Time,Clonskeagh Totem,Clonskeagh Totem IN,Clonskeagh Totem OUT,Dun Laoghaire @ Peoples Park Cyclist,Dun Laoghaire @ Peoples Park Cyclists IN,Dun Laoghaire @ Peoples Park Cyclists OUT,Dun Laoghaire @ Seapoint Beach Cyclist,Dun Laoghaire @ Seapoint Beach Cyclist IN,Dun Laoghaire @ Seapoint Beach Cyclist OUT,Dun Laoghaire @ York Road Cyclist,Dun Laoghaire @ York Road Cyclists IN,Dun Laoghaire @ York Road Cyclists OUT,Glenageary Cyclist,Glenageary Bikes IN,Glenageary Bikes OUT,Grange Road Totem,N11 Before UCD,N11 Before UCD Cyclist IN,N11 Before UCD Cyclist OUT,N11 Outbound (Montrose),N11 Outbound (Montrose) OUT-Away From City Centre,N11 Outbound (Montrose) IN- Towards City Centre,N11 Totem Inbound,Rock Road Bus Lane,Rock Road Park,Rock Road Park IN,Rock Road Park OUT,Rock Road Totem Inbound,Wyattville Rd - Bicycles From N11,Wyattville Rd - Bicycles Towards N11,Wyattville Rd - Bicycles Towards N11 Cyclist IN,Wyattville Rd - Bicycles Towards N11 Cyclist OUT,Wyattville Rd At Park Gates Cyclist,Wyattville Rd At Park Gates Bikes IN,Wyattville Rd At Park Gates Bikes OUT,Wyattville Road At Steps Cyclist,Wyattville Road At Steps Bikes IN,Wyattville Road At Steps Bikes OUT
"Jan 1, 2023 12:00 AM",4,2,2,0,0,0,2,0,2,2,0,2,,,,0,1,1,0,0,0,0,1,1,1,0,1,2,0,0,,,0,0,0,,,
"Jan 1, 2023 1:00 AM",4,1,3,0,0,0,0,0,0,3,1,2,,,,0,4,4,0,3,3,0,3,5,1,1,0,7,0,0,,,0,0,0,,,
"Jan 1, 2023 2:00 AM",5,3,2,5,4,1,10,7,3,6,4,2,,,,0,1,1,0,1,1,0,1,4,4,3,1,4,1,0,,,1,1,0,,,
"Jan 1, 2023 3:00 AM",4,2,2,0,0,0,0,0,0,0,0,0,,,,0,0,0,0,1,1,0,0,2,1,1,0,2,0,0,,,0,0,0,,,
"Jan 1, 2023 4:00 AM",4,2,2,0,0,0,2,1,1,2,1,1,,,,0,2,1,1,3,3,0,1,0,0,0,0,1,0,0,,,0,0,0,,,
"Jan 1, 2023 5:00 AM",1,0,1,1,1,0,2,2,0,1,0,1,,,,0,0,0,0,1,1,0,0,0,3,2,1,3,0,0,,,0,0,0,,,
"Jan 1, 2023 6:00 AM",5,4,1,0,0,0,2,2,0,1,1,0,,,,0,2,2,0,2,2,0,2,3,0,0,0,5,0,0,,,0,0,0,,,
"Jan 1, 2023 7:00 AM",7,4,3,4,2,2,3,2,1,2,1,1,,,,2,1,1,0,1,1,0,3,2,1,1,0,8,2,2,,,1,1,0,,,
"Jan 1, 2023 8:00 AM",10,3,7,20,16,4,28,25,3,19,15,4,,,,4,4,4,0,1,1,0,4,7,9,8,1,6,0,1,,,2,2,0,,,
"Jan 1, 2023 9:00 AM",8,4,4,27,18,9,37,18,19,20,13,7,,,,4,2,2,0,3,3,0,2,7,7,6,1,7,0,8,,,6,5,1,,,
"Jan 1, 2023 10:00 AM",21,14,7,67,40,27,78,53,25,58,42,16,,,,5,8,8,0,5,5,0,8,16,27,21,6,14,4,2,,,3,2,1,,,
"Jan 1, 2023 11:00 AM",20,9,11,62,23,39,77,38,39,58,30,28,,,,3,6,5,1,3,3,0,5,9,33,20,13,19,1,4,,,2,0,2,,,
"Jan 1, 2023 12:00 PM",24,9,15,93,53,40,71,34,37,72,41,31,,,,17,9,8,1,5,5,0,6,13,23,13,10,14,1,3,,,1,0,1,,,
"Jan 1, 2023 1:00 PM",22,14,8,66,25,41,70,28,42,50,19,31,,,,11,5,5,0,3,3,0,5,12,24,14,10,24,4,1,,,9,6,3,,,
"Jan 1, 2023 2:00 PM",10,5,5,62,33,29,65,36,29,49,31,18,,,,4,5,5,0,4,3,1,5,12,26,15,11,14,4,3,,,1,1,0,,,
"Jan 1, 2023 3:00 PM",18,11,7,66,31,35,61,33,28,66,32,34,,,,27,3,3,0,6,3,3,2,8,24,11,13,12,1,0,,,1,1,0,,,
"Jan 1, 2023 4:00 PM",19,9,10,60,34,26,57,26,31,42,23,19,,,,2,5,5,0,5,4,1,7,12,14,6,8,11,2,1,,,1,0,1,,,
"Jan 1, 2023 5:00 PM",17,5,12,34,14,20,21,5,16,19,6,13,,,,6,4,3,1,5,5,0,4,6,3,0,3,10,1,2,,,6,3,3,,,
"Jan 1, 2023 6:00 PM",23,14,9,4,2,2,15,6,9,6,3,3,,,,6,7,6,1,4,2,2,6,4,2,2,0,10,0,0,,,3,2,1,,,
"Jan 1, 2023 7:00 PM",14,10,4,12,5,7,14,6,8,11,2,9,,,,7,5,5,0,2,2,0,4,6,7,2,5,8,1,0,,,0,0,0,,,
"Jan 1, 2023 8:00 PM",16,5,11,6,5,1,8,4,4,3,1,2,,,,4,3,2,1,4,4,0,3,1,5,2,3,6,0,1,,,1,1,0,,,
"Jan 1, 2023 9:00 PM",13,4,9,2,2,0,7,5,2,3,2,1,,,,4,2,2,0,8,6,2,2,3,2,2,0,4,0,0,,,0,0,0,,,
"Jan 1, 2023 10:00 PM",8,3,5,3,1,2,3,1,2,3,1,2,,,,2,4,4,0,3,2,1,5,2,0,0,0,5,0,0,,,2,1,1,,,
"Jan 1, 2023 11:00 PM",8,2,6,2,2,0,1,0,1,1,0,1,,,,2,0,0,0,3,3,0,0,0,0,0,0,3,0,2,,,0,0,0,,,
"Jan 2, 2023 12:00 AM",4,0,4,0,0,0,0,0,0,1,0,1,,,,1,2,2,0,2,2,0,2,2,1,1,0,3,0,0,,,2,2,0,,,
"Jan 2, 2023 1:00 AM",1,0,1,0,0,0,0,0,0,0,0,0,,,,0,0,0,0,0,0,0,0,0,0,0,0,0,0,0,,,0,0,0,,,
"Jan 2, 2023 2:00 AM",2,1,1,0,0,0,0,0,0,0,0,0,,,,0,0,0,0,0,0,0,0,2,1,1,0,0,0,0,,,0,0,0,,,
"Jan 2, 2023 3:00 AM",0,0,0,0,0,0,0,0,0,0,0,0,,,,0,0,0,0,0,0,0,0,0,0,0,0,0,0,0,,,0,0,0,,,
"Jan 2, 2023 4:00 AM",0,0,0,0,0,0,1,0,1,1,0,1,,,,0,0,0,0,0,0,0,0,0,1,0,1,0,0,0,,,0,0,0,,,
"Jan 2, 2023 5:00 AM",2,0,2,0,0,0,1,0,1,0,0,0,,,,1,1,0,1,0,0,0,1,1,1,0,1,1,0,0,,,0,0,0,,,
"Jan 2, 2023 6:00 AM",8,4,4,3,0,3,4,2,2,2,1,1,,,,2,2,2,0,0,0,0,2,2,1,0,1,8,0,2,,,0,0,0,,,
"Jan 2, 2023 7:00 AM",15,6,9,4,3,1,6,4,2,6,4,2,,,,2,5,5,0,4,3,1,5,4,1,0,1,5,1,1,,,0,0,0,,,
"Jan 2, 2023 8:00 AM",12,7,5,19,13,6,24,15,9,17,13,4,,,,3,9,9,0,5,5,0,9,8,4,3,1,11,1,3,,,0,0,0,,,
"Jan 2, 2023 9:00 AM",20,9,11,47,25,22,51,32,19,39,23,16,,,,3,7,7,0,5,4,1,4,11,15,7,8,20,0,1,,,3,3,0,,,
"Jan 2, 2023 10:00 AM",27,14,13,87,60,27,92,64,28,83,63,20,,,,10,21,19,2,2,2,0,21,24,32,24,8,19,3,7,,,2,1,1,,,
"Jan 2, 2023 11:00 AM",36,16,20,74,38,36,91,44,47,59,33,26,,,,16,11,11,0,8,7,1,12,13,29,18,11,37,9,4,,,2,1,1,,,
"Jan 2, 2023 12:00 PM",43,19,24,109,53,56,103,52,51,95,46,49,,,,18,16,15,1,15,13,2,11,21,44,23,21,28,11,3,,,1,0,1,,,
"Jan 2, 2023 1:00 PM",38,21,17,138,80,58,122,81,41,107,72,35,,,,21,14,13,1,11,10,1,12,28,52,36,16,30,1,3,,,6,5,1,,,
"Jan 2, 2023 2:00 PM",50,27,23,103,46,57,144,63,81,120,61,59,,,,13,15,14,1,16,14,2,12,25,63,33,30,26,5,4,,,12,8,4,,,
"Jan 2, 2023 3:00 PM",39,26,13,86,38,48,101,38,63,90,41,49,,,,18,17,15,2,14,14,0,12,18,44,19,25,29,8,2,,,17,11,6,,,
"Jan 2, 2023 4:00 PM",38,7,31,53,29,24,58,20,38,46,21,25,,,,25,11,11,0,12,11,1,7,13,27,15,12,16,4,2,,,17,8,9,,,
"Jan 2, 2023 5:00 PM",32,15,17,15,7,8,27,14,13,16,10,6,,,,16,6,5,1,9,6,3,5,9,13,6,7,10,1,0,,,8,5,3,,,
"Jan 2, 2023 6:00 PM",32,11,21,8,6,2,12,4,8,13,5,8,,,,6,8,8,0,10,9,1,7,5,3,0,3,10,1,1,,,8,4,4,,,
"Jan 2, 2023 7:00 PM",22,14,8,7,3,4,6,1,5,6,0,6,,,,3,4,3,1,2,2,0,2,5,1,1,0,12,2,0,,,2,1,1,,,
"Jan 2, 2023 8:00 PM",16,7,9,0,0,0,4,2,2,2,1,1,,,,2,2,2,0,5,4,1,4,4,2,2,0,7,0,2,,,0,0,0,,,
"Jan 2, 2023 9:00 PM",5,5,0,4,3,1,7,4,3,8,5,3,,,,0,3,3,0,1,1,0,3,5,2,1,1,13,1,2,,,4,2,2,,,
"Jan 2, 2023 10:00 PM",13,5,8,0,0,0,3,0,3,1,0,1,,,,12,2,2,0,1,1,0,2,1,1,1,0,4,0,0,,,3,2,1,,,
"Jan 2, 2023 11:00 PM",5,2,3,1,0,1,2,0,2,2,0,2,,,,1,2,2,0,1,1,0,1,5,1,0,1,2,0,1,,,2,1,1,,,
"Jan 3, 2023 12:00 AM",2,0,2,0,0,0,0,0,0,1,1,0,,,,1,2,1,1,1,1,0,1,4,0,0,0,1,0,0,,,0,0,0,,,
"Jan 3, 2023 1:00 AM",2,1,1,0,0,0,0,0,0,0,0,0,,,,0,1,1,0,1,1,0,1,0,0,0,0,1,0,0,,,0,0,0,,,
"Jan 3, 2023 2:00 AM",6,4,2,0,0,0,0,0,0,0,0,0,,,,0,0,0,0,0,0,0,0,0,0,0,0,0,0,0,,,0,0,0,,,
"Jan 3, 2023 3:00 AM",0,0,0,0,0,0,0,0,0,0,0,0,,,,0,0,0,0,0,0,0,0,1,0,0,0,0,0,0,,,0,0,0,,,
"Jan 3, 2023 4:00 AM",2,0,2,1,0,1,1,0,1,1,0,1,,,,0,1,1,0,0,0,0,1,0,1,0,1,0,0,0,,,0,0,0,,,
"Jan 3, 2023 5:00 AM",2,2,0,0,0,0,4,1,3,1,1,0,,,,1,2,2,0,0,0,0,3,3,0,0,0,2,0,0,,,0,0,0,,,
"Jan 3, 2023 6:00 AM",30,14,16,6,0,6,6,2,4,7,1,6,,,,3,8,8,0,5,4,1,11,7,4,0,4,23,0,3,,,1,1,0,,,
"Jan 3, 2023 7:00 AM",62,48,14,24,8,16,27,10,17,19,8,11,,,,6,28,28,0,9,8,1,29,20,4,3,1,54,2,3,,,7,6,1,,,
"Jan 3, 2023 8:00 AM",107,79,28,38,7,31,46,10,36,43,14,29,,,,10,55,55,0,8,5,3,59,33,30,8,22,89,3,2,,,3,2,1,,,
"Jan 3, 2023 9:00 AM",35,27,8,19,8,11,26,14,12,19,16,3,,,,5,18,18,0,12,7,5,19,8,17,8,9,23,0,1,,,3,2,1,,,
"Jan 3, 2023 10:00 AM",20,13,7,14,5,9,30,16,14,13,7,6,,,,9,12,12,0,4,2,2,11,9,11,5,6,8,1,0,,,0,0,0,,,
"Jan 3, 2023 11:00 AM",29,18,11,11,5,6,22,10,12,11,6,5,,,,12,12,11,1,3,2,1,8,10,15,8,7,6,1,1,,,4,1,3,,,
"Jan 3, 2023 12:00 PM",33,13,20,15,10,5,20,11,9,10,7,3,,,,3,10,9,1,6,6,0,9,9,10,2,8,10,1,1,,,5,3,2,,,
"Jan 3, 2023 1:00 PM",41,16,25,38,7,31,42,18,24,29,18,11,,,,10,10,8,2,5,4,1,7,12,20,14,6,13,3,2,,,5,3,2,,,
"Jan 3, 2023 2:00 PM",37,20,17,27,16,11,38,21,17,41,27,14,,,,13,12,9,3,5,4,1,8,17,18,8,10,13,1,4,,,9,6,3,,,
"Jan 3, 2023 3:00 PM",46,23,23,43,25,18,38,24,14,39,22,17,,,,15,13,11,2,17,16,1,9,15,14,10,4,16,5,1,,,2,2,0,,,
"Jan 3, 2023 4:00 PM",74,23,51,28,17,11,41,22,19,32,19,13,,,,15,11,11,0,17,15,2,7,32,26,15,11,27,1,2,,,5,4,1,,,
"Jan 3, 2023 5:00 PM",121,22,99,41,29,12,70,42,28,58,27,31,,,,13,15,10,5,44,42,2,12,58,23,13,10,25,1,2,,,14,9,5,,,
"Jan 3, 2023 6:00 PM",108,31,77,21,15,6,37,27,10,30,19,11,,,,15,11,11,0,33,32,1,14,49,20,14,6,17,1,4,,,8,3,5,,,
"Jan 3, 2023 7:00 PM",42,11,31,11,8,3,16,13,3,13,12,1,,,,7,8,7,1,19,17,2,7,16,10,7,3,11,0,3,,,3,2,1,,,
"Jan 3, 2023 8:00 PM",30,6,24,14,11,3,22,13,9,12,6,6,,,,5,7,7,0,11,10,1,7,7,8,6,2,4,0,3,,,5,3,2,,,
"Jan 3, 2023 9:00 PM",16,3,13,1,0,1,5,0,5,3,0,3,,,,0,4,3,1,5,4,1,3,6,1,1,0,3,0,0,,,1,0,1,,,
"Jan 3, 2023 10:00 PM",18,9,9,3,1,2,3,0,3,0,0,0,,,,0,1,1,0,3,3,0,1,6,2,1,1,4,1,0,,,4,2,2,,,
"Jan 3, 2023 11:00 PM",7,4,3,1,1,0,2,2,0,2,1,1,,,,1,2,2,0,6,6,0,2,0,3,2,1,2,1,1,,,0,0,0,,,
"Jan 4, 2023 12:00 AM",1,0,1,0,0,0,0,0,0,1,0,1,,,,1,0,0,0,2,2,0,0,0,0,0,0,0,1,0,,,2,1,1,,,
"Jan 4, 2023 1:00 AM",4,3,1,1,1,0,1,0,1,0,0,0,,,,0,0,0,0,1,1,0,0,0,0,0,0,2,0,0,,,0,0,0,,,
"Jan 4, 2023 2:00 AM",6,5,1,0,0,0,1,1,0,0,0,0,,,,0,0,0,0,0,0,0,0,0,1,1,0,0,0,0,,,0,0,0,,,
"Jan 4, 2023 3:00 AM",0,0,0,0,0,0,0,0,0,0,0,0,,,,0,0,0,0,0,0,0,0,0,0,0,0,0,0,0,,,0,0,0,,,
"Jan 4, 2023 4:00 AM",2,0,2,1,0,1,1,0,1,1,0,1,,,,0,2,2,0,0,0,0,2,0,1,0,1,0,0,0,,,0,0,0,,,
"Jan 4, 2023 5:00 AM",7,7,0,0,0,0,0,0,0,0,0,0,,,,0,3,3,0,2,1,1,3,1,0,0,0,4,1,0,,,0,0,0,,,
"Jan 4, 2023 6:00 AM",32,18,14,4,0,4,4,0,4,4,0,4,,,,1,9,8,1,5,5,0,6,7,0,0,0,16,0,0,,,1,1,0,,,
"Jan 4, 2023 7:00 AM",73,53,20,19,5,14,24,5,19,20,6,14,,,,9,38,38,0,7,6,1,37,16,11,6,5,52,3,0,,,6,6,0,,,
"Jan 4, 2023 8:00 AM",135,103,32,35,8,27,58,23,35,44,21,23,,,,15,80,79,1,12,5,7,80,33,26,5,21,112,0,3,,,3,1,2,,,
"Jan 4, 2023 9:00 AM",71,54,17,30,10,20,40,19,21,27,16,11,,,,8,23,23,0,14,13,1,22,11,18,8,10,34,1,2,,,1,0,1,,,
"Jan 4, 2023 10:00 AM",37,29,8,22,9,13,33,20,13,12,10,2,,,,12,14,14,0,4,3,1,14,4,15,11,4,16,2,0,,,2,2,0,,,
"Jan 4, 2023 11:00 AM",26,14,12,26,13,13,52,22,30,30,18,12,,,,12,16,14,2,5,5,0,11,6,25,13,12,11,0,1,,,3,3,0,,,
"Jan 4, 2023 12:00 PM",39,14,25,30,15,15,40,23,17,27,18,9,,,,5,15,14,1,4,4,0,11,6,26,19,7,11,4,2,,,4,0,4,,,
"Jan 4, 2023 1:00 PM",49,19,30,45,27,18,41,26,15,42,27,15,,,,23,11,10,1,8,8,0,11,13,21,10,11,19,1,2,,,4,2,2,,,
"Jan 4, 2023 2:00 PM",35,17,18,23,10,13,30,15,15,30,15,15,,,,17,12,12,0,11,9,2,12,7,16,8,8,11,1,2,,,5,4,1,,,
"Jan 4, 2023 3:00 PM",36,14,22,29,17,12,38,20,18,34,23,11,,,,18,10,9,1,13,12,1,8,18,16,4,12,15,0,3,,,10,4,6,,,
"Jan 4, 2023 4:00 PM",79,26,53,35,22,13,45,23,22,39,20,19,,,,16,17,13,4,20,18,2,9,33,35,19,16,24,0,1,,,5,2,3,,,
"Jan 4, 2023 5:00 PM",135,28,107,39,29,10,59,34,25,44,29,15,,,,18,27,24,3,55,53,2,27,67,30,15,15,35,5,1,,,4,4,0,,,
"Jan 4, 2023 6:00 PM",122,26,96,24,13,11,44,33,11,37,20,17,,,,13,13,13,0,54,52,2,13,50,24,18,6,17,1,6,,,2,1,1,,,
"Jan 4, 2023 7:00 PM",47,12,35,24,15,9,35,19,16,28,14,14,,,,4,5,3,2,25,25,0,3,24,11,5,6,12,0,4,,,7,4,3,,,
"Jan 4, 2023 8:00 PM",38,9,29,14,9,5,18,10,8,19,11,8,,,,4,9,7,2,7,6,1,7,12,5,5,0,9,0,1,,,5,4,1,,,
"Jan 4, 2023 9:00 PM",16,4,12,2,1,1,10,6,4,4,2,2,,,,2,4,4,0,6,5,1,2,6,4,4,0,4,2,0,,,1,1,0,,,
"Jan 4, 2023 10:00 PM",17,2,15,2,2,0,3,1,2,3,1,2,,,,4,5,5,0,10,10,0,5,5,2,1,1,7,1,0,,,3,1,2,,,
"Jan 4, 2023 11:00 PM",5,1,4,0,0,0,2,2,0,2,1,1,,,,2,2,2,0,5,5,0,1,1,3,3,0,1,1,0,,,0,0,0,,,
"Jan 5, 2023 12:00 AM",4,2,2,0,0,0,1,0,1,1,0,1,,,,1,0,0,0,3,2,1,0,1,0,0,0,1,0,0,,,1,0,1,,,
"Jan 5, 2023 1:00 AM",1,0,1,0,0,0,2,1,1,1,0,1,,,,0,0,0,0,0,0,0,0,2,4,2,2,0,0,0,,,1,1,0,,,
"Jan 5, 2023 2:00 AM",3,3,0,1,1,0,0,0,0,0,0,0,,,,0,0,0,0,0,0,0,0,0,2,1,1,0,0,0,,,0,0,0,,,
"Jan 5, 2023 3:00 AM",0,0,0,0,0,0,0,0,0,0,0,0,,,,0,0,0,0,0,0,0,0,1,0,0,0,0,0,0,,,0,0,0,,,
"Jan 5, 2023 4:00 AM",1,0,1,2,0,2,1,0,1,1,0,1,,,,0,2,2,0,0,0,0,2,0,1,0,1,2,0,0,,,0,0,0,,,
"Jan 5, 2023 5:00 AM",5,3,2,1,0,1,3,0,3,1,0,1,,,,2,7,6,1,3,2,1,3,2,1,1,0,6,0,0,,,0,0,0,,,
"Jan 5, 2023 6:00 AM",30,17,13,8,3,5,11,6,5,7,4,3,,,,10,13,13,0,4,3,1,12,3,2,1,1,15,0,3,,,0,0,0,,,
"Jan 5, 2023 7:00 AM",105,69,36,23,5,18,46,13,33,26,8,18,,,,9,46,46,0,18,15,3,45,22,22,6,16,82,3,4,,,3,1,2,,,
"Jan 5, 2023 8:00 AM",200,148,52,68,20,48,116,39,77,85,31,54,,,,34,98,94,4,26,22,4,86,41,57,15,42,157,4,5,,,22,19,3,,,
"Jan 5, 2023 9:00 AM",80,58,22,32,9,23,65,37,28,51,37,14,,,,15,32,32,0,13,9,4,34,17,25,15,10,65,2,2,,,3,2,1,,,
"Jan 5, 2023 10:00 AM",31,22,9,45,18,27,59,27,32,41,26,15,,,,7,14,14,0,4,4,0,14,10,19,11,8,17,3,4,,,1,0,1,,,
"Jan 5, 2023 11:00 AM",41,29,12,48,27,21,49,27,22,31,17,14,,,,11,14,11,3,7,6,1,9,15,18,10,8,21,2,2,,,1,0,1,,,
"Jan 5, 2023 12:00 PM",40,19,21,53,24,29,79,41,38,42,24,18,,,,8,16,15,1,5,5,0,10,18,23,13,10,20,4,9,,,3,3,0,,,
"Jan 5, 2023 1:00 PM",64,31,33,38,20,18,75,35,40,50,24,26,,,,8,16,15,1,9,8,1,11,15,22,11,11,14,1,1,,,5,2,3,,,
"Jan 5, 2023 2:00 PM",43,22,21,39,20,19,47,17,30,33,15,18,,,,16,13,11,2,9,8,1,9,19,23,14,9,24,3,4,,,7,3,4,,,
"Jan 5, 2023 3:00 PM",66,28,38,26,19,7,33,17,16,25,15,10,,,,12,23,21,2,21,17,4,14,25,22,14,8,27,7,0,,,10,7,3,,,
"Jan 5, 2023 4:00 PM",102,30,72,27,20,7,48,32,16,37,26,11,,,,10,16,11,5,35,32,3,13,35,26,15,11,27,1,1,,,3,1,2,,,
"Jan 5, 2023 5:00 PM",130,32,98,34,22,12,79,47,32,55,31,24,,,,10,18,15,3,59,54,5,18,65,44,31,13,30,1,2,,,8,4,4,,,
"Jan 5, 2023 6:00 PM",134,29,105,35,29,6,68,48,20,57,42,15,,,,19,19,19,0,72,70,2,16,64,35,25,10,30,8,3,,,6,3,3,,,
"Jan 5, 2023 7:00 PM",59,15,44,15,12,3,32,22,10,23,16,7,,,,5,5,4,1,23,21,2,6,32,14,13,1,10,4,5,,,4,1,3,,,
"Jan 5, 2023 8:00 PM",40,9,31,10,8,2,13,8,5,11,6,5,,,,2,8,7,1,11,11,0,7,11,3,3,0,7,4,2,,,4,2,2,,,
"Jan 5, 2023 9:00 PM",26,4,22,3,2,1,5,3,2,2,1,1,,,,7,5,5,0,6,5,1,6,4,3,1,2,2,3,0,,,0,0,0,,,
"Jan 5, 2023 10:00 PM",18,9,9,2,2,0,6,2,4,6,0,6,,,,2,4,4,0,4,4,0,4,5,6,4,2,4,2,1,,,0,0,0,,,
"Jan 5, 2023 11:00 PM",4,1,3,0,0,0,3,2,1,2,1,1,,,,1,4,4,0,7,7,0,4,2,2,2,0,2,0,0,,,1,0,1,,,
"Jan 6, 2023 12:00 AM",10,3,7,0,0,0,0,0,0,1,1,0,,,,1,1,1,0,5,5,0,0,2,0,0,0,0,1,0,,,1,1,0,,,
"Jan 6, 2023 1:00 AM",3,1,2,1,0,1,1,0,1,1,0,1,,,,0,0,0,0,2,1,1,0,2,0,0,0,0,1,0,,,0,0,0,,,
"Jan 6, 2023 2:00 AM",3,2,1,0,0,0,0,0,0,0,0,0,,,,0,0,0,0,0,0,0,0,2,1,0,1,0,0,0,,,0,0,0,,,
"Jan 6, 2023 3:00 AM",1,1,0,0,0,0,0,0,0,0,0,0,,,,0,0,0,0,0,0,0,0,0,1,1,0,0,0,0,,,0,0,0,,,
"Jan 6, 2023 4:00 AM",2,0,2,2,1,1,2,1,1,2,1,1,,,,0,2,2,0,0,0,0,2,0,1,0,1,0,0,0,,,0,0,0,,,
"Jan 6, 2023 5:00 AM",10,5,5,1,1,0,3,2,1,3,2,1,,,,2,6,6,0,3,1,2,5,2,0,0,0,6,0,0,,,0,0,0,,,
"Jan 6, 2023 6:00 AM",25,13,12,8,5,3,9,4,5,6,4,2,,,,4,10,10,0,6,6,0,9,6,3,3,0,20,0,1,,,0,0,0,,,
"Jan 6, 2023 7:00 AM",61,35,26,38,13,25,41,15,26,34,15,19,,,,9,29,29,0,10,8,2,29,18,9,7,2,59,2,3,,,4,4,0,,,
"Jan 6, 2023 8:00 AM",149,106,43,55,14,41,97,44,53,64,28,36,,,,23,74,72,2,26,20,6,68,39,56,26,30,106,3,5,,,13,9,4,,,
"Jan 6, 2023 9:00 AM",61,41,20,37,17,20,77,38,39,53,33,20,,,,7,35,32,3,16,11,5,30,13,25,9,16,45,4,4,,,4,4,0,,,
"Jan 6, 2023 10:00 AM",21,12,9,39,16,23,55,25,30,38,18,20,,,,6,16,16,0,6,4,2,15,12,17,10,7,28,2,2,,,2,2,0,,,
"Jan 6, 2023 11:00 AM",41,19,22,42,25,17,57,32,25,34,21,13,,,,9,15,14,1,3,2,1,10,10,25,15,10,20,3,0,,,5,3,2,,,
"Jan 6, 2023 12:00 PM",46,25,21,55,31,24,73,45,28,51,30,21,,,,11,14,14,0,12,11,1,14,23,22,10,12,17,3,0,,,5,2,3,,,
"Jan 6, 2023 1:00 PM",64,35,29,61,27,34,86,40,46,61,28,33,,,,15,14,14,0,10,8,2,8,17,37,23,14,17,2,5,,,8,4,4,,,
"Jan 6, 2023 2:00 PM",50,23,27,40,22,18,53,25,28,52,34,18,,,,12,23,18,5,21,20,1,18,19,29,19,10,34,3,6,,,3,2,1,,,
"Jan 6, 2023 3:00 PM",67,25,42,43,24,19,33,17,16,32,20,12,,,,16,19,15,4,27,25,2,14,30,12,9,3,26,6,1,,,8,5,3,,,
"Jan 6, 2023 4:00 PM",80,25,55,33,23,10,41,20,21,43,25,18,,,,9,23,18,5,30,26,4,17,41,27,12,15,36,2,2,,,7,3,4,,,
"Jan 6, 2023 5:00 PM",123,28,95,30,20,10,48,31,17,33,22,11,,,,9,14,12,2,48,45,3,12,48,34,20,14,33,7,2,,,8,6,2,,,
"Jan 6, 2023 6:00 PM",93,32,61,39,30,9,44,30,14,33,20,13,,,,16,13,11,2,44,44,0,14,50,24,15,9,17,2,2,,,8,4,4,,,
"Jan 6, 2023 7:00 PM",57,21,36,13,11,2,27,20,7,16,12,4,,,,2,11,11,0,22,22,0,9,22,10,7,3,12,4,1,,,2,2,0,,,
"Jan 6, 2023 8:00 PM",41,18,23,16,5,11,15,3,12,12,3,9,,,,8,9,7,2,12,9,3,7,12,9,5,4,13,0,2,,,3,2,1,,,
"Jan 6, 2023 9:00 PM",29,10,19,4,1,3,8,3,5,2,0,2,,,,5,7,6,1,9,8,1,5,8,9,5,4,8,2,0,,,4,1,3,,,
"Jan 6, 2023 10:00 PM",23,5,18,5,2,3,4,2,2,2,1,1,,,,5,8,8,0,8,7,1,7,4,4,3,1,5,0,0,,,1,0,1,,,
"Jan 6, 2023 11:00 PM",9,3,6,3,1,2,6,2,4,3,2,1,,,,4,3,2,1,5,5,0,1,2,0,0,0,2,0,0,,,2,1,1,,,
"Jan 7, 2023 12:00 AM",6,0,6,0,0,0,1,1,0,6,4,2,,,,0,0,0,0,7,5,2,1,3,2,2,0,2,0,0,,,1,1,0,,,
"Jan 7, 2023 1:00 AM",2,2,0,0,0,0,2,2,0,1,1,0,,,,0,0,0,0,3,3,0,1,0,2,2,0,0,0,0,,,0,0,0,,,
"Jan 7, 2023 2:00 AM",5,2,3,0,0,0,0,0,0,0,0,0,,,,1,1,1,0,2,2,0,1,0,0,0,0,1,0,0,,,1,0,1,,,
"Jan 7, 2023 3:00 AM",2,1,1,0,0,0,0,0,0,0,0,0,,,,0,0,0,0,0,0,0,0,1,0,0,0,1,0,0,,,0,0,0,,,
"Jan 7, 2023 4:00 AM",1,0,1,0,0,0,1,1,0,0,0,0,,,,0,0,0,0,0,0,0,0,3,0,0,0,0,0,0,,,2,1,1,,,
"Jan 7, 2023 5:00 AM",0,0,0,0,0,0,0,0,0,0,0,0,,,,1,3,3,0,2,2,0,3,1,0,0,0,1,0,0,,,0,0,0,,,
"Jan 7, 2023 6:00 AM",8,4,4,1,0,1,3,1,2,2,0,2,,,,2,3,3,0,2,2,0,4,2,0,0,0,3,0,0,,,3,2,1,,,
"Jan 7, 2023 7:00 AM",12,7,5,7,5,2,8,4,4,10,7,3,,,,5,3,3,0,5,5,0,2,5,2,2,0,10,1,1,,,0,0,0,,,
"Jan 7, 2023 8:00 AM",28,12,16,37,16,21,35,21,14,28,19,9,,,,3,13,13,0,7,5,2,13,12,8,5,3,12,4,5,,,6,2,4,,,
"Jan 7, 2023 9:00 AM",39,22,17,73,38,35,75,44,31,68,44,24,,,,8,10,10,0,5,4,1,13,19,31,15,16,24,4,11,,,5,4,1,,,
"Jan 7, 2023 10:00 AM",43,20,23,88,45,43,95,57,38,83,46,37,,,,19,21,19,2,13,11,2,18,23,25,14,11,25,11,4,,,4,3,1,,,
"Jan 7, 2023 11:00 AM",43,21,22,96,49,47,127,58,69,82,42,40,,,,16,14,13,1,15,13,2,13,11,44,28,16,28,6,3,,,5,3,2,,,
"Jan 7, 2023 12:00 PM",41,22,19,86,41,45,101,49,52,69,33,36,,,,10,17,17,0,7,5,2,15,19,47,29,18,27,2,6,,,1,1,0,,,
"Jan 7, 2023 1:00 PM",52,23,29,76,41,35,87,43,44,66,40,26,,,,9,21,20,1,9,8,1,17,16,40,13,27,18,2,5,,,4,2,2,,,
"Jan 7, 2023 2:00 PM",39,20,19,98,50,48,82,41,41,64,33,31,,,,15,23,22,1,17,13,4,17,20,46,33,13,26,5,1,,,6,4,2,,,
"Jan 7, 2023 3:00 PM",43,15,28,82,40,42,88,41,47,72,39,33,,,,14,20,19,1,8,8,0,18,14,50,24,26,16,3,2,,,8,7,1,,,
"Jan 7, 2023 4:00 PM",39,20,19,51,25,26,47,19,28,49,22,27,,,,6,15,12,3,12,12,0,9,10,50,27,23,19,6,2,,,5,3,2,,,
"Jan 7, 2023 5:00 PM",31,16,15,30,16,14,41,15,26,28,10,18,,,,7,6,3,3,8,8,0,3,12,11,3,8,16,3,0,,,5,3,2,,,
"Jan 7, 2023 6:00 PM",35,14,21,9,4,5,12,5,7,11,4,7,,,,4,8,8,0,5,5,0,8,7,7,3,4,4,1,1,,,2,1,1,,,
"Jan 7, 2023 7:00 PM",28,15,13,6,6,0,10,6,4,6,4,2,,,,11,3,3,0,3,3,0,5,7,8,5,3,7,0,0,,,2,1,1,,,
"Jan 7, 2023 8:00 PM",13,8,5,5,4,1,5,3,2,4,3,1,,,,3,4,3,1,5,5,0,3,3,4,2,2,5,2,0,,,1,1,0,,,
"Jan 7, 2023 9:00 PM",7,2,5,6,4,2,6,4,2,4,2,2,,,,1,7,7,0,2,2,0,5,1,1,1,0,3,1,0,,,3,2,1,,,
"Jan 7, 2023 10:00 PM",7,2,5,2,2,0,2,1,1,1,1,0,,,,4,3,2,1,2,1,1,1,4,0,0,0,3,0,2,,,3,2,1,,,
"Jan 7, 2023 11:00 PM",6,1,5,3,0,3,5,2,3,3,0,3,,,,1,4,3,1,3,2,1,4,4,1,1,0,5,0,0,,,0,0,0,,,
"Jan 8, 2023 12:00 AM",5,2,3,0,0,0,3,2,1,6,2,4,,,,1,2,2,0,1,0,1,2,5,0,0,0,1,0,1,,,0,0,0,,,
"Jan 8, 2023 1:00 AM",7,2,5,1,1,0,1,1,0,1,1,0,,,,0,1,1,0,3,3,0,1,0,0,0,0,2,0,0,,,1,0,1,,,
"Jan 8, 2023 2:00 AM",0,0,0,0,0,0,0,0,0,0,0,0,,,,1,0,0,0,0,0,0,0,1,0,0,0,1,0,0,,,0,0,0,,,
"Jan 8, 2023 3:00 AM",1,0,1,0,0,0,0,0,0,0,0,0,,,,0,0,0,0,1,1,0,1,0,1,1,0,1,0,0,,,0,0,0,,,
"Jan 8, 2023 4:00 AM",1,0,1,1,1,0,1,1,0,1,1,0,,,,0,0,0,0,0,0,0,0,0,1,1,0,0,0,0,,,0,0,0,,,
"Jan 8, 2023 5:00 AM",4,0,4,1,1,0,1,1,0,1,1,0,,,,2,0,0,0,0,0,0,0,1,0,0,0,0,1,0,,,0,0,0,,,
"Jan 8, 2023 6:00 AM",5,3,2,3,2,1,8,3,5,4,2,2,,,,2,3,3,0,1,1,0,3,5,0,0,0,8,0,0,,,0,0,0,,,
"Jan 8, 2023 7:00 AM",12,9,3,17,7,10,15,10,5,15,9,6,,,,0,4,4,0,3,2,1,4,6,2,0,2,7,0,3,,,0,0,0,,,
"Jan 8, 2023 8:00 AM",17,9,8,34,22,12,28,16,12,27,16,11,,,,1,4,4,0,4,3,1,5,11,7,5,2,15,0,0,,,1,1,0,,,
"Jan 8, 2023 9:00 AM",41,18,23,52,34,18,48,31,17,43,32,11,,,,6,15,15,0,9,8,1,13,18,20,6,14,32,1,19,,,2,2,0,,,
"Jan 8, 2023 10:00 AM",43,26,17,103,64,39,99,65,34,92,63,29,,,,10,19,18,1,6,5,1,16,21,31,25,6,33,3,6,,,2,1,1,,,
"Jan 8, 2023 11:00 AM",51,27,24,140,68,72,129,66,63,108,62,46,,,,11,9,9,0,8,6,2,8,24,41,19,22,44,3,17,,,6,1,5,,,
"Jan 8, 2023 12:00 PM",34,19,15,146,74,72,145,80,65,117,59,58,,,,13,22,20,2,11,10,1,17,39,72,47,25,38,19,5,,,11,7,4,,,
"Jan 8, 2023 1:00 PM",43,23,20,103,44,59,123,56,67,91,48,43,,,,18,20,18,2,16,11,5,18,22,53,27,26,42,3,7,,,4,3,1,,,
"Jan 8, 2023 2:00 PM",46,16,30,93,39,54,117,54,63,103,57,46,,,,21,15,15,0,19,17,2,11,26,63,38,25,24,4,5,,,7,4,3,,,
"Jan 8, 2023 3:00 PM",31,21,10,130,69,61,96,50,46,82,39,43,,,,23,18,15,3,10,8,2,12,16,35,15,20,19,4,2,,,5,3,2,,,
"Jan 8, 2023 4:00 PM",32,9,23,58,29,29,74,24,50,60,23,37,,,,19,13,13,0,10,8,2,10,13,45,19,26,25,1,1,,,4,1,3,,,
"Jan 8, 2023 5:00 PM",36,20,16,34,20,14,32,12,20,30,14,16,,,,2,6,4,2,10,7,3,4,14,17,7,10,9,2,2,,,2,1,1,,,
"Jan 8, 2023 6:00 PM",37,16,21,13,9,4,20,11,9,15,8,7,,,,6,6,4,2,7,7,0,3,6,15,6,9,10,1,0,,,2,1,1,,,
"Jan 8, 2023 7:00 PM",27,16,11,10,6,4,11,7,4,11,6,5,,,,3,1,1,0,0,0,0,1,5,7,6,1,9,2,3,,,3,2,1,,,
"Jan 8, 2023 8:00 PM",15,6,9,8,4,4,7,4,3,5,3,2,,,,4,3,2,1,3,3,0,3,4,1,1,0,6,0,0,,,0,0,0,,,
"Jan 8, 2023 9:00 PM",6,3,3,2,1,1,5,3,2,2,1,1,,,,0,3,1,2,1,1,0,2,3,4,3,1,7,0,0,,,4,2,2,,,
"Jan 8, 2023 10:00 PM",6,2,4,1,1,0,7,2,5,3,1,2,,,,0,6,6,0,4,4,0,6,4,1,1,0,4,1,0,,,2,2,0,,,
"Jan 8, 2023 11:00 PM",7,2,5,1,1,0,3,1,2,3,1,2,,,,4,2,2,0,3,3,0,2,0,1,1,0,2,0,0,,,0,0,0,,,
"Jan 9, 2023 12:00 AM",5,2,3,0,0,0,0,0,0,0,0,0,,,,1,0,0,0,1,1,0,0,0,0,0,0,2,0,0,,,1,0,1,,,
"Jan 9, 2023 1:00 AM",2,0,2,0,0,0,0,0,0,1,0,1,,,,0,0,0,0,0,0,0,0,1,0,0,0,1,0,0,,,1,1,0,,,
"Jan 9, 2023 2:00 AM",0,0,0,0,0,0,2,1,1,1,1,0,,,,0,0,0,0,1,1,0,0,0,2,1,1,0,0,0,,,1,1,0,,,
"Jan 9, 2023 3:00 AM",1,0,1,0,0,0,0,0,0,0,0,0,,,,0,0,0,0,0,0,0,0,0,0,0,0,0,0,0,,,0,0,0,,,
"Jan 9, 2023 4:00 AM",1,0,1,0,0,0,0,0,0,0,0,0,,,,0,2,2,0,0,0,0,2,0,0,0,0,0,0,0,,,0,0,0,,,
"Jan 9, 2023 5:00 AM",3,2,1,0,0,0,3,1,2,2,1,1,,,,1,2,2,0,2,1,1,2,2,0,0,0,7,0,0,,,0,0,0,,,
"Jan 9, 2023 6:00 AM",36,24,12,3,1,2,11,3,8,5,2,3,,,,5,16,16,0,4,3,1,14,10,6,2,4,23,0,1,,,1,1,0,,,
"Jan 9, 2023 7:00 AM",114,71,43,31,9,22,60,19,41,41,15,26,,,,13,68,68,0,15,13,2,65,27,11,2,9,96,2,4,,,5,4,1,,,
"Jan 9, 2023 8:00 AM",192,142,50,64,13,51,104,28,76,73,29,44,,,,39,134,128,6,39,28,11,113,30,66,21,45,194,4,4,,,12,10,2,,,
"Jan 9, 2023 9:00 AM",96,79,17,31,10,21,52,24,28,38,24,14,,,,13,43,43,0,17,11,6,36,15,32,10,22,59,1,3,,,6,5,1,,,
"Jan 9, 2023 10:00 AM",39,30,9,29,18,11,31,22,9,26,17,9,,,,7,21,21,0,9,7,2,20,7,10,9,1,15,2,0,,,2,1,1,,,
"Jan 9, 2023 11:00 AM",24,15,9,14,9,5,29,13,16,17,12,5,,,,6,11,10,1,12,10,2,9,8,7,2,5,19,3,0,,,4,4,0,,,
"Jan 9, 2023 12:00 PM",37,17,20,28,9,19,56,26,30,24,10,14,,,,6,17,17,0,12,11,1,13,6,13,8,5,16,1,1,,,4,2,2,,,
"Jan 9, 2023 1:00 PM",55,22,33,27,13,14,53,20,33,31,10,21,,,,12,17,15,2,14,13,1,14,13,16,9,7,20,2,2,,,2,1,1,,,
"Jan 9, 2023 2:00 PM",44,24,20,25,14,11,33,17,16,22,14,8,,,,12,19,14,5,7,6,1,12,14,13,8,5,20,1,1,,,5,2,3,,,
"Jan 9, 2023 3:00 PM",55,22,33,23,14,9,48,32,16,30,17,13,,,,16,24,23,1,20,17,3,16,24,21,14,7,25,3,2,,,6,4,2,,,
"Jan 9, 2023 4:00 PM",98,29,69,31,21,10,48,29,19,38,27,11,,,,13,19,17,2,34,26,8,17,56,38,26,12,29,5,3,,,9,5,4,,,
"Jan 9, 2023 5:00 PM",153,36,117,39,29,10,63,42,21,48,28,20,,,,15,37,29,8,97,93,4,28,73,45,32,13,38,7,5,,,6,3,3,,,
"Jan 9, 2023 6:00 PM",147,27,120,32,25,7,68,53,15,38,27,11,,,,28,23,21,2,81,78,3,24,99,43,31,12,23,3,4,,,9,7,2,,,
"Jan 9, 2023 7:00 PM",83,23,60,16,14,2,29,26,3,23,17,6,,,,2,12,9,3,32,32,0,10,28,11,6,5,12,4,1,,,7,3,4,,,
"Jan 9, 2023 8:00 PM",49,15,34,13,9,4,26,8,18,24,8,16,,,,3,12,10,2,21,20,1,12,10,7,3,4,15,0,2,,,0,0,0,,,
"Jan 9, 2023 9:00 PM",18,4,14,8,5,3,13,6,7,10,5,5,,,,3,4,3,1,9,9,0,4,8,2,2,0,10,2,2,,,3,2,1,,,
"Jan 9, 2023 10:00 PM",12,4,8,4,4,0,9,3,6,8,3,5,,,,2,6,4,2,3,3,0,4,4,3,1,2,8,0,2,,,3,2,1,,,
"Jan 9, 2023 11:00 PM",5,1,4,3,1,2,4,2,2,3,0,3,,,,0,0,0,0,4,4,0,0,5,1,0,1,2,0,0,,,1,0,1,,,
"Jan 10, 2023 12:00 AM",1,1,0,0,0,0,0,0,0,1,1,0,,,,0,1,1,0,1,0,1,1,2,1,1,0,0,0,0,,,0,0,0,,,
"Jan 10, 2023 1:00 AM",0,0,0,1,1,0,1,1,0,1,1,0,,,,0,0,0,0,0,0,0,0,2,0,0,0,1,0,0,,,0,0,0,,,
"Jan 10, 2023 2:00 AM",2,2,0,0,0,0,0,0,0,0,0,0,0,0,0,0,0,0,0,1,1,0,0,2,0,0,0,0,0,0,,,0,0,0,,,
"Jan 10, 2023 3:00 AM",0,0,0,0,0,0,0,0,0,0,0,0,0,0,0,0,0,0,0,0,0,0,0,0,0,0,0,0,0,0,,,0,0,0,,,
"Jan 10, 2023 4:00 AM",1,0,1,0,0,0,0,0,0,0,0,0,0,0,0,0,2,2,0,0,0,0,2,0,0,0,0,0,0,0,,,0,0,0,,,
"Jan 10, 2023 5:00 AM",4,3,1,0,0,0,2,0,2,0,0,0,0,0,0,1,5,5,0,2,1,1,5,2,1,0,1,5,0,0,,,1,1,0,,,
"Jan 10, 2023 6:00 AM",32,21,11,1,0,1,2,0,2,4,0,4,0,0,0,2,8,8,0,6,5,1,8,5,0,0,0,11,0,1,,,0,0,0,,,
"Jan 10, 2023 7:00 AM",86,58,28,11,1,10,29,5,24,21,6,15,0,0,0,7,54,51,3,18,14,4,48,26,12,2,10,78,1,1,,,3,3,0,,,
"Jan 10, 2023 8:00 AM",208,170,38,57,10,47,89,19,70,62,19,43,0,0,0,22,116,114,2,25,16,9,105,32,51,16,35,174,4,2,,,15,13,2,,,
"Jan 10, 2023 9:00 AM",89,74,15,37,8,29,50,22,28,38,25,13,0,0,0,10,39,39,0,14,10,4,36,13,23,5,18,56,2,4,,,5,3,2,,,
"Jan 10, 2023 10:00 AM",29,21,8,22,10,12,20,5,15,15,8,7,0,0,0,6,16,16,0,3,3,0,13,7,6,2,4,17,1,0,,,2,2,0,,,
"Jan 10, 2023 11:00 AM",27,16,11,22,11,11,25,15,10,20,8,12,0,0,0,5,14,13,1,4,1,3,9,7,5,2,3,19,3,1,,,6,2,4,,,
"Jan 10, 2023 12:00 PM",27,13,14,34,19,15,39,26,13,39,21,18,0,0,0,7,8,8,0,4,4,0,7,11,12,7,5,9,3,2,,,3,3,0,,,
"Jan 10, 2023 1:00 PM",36,15,21,39,22,17,47,22,25,37,20,17,0,0,0,12,16,12,4,14,11,3,12,22,25,13,12,15,3,4,,,5,2,3,,,
"Jan 10, 2023 2:00 PM",42,18,24,16,8,8,26,12,14,19,11,8,0,0,0,11,20,18,2,8,8,0,15,14,9,5,4,16,3,0,,,6,2,4,,,
"Jan 10, 2023 3:00 PM",58,18,40,14,8,6,28,16,12,19,11,8,0,0,0,10,12,8,4,11,10,1,8,18,13,7,6,15,5,2,,,6,4,2,,,
"Jan 10, 2023 4:00 PM",94,26,68,16,11,5,23,15,8,15,10,5,0,0,0,5,14,11,3,27,23,4,13,37,23,16,7,20,1,2,,,2,0,2,,,
"Jan 10, 2023 5:00 PM",170,34,136,32,24,8,55,29,26,47,22,25,0,0,0,10,27,21,6,61,59,2,19,69,30,19,11,44,3,2,,,5,3,2,,,
"Jan 10, 2023 6:00 PM",125,29,96,37,30,7,59,44,15,43,34,9,0,0,0,27,22,21,1,85,84,1,21,68,34,27,7,23,4,1,,,4,2,2,,,
"Jan 10, 2023 7:00 PM",74,20,54,15,11,4,27,20,7,14,9,5,0,0,0,5,10,8,2,28,25,3,9,35,13,10,3,14,3,2,,,6,3,3,,,
"Jan 10, 2023 8:00 PM",48,14,34,10,9,1,19,15,4,10,9,1,0,0,0,3,9,7,2,14,14,0,6,17,12,7,5,6,2,2,,,1,1,0,,,
"Jan 10, 2023 9:00 PM",23,5,18,4,4,0,6,4,2,6,6,0,0,0,0,4,4,4,0,8,7,1,3,10,4,3,1,5,0,0,,,3,1,2,,,
"Jan 10, 2023 10:00 PM",16,6,10,1,1,0,7,5,2,2,0,2,0,0,0,0,1,1,0,10,7,3,1,6,4,1,3,3,2,0,,,0,0,0,,,
"Jan 10, 2023 11:00 PM",2,0,2,0,0,0,1,0,1,1,0,1,0,0,0,1,4,4,0,1,1,0,4,1,0,0,0,4,0,0,,,1,1,0,,,
"Jan 11, 2023 12:00 AM",2,0,2,0,0,0,0,0,0,0,0,0,0,0,0,2,1,1,0,1,1,0,1,0,0,0,0,1,0,0,,,0,0,0,,,
"Jan 11, 2023 1:00 AM",1,0,1,0,0,0,1,0,1,0,0,0,0,0,0,0,0,0,0,1,1,0,0,1,0,0,0,0,0,0,,,0,0,0,,,
"Jan 11, 2023 2:00 AM",3,3,0,0,0,0,1,0,1,1,0,1,0,0,0,0,0,0,0,0,0,0,0,0,0,0,0,0,0,0,,,0,0,0,,,
"Jan 11, 2023 3:00 AM",1,0,1,0,0,0,0,0,0,0,0,0,0,0,0,0,0,0,0,0,0,0,0,0,1,1,0,0,0,0,,,0,0,0,,,
"Jan 11, 2023 4:00 AM",1,0,1,1,1,0,1,1,0,1,1,0,0,0,0,0,1,1,0,2,2,0,1,0,0,0,0,0,0,0,,,1,1,0,,,
"Jan 11, 2023 5:00 AM",4,3,1,0,0,0,2,1,1,2,1,1,0,0,0,1,5,5,0,2,1,1,5,2,0,0,0,7,0,0,,,1,1,0,,,
"Jan 11, 2023 6:00 AM",35,22,13,6,2,4,9,3,6,5,3,2,0,0,0,5,11,11,0,8,7,1,11,7,2,1,1,23,0,0,,,0,0,0,,,
"Jan 11, 2023 7:00 AM",100,69,31,25,6,19,43,11,32,33,10,23,0,0,0,11,62,62,0,19,16,3,57,19,16,4,12,88,0,1,,,5,4,1,,,
"Jan 11, 2023 8:00 AM",218,171,47,53,6,47,93,22,71,64,21,43,0,0,0,25,131,127,4,27,21,6,112,34,60,14,46,198,3,4,,,16,11,5,,,
"Jan 11, 2023 9:00 AM",104,84,20,26,6,20,48,23,25,33,19,14,0,0,0,8,48,47,1,17,11,6,41,14,29,11,18,49,3,3,,,7,6,1,,,
"Jan 11, 2023 10:00 AM",28,22,6,17,6,11,14,7,7,11,7,4,0,0,0,3,16,15,1,6,4,2,9,5,2,1,1,18,0,0,,,2,2,0,,,
"Jan 11, 2023 11:00 AM",18,10,8,4,2,2,9,4,5,2,0,2,0,0,0,1,7,6,1,7,6,1,5,8,4,2,2,8,1,2,,,6,3,3,,,
"Jan 11, 2023 12:00 PM",28,16,12,14,11,3,20,11,9,12,9,3,0,0,0,3,10,10,0,5,5,0,7,4,3,3,0,8,1,1,,,1,1,0,,,
"Jan 11, 2023 1:00 PM",37,17,20,19,10,9,34,21,13,25,13,12,0,0,0,12,12,11,1,18,16,2,8,15,12,7,5,20,1,3,,,3,2,1,,,
"Jan 11, 2023 2:00 PM",40,12,28,14,11,3,23,15,8,14,11,3,0,0,0,13,11,9,2,13,11,2,7,12,13,6,7,15,2,1,,,2,1,1,,,
"Jan 11, 2023 3:00 PM",59,22,37,20,14,6,30,20,10,20,14,6,0,0,0,6,20,19,1,9,9,0,10,20,13,7,6,9,3,0,,,4,3,1,,,
"Jan 11, 2023 4:00 PM",107,28,79,32,18,14,46,27,19,38,21,17,0,0,0,19,19,14,5,23,20,3,13,39,27,16,11,27,1,1,,,1,0,1,,,
"Jan 11, 2023 5:00 PM",163,41,122,41,30,11,58,41,17,49,32,17,0,0,0,12,21,17,4,74,74,0,22,87,38,25,13,36,6,1,,,8,6,2,,,
"Jan 11, 2023 6:00 PM",143,26,117,26,23,3,54,39,15,37,26,11,0,0,0,24,30,24,6,63,59,4,23,79,41,33,8,27,2,1,,,11,6,5,,,
"Jan 11, 2023 7:00 PM",68,19,49,19,13,6,36,26,10,23,18,5,0,0,0,7,7,6,1,29,28,1,4,39,12,8,4,12,1,2,,,5,1,4,,,
"Jan 11, 2023 8:00 PM",44,9,35,10,6,4,9,8,1,7,4,3,0,0,0,9,8,6,2,12,11,1,5,21,7,7,0,4,1,1,,,7,4,3,,,
"Jan 11, 2023 9:00 PM",16,2,14,7,7,0,7,4,3,3,3,0,0,0,0,3,3,2,1,5,5,0,2,6,7,4,3,4,4,1,,,6,3,3,,,
"Jan 11, 2023 10:00 PM",9,5,4,2,2,0,2,2,0,2,1,1,0,0,0,1,3,3,0,3,3,0,3,9,1,1,0,0,0,0,,,1,1,0,,,
"Jan 11, 2023 11:00 PM",9,2,7,0,0,0,2,1,1,3,0,3,0,0,0,4,2,2,0,3,3,0,2,1,0,0,0,5,1,0,,,1,1,0,,,
"Jan 12, 2023 12:00 AM",3,0,3,0,0,0,1,0,1,1,0,1,0,0,0,0,0,0,0,2,2,0,0,1,0,0,0,1,0,0,,,0,0,0,,,
"Jan 12, 2023 1:00 AM",2,1,1,0,0,0,0,0,0,0,0,0,0,0,0,0,0,0,0,1,0,1,0,0,0,0,0,0,0,0,,,0,0,0,,,
"Jan 12, 2023 2:00 AM",2,1,1,0,0,0,0,0,0,0,0,0,0,0,0,0,0,0,0,0,0,0,0,1,0,0,0,0,0,0,,,0,0,0,,,
"Jan 12, 2023 3:00 AM",0,0,0,0,0,0,0,0,0,0,0,0,0,0,0,0,0,0,0,0,0,0,0,0,1,1,0,0,0,0,,,0,0,0,,,
"Jan 12, 2023 4:00 AM",0,0,0,0,0,0,0,0,0,0,0,0,0,0,0,0,1,1,0,0,0,0,1,0,0,0,0,0,0,0,,,0,0,0,,,
"Jan 12, 2023 5:00 AM",2,1,1,4,1,3,3,1,2,4,2,2,0,0,0,0,2,2,0,4,3,1,1,2,0,0,0,4,0,0,,,2,2,0,,,
"Jan 12, 2023 6:00 AM",31,22,9,7,1,6,7,3,4,8,4,4,0,0,0,4,14,14,0,4,2,2,12,6,4,0,4,25,0,3,,,1,0,1,,,
"Jan 12, 2023 7:00 AM",85,61,24,25,5,20,41,8,33,31,11,20,0,0,0,9,57,55,2,17,13,4,45,15,22,4,18,73,2,1,,,7,7,0,,,
"Jan 12, 2023 8:00 AM",192,145,47,54,11,43,82,17,65,60,13,47,0,0,0,21,92,90,2,27,20,7,115,31,42,13,29,187,6,1,,,15,13,2,,,
"Jan 12, 2023 9:00 AM",92,73,19,26,7,19,41,16,25,33,18,15,0,0,0,11,33,33,0,12,8,4,40,12,31,8,23,58,0,2,,,1,1,0,,,
"Jan 12, 2023 10:00 AM",33,20,13,16,6,10,13,6,7,9,4,5,0,0,0,7,11,11,0,7,3,4,9,2,4,2,2,8,1,0,,,0,0,0,,,
"Jan 12, 2023 11:00 AM",21,13,8,18,9,9,15,7,8,9,5,4,0,0,0,5,8,7,1,7,5,2,6,4,2,1,1,13,0,3,,,1,1,0,,,
"Jan 12, 2023 12:00 PM",38,17,21,20,7,13,20,6,14,19,9,10,0,0,0,8,10,10,0,11,9,2,7,7,9,6,3,13,4,1,,,3,1,2,,,
"Jan 12, 2023 1:00 PM",45,22,23,29,16,13,37,20,17,21,13,8,0,0,0,6,13,9,4,11,9,2,7,9,9,9,0,9,0,1,,,4,4,0,,,
"Jan 12, 2023 2:00 PM",36,14,22,18,9,9,24,12,12,16,8,8,0,0,0,6,12,10,2,11,8,3,8,13,15,7,8,16,0,0,,,4,2,2,,,
"Jan 12, 2023 3:00 PM",41,10,31,19,11,8,20,16,4,10,7,3,0,0,0,16,13,10,3,16,14,2,7,23,15,11,4,13,1,2,,,3,3,0,,,
"Jan 12, 2023 4:00 PM",82,26,56,15,11,4,31,24,7,24,20,4,0,0,0,3,16,11,5,24,22,2,10,38,29,18,11,25,1,1,,,4,1,3,,,
"Jan 12, 2023 5:00 PM",137,30,107,39,29,10,42,29,13,42,28,14,0,0,0,15,21,18,3,64,60,4,20,72,30,21,9,26,2,1,,,4,3,1,,,
"Jan 12, 2023 6:00 PM",126,32,94,16,14,2,47,36,11,35,25,10,0,0,0,10,20,20,0,66,64,2,16,62,35,30,5,13,1,3,,,5,3,2,,,
"Jan 12, 2023 7:00 PM",80,22,58,8,8,0,22,17,5,19,12,7,0,0,0,3,11,9,2,27,22,5,10,26,16,14,2,8,2,3,,,5,3,2,,,
"Jan 12, 2023 8:00 PM",41,14,27,5,4,1,9,7,2,7,5,2,0,0,0,2,4,3,1,14,14,0,3,10,7,5,2,4,1,0,,,3,1,2,,,
"Jan 12, 2023 9:00 PM",22,2,20,7,6,1,9,8,1,7,7,0,0,0,0,2,4,4,0,10,10,0,3,5,3,1,2,3,0,0,,,3,0,3,,,
"Jan 12, 2023 10:00 PM",18,6,12,0,0,0,5,3,2,5,1,4,0,0,0,1,4,4,0,4,3,1,3,1,0,0,0,2,0,0,,,2,2,0,,,
"Jan 12, 2023 11:00 PM",9,3,6,3,1,2,2,0,2,3,0,3,0,0,0,0,0,0,0,2,2,0,0,3,0,0,0,7,2,0,,,0,0,0,,,
"Jan 13, 2023 12:00 AM",2,1,1,0,0,0,0,0,0,0,0,0,0,0,0,1,0,0,0,2,2,0,0,3,0,0,0,1,0,0,,,0,0,0,,,
"Jan 13, 2023 1:00 AM",0,0,0,0,0,0,0,0,0,0,0,0,0,0,0,0,0,0,0,2,2,0,0,0,0,0,0,0,0,0,,,0,0,0,,,
"Jan 13, 2023 2:00 AM",3,2,1,0,0,0,2,0,2,2,0,2,0,0,0,0,0,0,0,0,0,0,0,0,0,0,0,1,0,0,,,0,0,0,,,
"Jan 13, 2023 3:00 AM",0,0,0,0,0,0,0,0,0,0,0,0,0,0,0,0,0,0,0,0,0,0,0,0,0,0,0,0,0,0,,,0,0,0,,,
"Jan 13, 2023 4:00 AM",0,0,0,0,0,0,0,0,0,0,0,0,0,0,0,0,2,2,0,2,2,0,2,0,1,1,0,0,0,0,,,0,0,0,,,
"Jan 13, 2023 5:00 AM",2,1,1,1,1,0,3,2,1,2,2,0,0,0,0,1,4,4,0,3,1,2,4,2,2,1,1,5,0,0,,,0,0,0,,,
"Jan 13, 2023 6:00 AM",18,10,8,4,0,4,6,2,4,6,3,3,0,0,0,3,9,9,0,2,2,0,5,9,3,3,0,13,0,1,,,1,1,0,,,
"Jan 13, 2023 7:00 AM",64,42,22,24,6,18,26,8,18,13,3,10,0,0,0,13,34,34,0,10,8,2,30,12,7,2,5,44,0,1,,,2,2,0,,,
"Jan 13, 2023 8:00 AM",135,95,40,25,9,16,54,22,32,40,18,22,0,0,0,13,84,81,3,23,17,6,74,21,36,20,16,83,2,0,,,6,2,4,,,
"Jan 13, 2023 9:00 AM",60,46,14,17,6,11,41,23,18,25,21,4,0,0,0,14,39,39,0,11,9,2,31,13,20,9,11,31,0,1,,,0,0,0,,,
"Jan 13, 2023 10:00 AM",41,26,15,12,7,5,19,10,9,16,11,5,0,0,0,6,11,9,2,5,5,0,12,5,11,6,5,27,1,3,,,3,2,1,,,
"Jan 13, 2023 11:00 AM",38,26,12,37,24,13,31,20,11,30,20,10,0,0,0,6,8,7,1,6,5,1,3,10,13,8,5,16,3,1,,,3,2,1,,,
"Jan 13, 2023 12:00 PM",51,23,28,22,9,13,25,14,11,15,9,6,0,0,0,5,17,16,1,8,7,1,14,11,9,5,4,16,0,2,,,3,3,0,,,
"Jan 13, 2023 1:00 PM",77,37,40,43,25,18,57,29,28,33,19,14,0,0,0,7,11,10,1,14,13,1,10,28,16,12,4,26,3,2,,,2,1,1,,,
"Jan 13, 2023 2:00 PM",44,21,23,38,16,22,46,25,21,40,25,15,0,0,0,10,13,12,1,8,8,0,9,26,26,8,18,23,2,1,,,6,3,3,,,
"Jan 13, 2023 3:00 PM",65,21,44,35,13,22,44,17,27,27,9,18,0,0,0,13,19,17,2,12,11,1,17,26,27,13,14,25,3,0,,,5,4,1,,,
"Jan 13, 2023 4:00 PM",102,24,78,22,12,10,41,21,20,34,21,13,0,0,0,9,20,15,5,26,24,2,13,30,18,6,12,35,3,4,,,5,4,1,,,
"Jan 13, 2023 5:00 PM",124,41,83,39,23,16,49,28,21,44,26,18,0,0,0,27,13,11,2,46,44,2,11,36,29,22,7,35,6,4,,,6,4,2,,,
"Jan 13, 2023 6:00 PM",88,26,62,25,22,3,40,27,13,32,19,13,0,0,0,8,17,16,1,43,43,0,13,38,21,11,10,14,1,2,,,5,3,2,,,
"Jan 13, 2023 7:00 PM",64,19,45,16,11,5,24,19,5,14,9,5,0,0,0,12,9,7,2,22,21,1,7,20,9,9,0,5,1,3,,,7,4,3,,,
"Jan 13, 2023 8:00 PM",31,12,19,8,6,2,14,9,5,10,6,4,0,0,0,8,4,4,0,6,6,0,5,13,5,5,0,7,1,3,,,1,0,1,,,
"Jan 13, 2023 9:00 PM",37,16,21,5,4,1,4,1,3,3,0,3,0,0,0,1,4,2,2,6,6,0,3,5,1,1,0,9,2,0,,,1,0,1,,,
"Jan 13, 2023 10:00 PM",15,2,13,3,3,0,4,3,1,3,3,0,0,0,0,2,8,8,0,3,1,2,7,6,1,1,0,5,0,0,,,3,1,2,,,
"Jan 13, 2023 11:00 PM",11,3,8,3,1,2,7,4,3,4,1,3,0,0,0,2,2,2,0,5,4,1,2,2,2,1,1,6,1,0,,,0,0,0,,,
"Jan 14, 2023 12:00 AM",8,1,7,0,0,0,1,0,1,0,0,0,0,0,0,0,0,0,0,4,3,1,0,2,1,1,0,2,0,0,,,0,0,0,,,
"Jan 14, 2023 1:00 AM",4,1,3,0,0,0,0,0,0,0,0,0,0,0,0,0,2,0,2,3,3,0,0,1,0,0,0,2,0,1,,,1,0,1,,,
"Jan 14, 2023 2:00 AM",2,2,0,0,0,0,2,2,0,2,2,0,0,0,0,0,1,1,0,2,2,0,1,0,1,1,0,2,0,0,,,0,0,0,,,
"Jan 14, 2023 3:00 AM",1,0,1,0,0,0,0,0,0,0,0,0,0,0,0,1,0,0,0,2,1,1,0,1,0,0,0,0,0,0,,,0,0,0,,,
"Jan 14, 2023 4:00 AM",2,0,2,0,0,0,0,0,0,0,0,0,0,0,0,0,1,1,0,0,0,0,1,0,1,1,0,0,1,0,,,0,0,0,,,
"Jan 14, 2023 5:00 AM",0,0,0,0,0,0,1,0,1,1,0,1,0,0,0,2,0,0,0,2,2,0,0,2,0,0,0,1,0,0,,,0,0,0,,,
"Jan 14, 2023 6:00 AM",5,3,2,2,1,1,4,2,2,3,1,2,0,0,0,2,1,1,0,0,0,0,1,1,0,0,0,5,0,1,,,0,0,0,,,
"Jan 14, 2023 7:00 AM",13,6,7,5,3,2,7,6,1,8,6,2,0,0,0,3,5,3,2,3,3,0,3,7,1,0,1,8,1,1,,,0,0,0,,,
"Jan 14, 2023 8:00 AM",27,16,11,38,23,15,32,19,13,34,22,12,0,0,0,11,7,7,0,4,4,0,9,11,5,4,1,19,1,5,,,2,1,1,,,
"Jan 14, 2023 9:00 AM",28,17,11,45,30,15,43,28,15,41,32,9,0,0,0,6,6,6,0,6,5,1,7,12,20,11,9,24,1,2,,,2,0,2,,,
"Jan 14, 2023 10:00 AM",35,25,10,69,31,38,75,41,34,70,40,30,0,0,0,11,14,14,0,13,10,3,14,17,23,13,10,24,3,1,,,4,4,0,,,
"Jan 14, 2023 11:00 AM",45,29,16,61,33,28,78,44,34,74,45,29,0,0,0,7,10,10,0,5,5,0,7,31,26,17,9,20,3,1,,,3,2,1,,,
"Jan 14, 2023 12:00 PM",48,28,20,61,31,30,54,21,33,64,30,34,0,0,0,14,13,12,1,16,11,5,8,18,23,9,14,16,4,1,,,2,1,1,,,
"Jan 14, 2023 1:00 PM",52,25,27,47,20,27,52,24,28,27,9,18,0,0,0,12,11,11,0,10,9,1,12,10,18,8,10,17,4,1,,,2,1,1,,,
"Jan 14, 2023 2:00 PM",50,27,23,32,16,16,29,14,15,22,12,10,0,0,0,14,16,13,3,10,6,4,11,8,13,6,7,21,1,2,,,3,3,0,,,
"Jan 14, 2023 3:00 PM",35,13,22,38,25,13,49,30,19,36,24,12,0,0,0,10,10,9,1,11,10,1,8,10,17,9,8,13,1,2,,,5,3,2,,,
"Jan 14, 2023 4:00 PM",27,9,18,21,10,11,40,16,24,27,10,17,0,0,0,27,12,8,4,6,4,2,9,9,14,5,9,14,1,0,,,2,1,1,,,
"Jan 14, 2023 5:00 PM",30,13,17,26,18,8,34,12,22,17,8,9,0,0,0,6,8,8,0,9,9,0,7,5,8,5,3,20,1,1,,,6,3,3,,,
"Jan 14, 2023 6:00 PM",38,13,25,5,3,2,9,5,4,10,3,7,0,0,0,9,4,4,0,8,6,2,6,10,5,5,0,12,5,3,,,1,1,0,,,
"Jan 14, 2023 7:00 PM",35,20,15,3,3,0,5,1,4,6,3,3,0,0,0,6,3,3,0,8,4,4,2,6,2,0,2,5,1,0,,,1,0,1,,,
"Jan 14, 2023 8:00 PM",19,11,8,6,3,3,6,2,4,6,2,4,0,0,0,1,10,10,0,4,4,0,8,6,2,1,1,4,0,1,,,1,0,1,,,
"Jan 14, 2023 9:00 PM",13,7,6,6,3,3,3,2,1,3,0,3,0,0,0,2,2,2,0,6,5,1,2,1,1,1,0,4,0,0,,,3,2,1,,,
"Jan 14, 2023 10:00 PM",12,4,8,1,1,0,2,1,1,1,1,0,0,0,0,3,4,4,0,2,1,1,4,1,2,1,1,2,1,0,,,0,0,0,,,
"Jan 14, 2023 11:00 PM",13,2,11,2,1,1,5,2,3,3,0,3,0,0,0,4,2,2,0,1,1,0,3,3,0,0,0,3,0,0,,,0,0,0,,,
"Jan 15, 2023 12:00 AM",9,2,7,0,0,0,2,1,1,1,1,0,0,0,0,0,3,3,0,1,1,0,3,1,2,1,1,6,0,0,,,0,0,0,,,
"Jan 15, 2023 1:00 AM",7,2,5,4,2,2,4,4,0,6,4,2,0,0,0,0,0,0,0,2,2,0,0,4,1,1,0,3,1,0,,,0,0,0,,,
"Jan 15, 2023 2:00 AM",3,2,1,1,1,0,1,1,0,1,1,0,0,0,0,0,0,0,0,0,0,0,0,1,0,0,0,2,0,0,,,0,0,0,,,
"Jan 15, 2023 3:00 AM",2,0,2,0,0,0,0,0,0,0,0,0,0,0,0,0,0,0,0,1,1,0,0,0,1,1,0,1,0,0,,,0,0,0,,,
"Jan 15, 2023 4:00 AM",0,0,0,0,0,0,1,1,0,0,0,0,0,0,0,0,0,0,0,0,0,0,0,1,3,3,0,2,1,0,,,0,0,0,,,
"Jan 15, 2023 5:00 AM",2,0,2,0,0,0,0,0,0,0,0,0,0,0,0,1,0,0,0,0,0,0,0,0,1,1,0,2,0,0,,,0,0,0,,,
"Jan 15, 2023 6:00 AM",4,1,3,1,0,1,2,1,1,0,0,0,0,0,0,1,1,1,0,0,0,0,1,1,0,0,0,3,0,0,,,0,0,0,,,
"Jan 15, 2023 7:00 AM",11,8,3,5,2,3,3,2,1,6,4,2,0,0,0,0,3,3,0,2,2,0,3,5,3,1,2,9,0,1,,,0,0,0,,,
"Jan 15, 2023 8:00 AM",10,9,1,16,8,8,18,13,5,19,12,7,0,0,0,0,5,4,1,1,1,0,4,8,1,1,0,6,1,0,,,1,0,1,,,
"Jan 15, 2023 9:00 AM",10,5,5,35,19,16,22,11,11,22,15,7,0,0,0,11,2,2,0,6,3,3,2,8,10,7,3,21,4,8,,,1,0,1,,,
"Jan 15, 2023 10:00 AM",38,21,17,63,33,30,62,42,20,56,36,20,0,0,0,7,15,14,1,9,5,4,14,19,21,10,11,30,4,8,,,7,5,2,,,
"Jan 15, 2023 11:00 AM",37,23,14,69,36,33,75,41,34,65,35,30,0,0,0,10,17,15,2,4,3,1,11,20,25,12,13,19,7,3,,,4,1,3,,,
"Jan 15, 2023 12:00 PM",25,19,6,104,45,59,73,37,36,80,39,41,0,0,0,10,14,14,0,7,7,0,11,14,31,14,17,22,6,6,,,12,7,5,,,
"Jan 15, 2023 1:00 PM",40,17,23,94,51,43,74,35,39,57,36,21,0,0,0,8,9,8,1,15,14,1,7,32,29,8,21,23,2,3,,,8,6,2,,,
"Jan 15, 2023 2:00 PM",41,25,16,69,33,36,53,27,26,66,33,33,0,0,0,11,9,9,0,9,4,5,9,16,18,7,11,22,6,0,,,8,7,1,,,
"Jan 15, 2023 3:00 PM",35,19,16,54,24,30,61,25,36,51,19,32,0,0,0,10,13,12,1,9,9,0,12,13,23,16,7,13,1,1,,,14,8,6,,,
"Jan 15, 2023 4:00 PM",34,14,20,26,13,13,41,11,30,22,9,13,0,0,0,6,8,8,0,6,5,1,6,5,22,10,12,14,2,2,,,8,6,2,,,
"Jan 15, 2023 5:00 PM",34,15,19,22,16,6,28,9,19,25,6,19,0,0,0,9,4,3,1,10,7,3,3,8,12,7,5,12,7,1,,,5,3,2,,,
"Jan 15, 2023 6:00 PM",26,10,16,11,7,4,16,8,8,16,8,8,0,0,0,5,8,7,1,8,7,1,5,9,6,5,1,10,0,0,,,0,0,0,,,
"Jan 15, 2023 7:00 PM",27,8,19,8,4,4,2,0,2,4,1,3,0,0,0,3,6,5,1,4,4,0,6,6,0,0,0,6,3,0,,,4,2,2,,,
"Jan 15, 2023 8:00 PM",15,6,9,2,1,1,4,3,1,3,0,3,0,0,0,2,3,3,0,0,0,0,2,5,1,1,0,6,0,1,,,0,0,0,,,
"Jan 15, 2023 9:00 PM",13,6,7,5,4,1,2,1,1,3,1,2,0,0,0,8,4,3,1,3,3,0,3,3,2,0,2,4,0,0,,,0,0,0,,,
"Jan 15, 2023 10:00 PM",10,2,8,1,1,0,5,3,2,3,3,0,0,0,0,0,4,4,0,1,1,0,5,2,1,0,1,2,1,1,,,4,2,2,,,
"Jan 15, 2023 11:00 PM",5,0,5,0,0,0,1,0,1,1,0,1,0,0,0,2,0,0,0,1,1,0,0,1,0,0,0,1,0,0,,,0,0,0,,,
"Jan 16, 2023 12:00 AM",1,0,1,0,0,0,1,1,0,2,2,0,0,0,0,1,2,2,0,3,3,0,2,1,0,0,0,1,0,0,,,0,0,0,,,
"Jan 16, 2023 1:00 AM",2,0,2,0,0,0,1,1,0,0,0,0,0,0,0,0,0,0,0,1,1,0,0,0,1,1,0,2,0,1,,,0,0,0,,,
"Jan 16, 2023 2:00 AM",2,2,0,0,0,0,0,0,0,0,0,0,0,0,0,0,0,0,0,0,0,0,0,1,0,0,0,1,0,0,,,0,0,0,,,
"Jan 16, 2023 3:00 AM",0,0,0,0,0,0,0,0,0,0,0,0,0,0,0,0,0,0,0,1,1,0,0,0,1,1,0,0,0,0,,,0,0,0,,,
"Jan 16, 2023 4:00 AM",1,0,1,0,0,0,0,0,0,0,0,0,0,0,0,0,3,3,0,0,0,0,2,0,0,0,0,1,0,0,,,0,0,0,,,
"Jan 16, 2023 5:00 AM",10,8,2,0,0,0,1,1,0,1,1,0,0,0,0,0,5,5,0,1,0,1,3,2,0,0,0,5,0,0,,,0,0,0,,,
"Jan 16, 2023 6:00 AM",40,23,17,9,2,7,13,4,9,8,3,5,0,0,0,6,11,11,0,5,4,1,9,7,3,2,1,31,0,3,,,0,0,0,,,
"Jan 16, 2023 7:00 AM",88,65,23,23,3,20,35,7,28,24,4,20,0,0,0,11,64,64,0,13,12,1,54,16,14,5,9,87,2,2,,,5,5,0,,,
"Jan 16, 2023 8:00 AM",171,126,45,49,11,38,95,33,62,69,21,48,0,0,0,31,123,122,1,30,20,10,109,28,47,18,29,167,5,5,,,20,17,3,,,
"Jan 16, 2023 9:00 AM",90,75,15,30,7,23,51,24,27,44,26,18,0,0,0,13,45,44,1,20,15,5,34,17,36,17,19,52,1,1,,,2,2,0,,,
"Jan 16, 2023 10:00 AM",30,20,10,18,9,9,33,18,15,25,17,8,0,0,0,8,19,18,1,6,5,1,15,11,10,5,5,21,1,3,,,2,1,1,,,
"Jan 16, 2023 11:00 AM",27,18,9,24,4,20,30,16,14,24,14,10,0,0,0,8,13,12,1,5,5,0,9,5,11,6,5,9,4,1,,,2,2,0,,,
"Jan 16, 2023 12:00 PM",31,19,12,43,24,19,38,22,16,32,19,13,0,0,0,6,10,10,0,8,7,1,10,12,12,9,3,15,1,1,,,1,0,1,,,
"Jan 16, 2023 1:00 PM",41,29,12,49,26,23,50,27,23,42,20,22,0,0,0,7,11,11,0,10,9,1,8,21,21,12,9,17,1,2,,,4,2,2,,,
"Jan 16, 2023 2:00 PM",50,26,24,24,12,12,30,15,15,27,14,13,0,0,0,10,13,10,3,10,7,3,8,5,16,9,7,24,3,1,,,4,2,2,,,
"Jan 16, 2023 3:00 PM",64,33,31,30,17,13,27,18,9,18,13,5,0,0,0,19,13,12,1,20,19,1,12,23,12,7,5,20,1,0,,,3,3,0,,,
"Jan 16, 2023 4:00 PM",90,23,67,25,21,4,54,36,18,44,31,13,0,0,0,17,21,19,2,26,22,4,17,51,29,19,10,40,3,2,,,9,6,3,,,
"Jan 16, 2023 5:00 PM",168,32,136,44,30,14,76,47,29,48,29,19,0,0,0,22,33,26,7,85,83,2,26,85,55,39,16,40,4,4,,,10,4,6,,,
"Jan 16, 2023 6:00 PM",132,27,105,37,32,5,67,53,14,50,34,16,0,0,0,19,25,19,6,66,64,2,21,71,41,23,18,26,1,1,,,5,4,1,,,
"Jan 16, 2023 7:00 PM",75,17,58,22,13,9,34,20,14,22,14,8,0,0,0,7,18,11,7,34,32,2,12,37,17,10,7,11,5,2,,,4,3,1,,,
"Jan 16, 2023 8:00 PM",36,6,30,16,12,4,17,11,6,14,9,5,0,0,0,6,14,12,2,14,14,0,7,23,5,3,2,9,0,2,,,5,2,3,,,
"Jan 16, 2023 9:00 PM",30,8,22,7,5,2,7,4,3,7,5,2,0,0,0,4,3,3,0,8,7,1,3,10,5,2,3,7,2,1,,,3,2,1,,,
"Jan 16, 2023 10:00 PM",14,3,11,1,1,0,4,1,3,2,0,2,0,0,0,0,4,3,1,8,8,0,3,7,3,2,1,6,2,2,,,2,2,0,,,
"Jan 16, 2023 11:00 PM",8,0,8,1,1,0,1,0,1,1,0,1,0,0,0,0,1,1,0,7,7,0,1,2,1,1,0,3,1,0,,,1,0,1,,,
"Jan 17, 2023 12:00 AM",2,1,1,0,0,0,0,0,0,4,4,0,0,0,0,0,0,0,0,0,0,0,0,3,2,1,1,1,0,0,,,0,0,0,,,
"Jan 17, 2023 1:00 AM",0,0,0,0,0,0,0,0,0,0,0,0,0,0,0,0,1,1,0,1,1,0,1,2,0,0,0,0,0,1,,,0,0,0,,,
"Jan 17, 2023 2:00 AM",5,4,1,0,0,0,0,0,0,0,0,0,0,0,0,0,0,0,0,0,0,0,0,0,0,0,0,0,0,0,,,0,0,0,,,
"Jan 17, 2023 3:00 AM",1,0,1,0,0,0,0,0,0,0,0,0,0,0,0,0,0,0,0,0,0,0,0,0,0,0,0,0,0,0,,,0,0,0,,,
"Jan 17, 2023 4:00 AM",2,1,1,0,0,0,0,0,0,0,0,0,0,0,0,0,1,1,0,0,0,0,1,0,0,0,0,1,0,0,,,0,0,0,,,
"Jan 17, 2023 5:00 AM",7,4,3,1,0,1,4,0,4,2,0,2,0,0,0,1,3,3,0,4,2,2,3,4,2,1,1,10,0,0,,,0,0,0,,,
"Jan 17, 2023 6:00 AM",26,16,10,8,5,3,8,4,4,8,5,3,0,0,0,2,10,10,0,5,5,0,8,8,1,0,1,18,0,3,,,3,1,2,,,
"Jan 17, 2023 7:00 AM",87,68,19,29,3,26,36,5,31,29,4,25,0,0,0,16,47,47,0,11,9,2,40,19,23,7,16,91,3,2,,,6,6,0,,,
"Jan 17, 2023 8:00 AM",236,188,48,36,4,32,82,23,59,50,18,32,0,0,0,22,112,107,5,23,13,10,96,35,51,17,34,166,6,3,,,17,13,4,,,
"Jan 17, 2023 9:00 AM",98,81,17,27,8,19,36,20,16,33,24,9,0,0,0,6,44,41,3,9,6,3,30,18,29,9,20,47,2,1,,,1,0,1,,,
"Jan 17, 2023 10:00 AM",31,26,5,18,2,16,22,11,11,11,6,5,0,0,0,7,18,18,0,4,3,1,16,6,14,6,8,22,1,2,,,1,1,0,,,
"Jan 17, 2023 11:00 AM",22,13,9,14,9,5,29,9,20,20,8,12,0,0,0,1,14,13,1,6,4,2,10,8,10,4,6,23,1,1,,,4,3,1,,,
"Jan 17, 2023 12:00 PM",40,21,19,23,14,9,23,15,8,24,14,10,0,0,0,8,15,13,2,12,11,1,8,10,7,4,3,16,2,1,,,1,1,0,,,
"Jan 17, 2023 1:00 PM",41,18,23,35,15,20,35,20,15,30,15,15,0,0,0,10,14,13,1,8,7,1,11,19,16,6,10,17,2,1,,,5,1,4,,,
"Jan 17, 2023 2:00 PM",37,21,16,35,18,17,24,12,12,22,11,11,0,0,0,15,15,14,1,14,12,2,12,18,19,11,8,17,1,3,,,6,2,4,,,
"Jan 17, 2023 3:00 PM",64,25,39,26,17,9,27,16,11,33,21,12,0,0,0,12,13,12,1,17,14,3,8,22,16,10,6,17,1,1,,,4,0,4,,,
"Jan 17, 2023 4:00 PM",101,26,75,18,12,6,36,21,15,25,17,8,0,0,0,19,25,19,6,34,30,4,15,47,18,13,5,24,5,4,,,2,2,0,,,
"Jan 17, 2023 5:00 PM",161,29,132,35,30,5,57,34,23,46,26,20,0,0,0,23,20,20,0,51,46,5,20,84,27,13,14,40,6,1,,,7,5,2,,,
"Jan 17, 2023 6:00 PM",151,29,122,22,19,3,55,39,16,46,28,18,0,0,0,16,26,20,6,70,68,2,22,98,34,18,16,20,3,2,,,7,4,3,,,
"Jan 17, 2023 7:00 PM",78,18,60,12,12,0,20,16,4,17,12,5,0,0,0,9,9,7,2,39,39,0,6,35,15,9,6,20,1,3,,,8,6,2,,,
"Jan 17, 2023 8:00 PM",40,12,28,7,5,2,11,9,2,7,5,2,0,0,0,3,7,5,2,19,17,2,3,18,10,6,4,8,1,1,,,5,2,3,,,
"Jan 17, 2023 9:00 PM",28,7,21,7,7,0,10,9,1,10,9,1,0,0,0,1,7,7,0,9,9,0,7,15,3,1,2,0,1,1,,,1,1,0,,,
"Jan 17, 2023 10:00 PM",12,4,8,0,0,0,1,0,1,0,0,0,0,0,0,1,3,3,0,12,8,4,3,2,0,0,0,6,2,0,,,0,0,0,,,
"Jan 17, 2023 11:00 PM",9,0,9,3,3,0,3,1,2,3,1,2,0,0,0,0,4,4,0,3,3,0,3,2,1,1,0,3,0,0,,,0,0,0,,,
"Jan 18, 2023 12:00 AM",3,2,1,0,0,0,0,0,0,1,1,0,0,0,0,0,0,0,0,4,4,0,0,0,2,2,0,0,2,0,,,1,1,0,,,
"Jan 18, 2023 1:00 AM",3,0,3,0,0,0,0,0,0,1,0,1,0,0,0,0,1,1,0,0,0,0,1,3,0,0,0,0,0,0,,,0,0,0,,,
"Jan 18, 2023 2:00 AM",3,3,0,0,0,0,0,0,0,0,0,0,0,0,0,1,0,0,0,1,1,0,0,0,0,0,0,1,0,0,,,0,0,0,,,
"Jan 18, 2023 3:00 AM",0,0,0,0,0,0,0,0,0,0,0,0,0,0,0,0,0,0,0,0,0,0,0,2,0,0,0,1,0,0,,,0,0,0,,,
"Jan 18, 2023 4:00 AM",1,1,0,0,0,0,0,0,0,0,0,0,0,0,0,0,1,1,0,0,0,0,1,0,0,0,0,3,0,0,,,1,1,0,,,
"Jan 18, 2023 5:00 AM",5,3,2,0,0,0,0,0,0,0,0,0,0,0,0,2,7,7,0,2,1,1,7,2,1,1,0,4,0,0,,,0,0,0,,,
"Jan 18, 2023 6:00 AM",31,20,11,3,0,3,11,4,7,5,1,4,0,0,0,1,6,6,0,5,5,0,4,10,1,0,1,24,0,1,,,0,0,0,,,
"Jan 18, 2023 7:00 AM",91,63,28,15,1,14,24,5,19,19,5,14,0,0,0,10,49,49,0,10,9,1,42,15,11,5,6,77,1,0,,,5,4,1,,,
"Jan 18, 2023 8:00 AM",183,142,41,51,9,42,77,20,57,55,14,41,0,0,0,27,126,121,5,24,18,6,101,31,52,15,37,185,3,5,,,10,9,1,,,
"Jan 18, 2023 9:00 AM",91,72,19,21,3,18,46,20,26,32,19,13,0,0,0,3,40,40,0,13,13,0,29,18,30,10,20,49,3,5,,,1,1,0,,,
"Jan 18, 2023 10:00 AM",28,22,6,18,5,13,24,11,13,20,14,6,0,0,0,3,22,22,0,4,3,1,21,7,11,5,6,13,0,2,,,4,2,2,,,
"Jan 18, 2023 11:00 AM",23,18,5,17,9,8,21,9,12,14,5,9,0,0,0,4,14,14,0,9,7,2,11,7,6,2,4,11,2,0,,,3,3,0,,,
"Jan 18, 2023 12:00 PM",35,18,17,13,8,5,15,9,6,12,7,5,0,0,0,3,15,14,1,11,9,2,14,9,7,1,6,16,0,1,,,6,4,2,,,
"Jan 18, 2023 1:00 PM",37,17,20,29,18,11,26,18,8,24,18,6,0,0,0,6,6,6,0,15,13,2,6,24,16,10,6,15,1,1,,,5,1,4,,,
"Jan 18, 2023 2:00 PM",42,25,17,26,18,8,28,15,13,19,15,4,0,0,0,8,13,11,2,14,13,1,9,14,17,9,8,19,1,2,,,6,1,5,,,
"Jan 18, 2023 3:00 PM",44,14,30,22,14,8,25,18,7,18,13,5,0,0,0,9,18,18,0,23,22,1,12,23,14,10,4,14,0,1,,,3,2,1,,,
"Jan 18, 2023 4:00 PM",109,31,78,27,14,13,27,12,15,33,16,17,0,0,0,13,21,15,6,28,27,1,15,43,31,19,12,28,1,1,,,3,2,1,,,
"Jan 18, 2023 5:00 PM",167,33,134,41,34,7,67,41,26,49,32,17,0,0,0,22,25,21,4,58,56,2,22,88,43,25,18,37,7,6,,,11,5,6,,,
"Jan 18, 2023 6:00 PM",142,32,110,31,24,7,56,40,16,33,24,9,0,0,0,13,27,19,8,72,70,2,19,76,34,23,11,26,2,2,,,4,3,1,,,
"Jan 18, 2023 7:00 PM",83,25,58,22,17,5,29,22,7,21,14,7,0,0,0,10,8,7,1,34,33,1,8,26,11,7,4,19,1,2,,,7,3,4,,,
"Jan 18, 2023 8:00 PM",55,19,36,4,4,0,15,11,4,8,6,2,0,0,0,4,10,7,3,7,7,0,7,9,5,2,3,10,2,3,,,4,3,1,,,
"Jan 18, 2023 9:00 PM",35,9,26,2,2,0,5,2,3,2,1,1,0,0,0,4,4,3,1,3,3,0,4,10,5,4,1,0,5,0,,,2,1,1,,,
"Jan 18, 2023 10:00 PM",24,3,21,3,3,0,3,2,1,4,1,3,0,0,0,2,4,3,1,5,5,0,4,5,4,3,1,6,1,1,,,2,1,1,,,
"Jan 18, 2023 11:00 PM",5,0,5,2,2,0,7,6,1,6,5,1,0,0,0,1,1,1,0,4,4,0,0,4,4,3,1,1,1,0,,,0,0,0,,,
"Jan 19, 2023 12:00 AM",0,0,0,0,0,0,1,1,0,1,1,0,0,0,0,0,2,1,1,3,3,0,1,1,1,1,0,2,0,0,,,1,1,0,,,
"Jan 19, 2023 1:00 AM",1,0,1,0,0,0,1,0,1,1,0,1,0,0,0,0,0,0,0,0,0,0,0,1,1,0,1,0,0,0,,,2,1,1,,,
"Jan 19, 2023 2:00 AM",4,4,0,0,0,0,0,0,0,0,0,0,0,0,0,0,0,0,0,0,0,0,0,0,0,0,0,0,0,0,,,0,0,0,,,
"Jan 19, 2023 3:00 AM",0,0,0,0,0,0,0,0,0,0,0,0,0,0,0,0,0,0,0,0,0,0,0,0,1,1,0,0,0,0,,,0,0,0,,,
"Jan 19, 2023 4:00 AM",1,0,1,1,0,1,0,0,0,0,0,0,0,0,0,0,1,1,0,0,0,0,1,0,0,0,0,0,0,0,,,1,0,1,,,
"Jan 19, 2023 5:00 AM",8,5,3,0,0,0,1,0,1,0,0,0,0,0,0,0,3,3,0,2,1,1,3,1,0,0,0,6,0,0,,,0,0,0,,,
"Jan 19, 2023 6:00 AM",32,21,11,12,4,8,9,4,5,12,5,7,0,0,0,6,10,10,0,3,3,0,8,8,1,0,1,28,0,3,,,1,0,1,,,
"Jan 19, 2023 7:00 AM",86,60,26,20,5,15,34,5,29,22,6,16,0,0,0,13,54,51,3,13,10,3,46,17,18,2,16,78,1,0,,,2,2,0,,,
"Jan 19, 2023 8:00 AM",203,150,53,46,9,37,90,21,69,61,19,42,0,0,0,19,129,126,3,22,17,5,114,32,40,12,28,173,3,3,,,16,14,2,,,
"Jan 19, 2023 9:00 AM",81,68,13,32,8,24,59,31,28,33,17,16,0,0,0,9,52,51,1,20,16,4,44,19,29,8,21,56,0,3,,,5,3,2,,,
"Jan 19, 2023 10:00 AM",33,27,6,35,20,15,46,22,24,31,17,14,0,0,0,7,26,26,0,10,7,3,22,5,12,5,7,23,1,2,,,2,2,0,,,
"Jan 19, 2023 11:00 AM",32,21,11,20,12,8,23,10,13,16,8,8,0,0,0,6,14,13,1,8,6,2,11,7,10,7,3,17,2,5,,,0,0,0,,,
"Jan 19, 2023 12:00 PM",37,21,16,21,11,10,45,22,23,23,13,10,0,0,0,9,13,13,0,17,15,2,7,12,14,7,7,15,5,2,,,6,5,1,,,
"Jan 19, 2023 1:00 PM",51,20,31,46,22,24,51,28,23,35,17,18,0,0,0,12,16,15,1,12,11,1,12,17,26,15,11,15,3,1,,,7,6,1,,,
"Jan 19, 2023 2:00 PM",50,28,22,37,20,17,43,19,24,25,14,11,0,0,0,14,15,12,3,12,10,2,10,21,21,11,10,17,1,1,,,5,1,4,,,
"Jan 19, 2023 3:00 PM",51,20,31,25,16,9,36,24,12,29,18,11,0,0,0,15,21,18,3,14,11,3,12,29,28,16,12,19,3,1,,,6,4,2,,,
"Jan 19, 2023 4:00 PM",102,36,66,28,20,8,45,28,17,37,21,16,0,0,0,12,24,21,3,35,31,4,15,42,25,13,12,25,2,0,,,4,1,3,,,
"Jan 19, 2023 5:00 PM",149,28,121,27,20,7,61,40,21,42,30,12,0,0,0,24,23,18,5,71,70,1,22,67,41,27,14,33,0,1,,,9,6,3,,,
"Jan 19, 2023 6:00 PM",155,36,119,35,29,6,52,36,16,44,31,13,0,0,0,13,24,18,6,71,70,1,19,63,34,19,15,30,1,4,,,9,7,2,,,
"Jan 19, 2023 7:00 PM",68,20,48,20,11,9,29,17,12,25,9,16,0,0,0,5,15,14,1,32,31,1,11,34,13,13,0,20,2,3,,,8,5,3,,,
"Jan 19, 2023 8:00 PM",64,22,42,9,7,2,16,9,7,9,5,4,0,0,0,7,13,9,4,22,21,1,7,18,4,4,0,16,3,1,,,7,3,4,,,
"Jan 19, 2023 9:00 PM",25,5,20,8,6,2,9,9,0,8,7,1,0,0,0,4,7,7,0,5,5,0,6,6,4,3,1,11,1,3,,,5,3,2,,,
"Jan 19, 2023 10:00 PM",24,8,16,6,4,2,14,8,6,9,4,5,0,0,0,4,3,1,2,7,6,1,1,10,5,3,2,10,0,0,,,0,0,0,,,
"Jan 19, 2023 11:00 PM",13,4,9,7,4,3,4,1,3,3,2,1,0,0,0,0,0,0,0,9,9,0,0,4,2,2,0,5,1,0,,,1,1,0,,,
"Jan 20, 2023 12:00 AM",1,0,1,0,0,0,0,0,0,0,0,0,0,0,0,2,2,2,0,2,2,0,2,1,0,0,0,2,0,0,,,1,0,1,,,
"Jan 20, 2023 1:00 AM",3,0,3,0,0,0,1,1,0,1,1,0,0,0,0,0,0,0,0,3,3,0,0,2,0,0,0,1,0,0,,,0,0,0,,,
"Jan 20, 2023 2:00 AM",2,1,1,0,0,0,1,0,1,1,0,1,0,0,0,0,0,0,0,1,1,0,0,1,0,0,0,0,0,0,,,0,0,0,,,
"Jan 20, 2023 3:00 AM",2,1,1,0,0,0,0,0,0,0,0,0,0,0,0,0,0,0,0,0,0,0,0,0,0,0,0,0,0,0,,,0,0,0,,,
"Jan 20, 2023 4:00 AM",2,1,1,0,0,0,0,0,0,0,0,0,0,0,0,0,1,1,0,0,0,0,1,0,0,0,0,0,0,0,,,0,0,0,,,
"Jan 20, 2023 5:00 AM",4,2,2,0,0,0,1,0,1,0,0,0,0,0,0,1,4,4,0,3,2,1,2,5,0,0,0,7,0,0,,,0,0,0,,,
"Jan 20, 2023 6:00 AM",23,12,11,5,1,4,9,4,5,9,4,5,0,0,0,2,9,9,0,2,2,0,7,7,4,2,2,20,0,2,,,0,0,0,,,
"Jan 20, 2023 7:00 AM",53,38,15,18,3,15,18,7,11,12,3,9,0,0,0,6,26,26,0,10,8,2,22,11,4,2,2,45,3,1,,,4,2,2,,,
"Jan 20, 2023 8:00 AM",114,78,36,41,7,34,68,18,50,45,12,33,0,0,0,24,80,75,5,25,21,4,63,23,35,12,23,90,1,2,,,15,12,3,,,
"Jan 20, 2023 9:00 AM",72,53,19,30,14,16,50,25,25,38,26,12,0,0,0,3,28,28,0,15,11,4,23,20,15,10,5,54,2,2,,,2,2,0,,,
"Jan 20, 2023 10:00 AM",37,24,13,25,14,11,33,21,12,20,16,4,0,0,0,5,17,16,1,6,6,0,10,9,7,5,2,17,1,2,,,2,1,1,,,
"Jan 20, 2023 11:00 AM",38,22,16,21,6,15,33,11,22,16,6,10,0,0,0,6,11,10,1,4,2,2,7,13,7,5,2,20,2,0,,,0,0,0,,,
"Jan 20, 2023 12:00 PM",51,31,20,20,10,10,37,14,23,14,6,8,0,0,0,6,15,15,0,5,3,2,10,10,13,5,8,22,4,3,,,3,2,1,,,
"Jan 20, 2023 1:00 PM",64,24,40,37,20,17,41,21,20,32,16,16,0,0,0,8,13,12,1,12,9,3,13,11,20,10,10,20,2,4,,,4,1,3,,,
"Jan 20, 2023 2:00 PM",53,27,26,32,17,15,56,33,23,40,22,18,0,0,0,6,15,12,3,18,14,4,16,23,20,12,8,30,6,2,,,7,4,3,,,
"Jan 20, 2023 3:00 PM",69,29,40,34,18,16,27,9,18,38,19,19,0,0,0,13,21,19,2,22,22,0,17,20,9,4,5,21,0,1,,,5,4,1,,,
"Jan 20, 2023 4:00 PM",81,29,52,35,24,11,47,29,18,37,25,12,0,0,0,16,16,15,1,25,22,3,11,26,29,16,13,29,3,2,,,4,2,2,,,
"Jan 20, 2023 5:00 PM",113,22,91,40,27,13,55,35,20,39,24,15,0,0,0,17,15,13,2,46,44,2,11,44,26,21,5,28,7,1,,,4,2,2,,,
"Jan 20, 2023 6:00 PM",91,28,63,27,19,8,35,22,13,32,21,11,0,0,0,12,20,16,4,48,43,5,12,49,15,9,6,17,1,4,,,8,2,6,,,
"Jan 20, 2023 7:00 PM",61,22,39,14,9,5,25,19,6,22,17,5,0,0,0,7,6,5,1,24,24,0,6,19,11,10,1,14,3,1,,,6,4,2,,,
"Jan 20, 2023 8:00 PM",44,15,29,4,3,1,16,9,7,9,4,5,0,0,0,3,8,8,0,10,10,0,8,13,8,5,3,9,1,0,,,5,3,2,,,
"Jan 20, 2023 9:00 PM",33,12,21,13,10,3,9,7,2,5,4,1,0,0,0,2,6,5,1,4,4,0,4,12,5,3,2,7,2,1,,,3,3,0,,,
"Jan 20, 2023 10:00 PM",23,7,16,6,3,3,9,7,2,6,3,3,0,0,0,3,4,4,0,1,1,0,4,3,7,6,1,3,0,0,,,0,0,0,,,
"Jan 20, 2023 11:00 PM",21,6,15,9,9,0,9,6,3,8,5,3,0,0,0,1,5,3,2,5,5,0,3,4,2,2,0,3,0,0,,,1,1,0,,,
"Jan 21, 2023 12:00 AM",9,0,9,0,0,0,1,1,0,3,3,0,0,0,0,2,1,0,1,5,5,0,0,4,3,3,0,0,0,0,,,2,2,0,,,
"Jan 21, 2023 1:00 AM",7,2,5,0,0,0,1,1,0,0,0,0,0,0,0,0,2,1,1,0,0,0,1,1,1,1,0,3,0,0,,,0,0,0,,,
"Jan 21, 2023 2:00 AM",4,1,3,0,0,0,0,0,0,0,0,0,0,0,0,0,2,2,0,2,2,0,2,0,0,0,0,0,0,0,,,0,0,0,,,
"Jan 21, 2023 3:00 AM",2,1,1,0,0,0,2,1,1,0,0,0,0,0,0,0,0,0,0,2,2,0,0,0,0,0,0,0,0,0,,,0,0,0,,,
"Jan 21, 2023 4:00 AM",2,1,1,0,0,0,0,0,0,0,0,0,0,0,0,0,1,1,0,0,0,0,1,0,0,0,0,0,0,0,,,0,0,0,,,
"Jan 21, 2023 5:00 AM",1,1,0,0,0,0,2,0,2,2,1,1,0,0,0,1,1,1,0,3,3,0,1,3,2,1,1,3,0,1,,,0,0,0,,,
"Jan 21, 2023 6:00 AM",7,3,4,3,2,1,5,3,2,4,2,2,0,0,0,0,1,1,0,3,3,0,1,3,3,2,1,2,1,1,,,1,1,0,,,
"Jan 21, 2023 7:00 AM",16,9,7,20,13,7,15,12,3,20,14,6,0,0,0,4,6,5,1,2,2,0,2,9,3,3,0,11,2,2,,,0,0,0,,,
"Jan 21, 2023 8:00 AM",26,13,13,43,25,18,35,22,13,33,26,7,0,0,0,5,14,14,0,6,5,1,11,11,8,7,1,14,1,2,,,2,0,2,,,
"Jan 21, 2023 9:00 AM",45,29,16,51,33,18,65,41,24,49,31,18,0,0,0,6,26,24,2,5,5,0,23,20,25,16,9,29,1,4,,,2,2,0,,,
"Jan 21, 2023 10:00 AM",45,26,19,75,37,38,79,45,34,54,35,19,0,0,0,4,15,14,1,12,9,3,15,25,21,10,11,24,0,5,,,4,3,1,,,
"Jan 21, 2023 11:00 AM",54,33,21,91,44,47,99,54,45,88,46,42,0,0,0,20,18,14,4,17,13,4,15,19,49,25,24,27,5,4,,,7,6,1,,,
"Jan 21, 2023 12:00 PM",61,38,23,68,33,35,75,38,37,68,30,38,0,0,0,15,21,19,2,12,10,2,15,25,45,25,20,34,2,2,,,4,4,0,,,
"Jan 21, 2023 1:00 PM",48,26,22,65,32,33,64,28,36,55,21,34,0,0,0,16,24,22,2,17,16,1,19,14,45,26,19,34,5,6,,,3,2,1,,,
"Jan 21, 2023 2:00 PM",59,41,18,57,29,28,54,23,31,51,28,23,0,0,0,18,22,21,1,11,9,2,17,10,24,6,18,34,1,1,,,3,2,1,,,
"Jan 21, 2023 3:00 PM",44,21,23,31,12,19,42,19,23,33,15,18,0,0,0,22,15,14,1,7,7,0,13,7,32,13,19,9,8,2,,,5,3,2,,,
"Jan 21, 2023 4:00 PM",27,15,12,14,8,6,32,20,12,26,14,12,0,0,0,11,7,6,1,10,10,0,8,9,17,6,11,15,2,1,,,6,4,2,,,
"Jan 21, 2023 5:00 PM",43,16,27,17,8,9,23,9,14,17,6,11,0,0,0,11,11,11,0,13,11,2,11,12,10,8,2,14,3,0,,,4,3,1,,,
"Jan 21, 2023 6:00 PM",38,10,28,11,9,2,21,16,5,11,9,2,0,0,0,26,6,6,0,5,5,0,6,13,6,5,1,14,0,0,,,4,2,2,,,
"Jan 21, 2023 7:00 PM",45,19,26,11,4,7,8,5,3,4,3,1,0,0,0,7,3,3,0,5,5,0,3,8,6,4,2,10,0,0,,,1,1,0,,,
"Jan 21, 2023 8:00 PM",29,15,14,1,1,0,5,3,2,5,4,1,0,0,0,1,3,3,0,6,5,1,3,7,2,2,0,10,0,0,,,1,0,1,,,
"Jan 21, 2023 9:00 PM",13,6,7,4,3,1,5,2,3,6,2,4,0,0,0,2,5,4,1,3,3,0,3,1,3,3,0,7,0,1,,,0,0,0,,,
"Jan 21, 2023 10:00 PM",12,5,7,1,1,0,4,2,2,3,1,2,0,0,0,3,4,4,0,7,7,0,4,4,2,1,1,5,0,1,,,1,0,1,,,
"Jan 21, 2023 11:00 PM",11,3,8,3,3,0,5,1,4,5,0,5,0,0,0,3,3,3,0,5,4,1,3,3,5,3,2,2,0,0,,,1,1,0,,,
"Jan 22, 2023 12:00 AM",14,3,11,0,0,0,1,1,0,7,3,4,0,0,0,0,1,1,0,2,2,0,1,3,4,3,1,4,0,0,,,1,1,0,,,
"Jan 22, 2023 1:00 AM",7,4,3,1,1,0,0,0,0,0,0,0,0,0,0,0,3,1,2,5,4,1,1,3,4,4,0,1,1,0,,,1,1,0,,,
"Jan 22, 2023 2:00 AM",15,2,13,1,1,0,2,2,0,2,2,0,0,0,0,0,1,1,0,1,1,0,1,1,1,1,0,1,0,0,,,0,0,0,,,
"Jan 22, 2023 3:00 AM",2,0,2,0,0,0,0,0,0,0,0,0,0,0,0,0,0,0,0,2,2,0,0,2,1,1,0,1,0,1,,,0,0,0,,,
"Jan 22, 2023 4:00 AM",1,1,0,0,0,0,0,0,0,0,0,0,0,0,0,0,0,0,0,0,0,0,0,0,2,2,0,0,0,0,,,0,0,0,,,
"Jan 22, 2023 5:00 AM",3,0,3,0,0,0,0,0,0,0,0,0,0,0,0,1,1,1,0,1,0,1,1,0,0,0,0,2,0,0,,,0,0,0,,,
"Jan 22, 2023 6:00 AM",4,3,1,3,1,2,3,1,2,3,1,2,0,0,0,2,3,3,0,1,0,1,4,2,2,1,1,6,1,0,,,1,1,0,,,
"Jan 22, 2023 7:00 AM",10,6,4,12,4,8,7,4,3,9,5,4,0,0,0,1,4,4,0,1,0,1,4,7,1,0,1,3,0,2,,,0,0,0,,,
"Jan 22, 2023 8:00 AM",17,9,8,22,19,3,33,20,13,30,23,7,0,0,0,4,9,8,1,8,6,2,3,11,8,5,3,17,0,0,,,0,0,0,,,
"Jan 22, 2023 9:00 AM",26,12,14,30,17,13,33,20,13,34,24,10,0,0,0,8,6,6,0,4,3,1,5,16,9,8,1,13,2,8,,,3,2,1,,,
"Jan 22, 2023 10:00 AM",35,20,15,83,42,41,82,55,27,76,39,37,0,0,0,5,24,24,0,7,7,0,20,30,24,19,5,35,2,4,,,3,3,0,,,
"Jan 22, 2023 11:00 AM",42,27,15,78,36,42,104,49,55,74,40,34,0,0,0,10,11,11,0,8,6,2,7,18,35,25,10,44,7,6,,,6,4,2,,,
"Jan 22, 2023 12:00 PM",66,26,40,82,34,48,105,57,48,71,37,34,0,0,0,12,22,20,2,6,5,1,16,21,48,32,16,25,9,0,,,7,7,0,,,
"Jan 22, 2023 1:00 PM",44,16,28,68,28,40,88,41,47,84,44,40,0,0,0,16,21,20,1,18,16,2,14,14,51,34,17,29,5,2,,,3,3,0,,,
"Jan 22, 2023 2:00 PM",45,31,14,76,42,34,85,47,38,75,48,27,0,0,0,6,23,22,1,14,12,2,19,17,43,20,23,28,0,2,,,3,1,2,,,
"Jan 22, 2023 3:00 PM",35,19,16,54,29,25,57,29,28,48,26,22,0,0,0,12,10,10,0,12,10,2,10,14,31,17,14,23,2,1,,,1,1,0,,,
"Jan 22, 2023 4:00 PM",43,21,22,42,23,19,55,17,38,47,13,34,0,0,0,9,8,8,0,18,14,4,4,12,19,6,13,23,3,1,,,5,4,1,,,
"Jan 22, 2023 5:00 PM",32,11,21,33,17,16,40,17,23,26,11,15,0,0,0,8,13,11,2,13,12,1,13,7,18,6,12,12,1,3,,,3,2,1,,,
"Jan 22, 2023 6:00 PM",35,19,16,15,8,7,10,4,6,12,5,7,0,0,0,4,5,5,0,5,4,1,3,8,6,4,2,7,0,0,,,2,1,1,,,
"Jan 22, 2023 7:00 PM",43,22,21,9,8,1,12,8,4,9,3,6,0,0,0,4,4,4,0,5,5,0,3,6,6,5,1,15,1,1,,,2,1,1,,,
"Jan 22, 2023 8:00 PM",15,5,10,1,1,0,2,1,1,0,0,0,0,0,0,6,6,3,3,4,4,0,4,4,2,1,1,6,0,1,,,3,0,3,,,
"Jan 22, 2023 9:00 PM",13,4,9,5,3,2,6,3,3,3,1,2,0,0,0,2,4,3,1,3,3,0,2,2,2,2,0,7,1,0,,,0,0,0,,,
"Jan 22, 2023 10:00 PM",5,0,5,2,2,0,3,1,2,3,2,1,0,0,0,2,5,5,0,1,1,0,6,3,2,1,1,2,0,0,,,0,0,0,,,
"Jan 22, 2023 11:00 PM",7,3,4,1,1,0,2,0,2,2,0,2,0,0,0,1,1,1,0,2,2,0,1,2,0,0,0,4,0,1,,,1,0,1,,,
"Jan 23, 2023 12:00 AM",4,1,3,0,0,0,3,2,1,1,1,0,0,0,0,0,1,1,0,1,1,0,0,2,1,0,1,0,0,0,,,0,0,0,,,
"Jan 23, 2023 1:00 AM",0,0,0,0,0,0,0,0,0,0,0,0,0,0,0,2,0,0,0,1,1,0,0,2,0,0,0,2,0,0,,,0,0,0,,,
"Jan 23, 2023 2:00 AM",2,1,1,0,0,0,0,0,0,0,0,0,0,0,0,0,0,0,0,0,0,0,0,0,0,0,0,1,0,0,,,0,0,0,,,
"Jan 23, 2023 3:00 AM",0,0,0,0,0,0,0,0,0,0,0,0,0,0,0,0,0,0,0,0,0,0,0,0,0,0,0,0,0,0,,,0,0,0,,,
"Jan 23, 2023 4:00 AM",0,0,0,0,0,0,0,0,0,0,0,0,0,0,0,0,2,2,0,0,0,0,2,0,0,0,0,0,0,0,,,0,0,0,,,
"Jan 23, 2023 5:00 AM",9,6,3,0,0,0,2,1,1,2,1,1,0,0,0,0,3,3,0,2,1,1,5,4,1,1,0,5,0,0,,,0,0,0,,,
"Jan 23, 2023 6:00 AM",35,21,14,12,1,11,15,3,12,13,1,12,0,0,0,4,14,14,0,4,3,1,12,9,9,3,6,32,1,2,,,2,2,0,,,
"Jan 23, 2023 7:00 AM",101,69,32,37,10,27,54,18,36,37,13,24,0,0,0,17,73,73,0,17,14,3,66,37,17,5,12,85,4,7,,,4,3,1,,,
"Jan 23, 2023 8:00 AM",232,175,57,67,11,56,115,25,90,88,28,60,0,0,0,32,168,162,6,42,29,13,141,40,84,19,65,187,10,5,,,15,14,1,,,
"Jan 23, 2023 9:00 AM",162,138,24,33,8,25,62,33,29,39,21,18,0,0,0,18,92,90,2,27,16,11,60,23,24,9,15,58,1,1,,,2,1,1,,,
"Jan 23, 2023 10:00 AM",60,47,13,42,18,24,54,28,26,47,27,20,0,0,0,2,39,36,3,11,9,2,24,15,19,7,12,31,3,1,,,5,3,2,,,
"Jan 23, 2023 11:00 AM",55,37,18,22,9,13,34,17,17,28,15,13,0,0,0,3,28,21,7,9,9,0,16,7,9,5,4,15,4,3,,,6,3,3,,,
"Jan 23, 2023 12:00 PM",63,33,30,41,21,20,45,23,22,25,13,12,0,0,0,13,24,22,2,17,13,4,13,13,19,11,8,26,2,2,,,1,1,0,,,
"Jan 23, 2023 1:00 PM",71,36,35,47,22,25,50,28,22,37,19,18,0,0,0,11,34,26,8,16,15,1,14,13,18,12,6,13,3,6,,,5,4,1,,,
"Jan 23, 2023 2:00 PM",82,36,46,43,23,20,47,24,23,39,24,15,0,0,0,10,23,18,5,17,16,1,13,22,23,12,11,18,2,4,,,6,4,2,,,
"Jan 23, 2023 3:00 PM",100,41,59,30,20,10,50,26,24,40,25,15,0,0,0,23,36,26,10,35,28,7,17,31,21,9,12,20,3,3,,,6,4,2,,,
"Jan 23, 2023 4:00 PM",133,32,101,34,27,7,54,39,15,52,38,14,0,0,0,17,28,23,5,56,51,5,16,54,34,21,13,46,6,7,,,9,5,4,,,
"Jan 23, 2023 5:00 PM",217,40,177,47,36,11,80,52,28,56,33,23,0,0,0,26,45,32,13,92,91,1,29,87,44,36,8,35,6,5,,,9,4,5,,,
"Jan 23, 2023 6:00 PM",187,45,142,37,34,3,91,69,22,56,37,19,0,0,0,19,42,25,17,98,92,6,28,91,55,45,10,31,1,1,,,7,6,1,,,
"Jan 23, 2023 7:00 PM",101,23,78,21,10,11,31,21,10,23,13,10,0,0,0,7,29,24,5,47,46,1,21,37,14,13,1,16,5,6,,,7,3,4,,,
"Jan 23, 2023 8:00 PM",67,23,44,11,9,2,22,13,9,9,6,3,0,0,0,7,14,12,2,24,23,1,7,18,18,12,6,17,0,2,,,4,3,1,,,
"Jan 23, 2023 9:00 PM",40,5,35,3,2,1,12,7,5,6,4,2,0,0,0,4,5,3,2,9,8,1,3,15,5,4,1,14,3,0,,,3,2,1,,,
"Jan 23, 2023 10:00 PM",35,8,27,1,1,0,5,3,2,3,2,1,0,0,0,2,9,6,3,10,9,1,4,4,6,4,2,4,0,1,,,3,2,1,,,
"Jan 23, 2023 11:00 PM",8,2,6,5,4,1,6,5,1,5,3,2,0,0,0,2,2,0,2,2,1,1,0,6,3,1,2,5,1,0,,,1,1,0,,,
"Jan 24, 2023 12:00 AM",4,1,3,0,0,0,1,1,0,1,0,1,0,0,0,0,0,0,0,2,2,0,0,1,1,0,1,1,0,0,,,1,1,0,,,
"Jan 24, 2023 1:00 AM",2,1,1,0,0,0,0,0,0,0,0,0,0,0,0,1,0,0,0,2,2,0,0,1,0,0,0,0,0,0,,,0,0,0,,,
"Jan 24, 2023 2:00 AM",2,2,0,0,0,0,0,0,0,0,0,0,0,0,0,0,0,0,0,0,0,0,0,0,0,0,0,0,0,0,,,0,0,0,,,
"Jan 24, 2023 3:00 AM",1,0,1,0,0,0,0,0,0,0,0,0,0,0,0,0,0,0,0,0,0,0,0,1,0,0,0,0,0,0,,,0,0,0,,,
"Jan 24, 2023 4:00 AM",2,1,1,0,0,0,0,0,0,0,0,0,0,0,0,0,1,1,0,0,0,0,1,0,1,1,0,0,0,0,,,0,0,0,,,
"Jan 24, 2023 5:00 AM",8,5,3,3,1,2,5,1,4,3,1,2,0,0,0,0,5,5,0,2,1,1,4,3,2,0,2,5,0,0,,,0,0,0,,,
"Jan 24, 2023 6:00 AM",68,40,28,13,4,9,15,2,13,15,5,10,0,0,0,4,15,14,1,4,4,0,18,10,6,2,4,36,0,2,,,2,0,2,,,
"Jan 24, 2023 7:00 AM",161,117,44,31,4,27,58,11,47,36,8,28,0,0,0,15,97,97,0,19,12,7,90,30,25,7,18,118,1,4,,,3,3,0,,,
"Jan 24, 2023 8:00 AM",312,255,57,78,14,64,135,42,93,96,35,61,0,0,0,35,209,202,7,34,24,10,171,43,85,25,60,248,8,6,,,21,18,3,,,
"Jan 24, 2023 9:00 AM",142,121,21,47,16,31,68,36,32,62,40,22,0,0,0,15,101,97,4,20,15,5,77,28,37,9,28,89,2,4,,,4,3,1,,,
"Jan 24, 2023 10:00 AM",64,54,10,49,19,30,45,31,14,38,22,16,0,0,0,7,47,43,4,14,9,5,31,20,16,11,5,31,2,2,,,1,1,0,,,
"Jan 24, 2023 11:00 AM",56,43,13,48,22,26,59,27,32,36,18,18,0,0,0,8,29,25,4,10,9,1,16,18,23,13,10,31,1,3,,,4,3,1,,,
"Jan 24, 2023 12:00 PM",74,37,37,50,19,31,63,24,39,41,20,21,0,0,0,16,28,24,4,11,10,1,16,18,34,12,22,22,3,7,,,2,0,2,,,
"Jan 24, 2023 1:00 PM",80,34,46,79,47,32,61,38,23,47,23,24,0,0,0,11,38,31,7,26,23,3,21,18,35,18,17,25,9,3,,,7,6,1,,,
"Jan 24, 2023 2:00 PM",87,34,53,59,26,33,68,39,29,45,26,19,0,0,0,13,38,31,7,34,31,3,24,28,52,31,21,34,2,7,,,8,1,7,,,
"Jan 24, 2023 3:00 PM",87,35,52,38,22,16,62,34,28,50,27,23,0,0,0,18,41,26,15,43,42,1,19,34,41,25,16,27,3,3,,,11,5,6,,,
"Jan 24, 2023 4:00 PM",154,39,115,33,23,10,64,39,25,41,24,17,0,0,0,26,38,27,11,61,58,3,20,74,34,22,12,38,2,2,,,6,2,4,,,
"Jan 24, 2023 5:00 PM",248,48,200,56,41,15,93,57,36,67,43,24,0,0,0,27,40,33,7,103,98,5,30,116,50,32,18,55,8,4,,,11,9,2,,,
"Jan 24, 2023 6:00 PM",208,41,167,43,38,5,97,74,23,62,45,17,0,0,0,27,53,41,12,108,103,5,39,112,58,43,15,40,0,1,,,6,6,0,,,
"Jan 24, 2023 7:00 PM",117,33,84,31,25,6,48,38,10,38,24,14,0,0,0,14,20,16,4,61,59,2,15,58,26,22,4,24,3,2,,,8,5,3,,,
"Jan 24, 2023 8:00 PM",73,21,52,44,36,8,49,36,13,52,40,12,0,0,0,8,17,15,2,26,24,2,11,18,14,12,2,19,1,4,,,4,0,4,,,
"Jan 24, 2023 9:00 PM",37,6,31,27,6,21,36,8,28,24,8,16,0,0,0,5,12,10,2,13,13,0,9,19,3,2,1,26,1,1,,,3,1,2,,,
"Jan 24, 2023 10:00 PM",28,6,22,5,4,1,5,5,0,2,2,0,0,0,0,2,8,5,3,11,9,2,3,7,3,3,0,4,1,1,,,0,0,0,,,
"Jan 24, 2023 11:00 PM",13,1,12,1,0,1,0,0,0,2,0,2,0,0,0,0,1,1,0,8,6,2,2,4,2,2,0,3,1,0,,,1,1,0,,,
"Jan 25, 2023 12:00 AM",11,1,10,0,0,0,0,0,0,1,1,0,0,0,0,0,1,1,0,4,3,1,1,3,1,1,0,0,0,0,,,0,0,0,,,
"Jan 25, 2023 1:00 AM",2,1,1,0,0,0,0,0,0,0,0,0,0,0,0,0,1,0,1,0,0,0,0,3,0,0,0,0,0,0,,,2,0,2,,,
"Jan 25, 2023 2:00 AM",5,3,2,0,0,0,1,1,0,1,1,0,0,0,0,0,0,0,0,0,0,0,0,0,0,0,0,0,0,0,,,1,1,0,,,
"Jan 25, 2023 3:00 AM",0,0,0,1,0,1,0,0,0,0,0,0,0,0,0,0,0,0,0,0,0,0,0,0,0,0,0,0,0,0,,,0,0,0,,,
"Jan 25, 2023 4:00 AM",4,1,3,0,0,0,0,0,0,0,0,0,0,0,0,0,2,2,0,0,0,0,2,1,0,0,0,0,0,0,,,1,1,0,,,
"Jan 25, 2023 5:00 AM",6,4,2,1,0,1,3,1,2,3,1,2,0,0,0,1,5,5,0,4,3,1,5,3,1,1,0,7,0,0,,,0,0,0,,,
"Jan 25, 2023 6:00 AM",49,38,11,15,4,11,14,3,11,12,3,9,0,0,0,4,17,17,0,6,6,0,14,17,5,1,4,26,0,1,,,0,0,0,,,
"Jan 25, 2023 7:00 AM",142,105,37,52,9,43,67,13,54,48,16,32,0,0,0,16,86,86,0,27,21,6,81,31,22,7,15,118,3,6,,,7,4,3,,,
"Jan 25, 2023 8:00 AM",299,250,49,81,19,62,140,35,105,90,32,58,0,0,0,45,217,212,5,36,30,6,178,42,77,24,53,220,7,10,,,20,16,4,,,
"Jan 25, 2023 9:00 AM",139,124,15,51,17,34,72,30,42,51,26,25,0,0,0,13,94,94,0,18,13,5,62,18,45,15,30,84,3,3,,,5,4,1,,,
"Jan 25, 2023 10:00 AM",67,49,18,22,10,12,35,13,22,28,16,12,0,0,0,8,45,41,4,13,10,3,17,7,21,12,9,28,0,0,,,4,1,3,,,
"Jan 25, 2023 11:00 AM",42,29,13,24,9,15,33,19,14,14,11,3,0,0,0,6,26,21,5,6,6,0,14,4,9,4,5,27,5,2,,,6,6,0,,,
"Jan 25, 2023 12:00 PM",57,29,28,20,11,9,26,13,13,24,14,10,0,0,0,8,39,30,9,13,9,4,17,10,18,11,7,22,0,1,,,2,2,0,,,
"Jan 25, 2023 1:00 PM",72,28,44,51,23,28,58,30,28,35,18,17,0,0,0,15,41,36,5,24,22,2,25,29,22,11,11,27,6,3,,,8,4,4,,,
"Jan 25, 2023 2:00 PM",63,30,33,29,18,11,48,29,19,35,21,14,0,0,0,17,17,9,8,26,20,6,8,26,27,13,14,26,3,5,,,7,4,3,,,
"Jan 25, 2023 3:00 PM",103,34,69,36,21,15,56,33,23,31,21,10,0,0,0,17,29,22,7,32,31,1,12,40,21,13,8,21,5,0,,,6,0,6,,,
"Jan 25, 2023 4:00 PM",150,35,115,40,25,15,61,38,23,45,23,22,0,0,0,16,35,25,10,53,48,5,21,54,29,21,8,39,2,3,,,4,2,2,,,
"Jan 25, 2023 5:00 PM",253,46,207,38,30,8,83,52,31,62,40,22,0,0,0,25,45,31,14,126,122,4,28,127,62,44,18,43,10,0,,,6,4,2,,,
"Jan 25, 2023 6:00 PM",207,44,163,41,35,6,87,60,27,64,44,20,0,0,0,20,40,32,8,109,106,3,27,90,48,31,17,38,6,3,,,5,5,0,,,
"Jan 25, 2023 7:00 PM",108,27,81,22,14,8,36,28,8,26,18,8,0,0,0,9,22,14,8,49,47,2,14,43,25,20,5,18,1,2,,,8,2,6,,,
"Jan 25, 2023 8:00 PM",73,15,58,10,8,2,23,17,6,15,12,3,0,0,0,8,19,15,4,21,19,2,12,21,12,9,3,17,4,3,,,4,2,2,,,
"Jan 25, 2023 9:00 PM",43,9,34,13,9,4,19,13,6,16,11,5,0,0,0,5,5,3,2,23,19,4,2,15,13,9,4,7,5,1,,,4,3,1,,,
"Jan 25, 2023 10:00 PM",38,10,28,3,3,0,10,8,2,10,8,2,0,0,0,0,9,8,1,13,13,0,7,8,7,4,3,5,0,1,,,1,1,0,,,
"Jan 25, 2023 11:00 PM",11,4,7,2,2,0,3,1,2,3,1,2,0,0,0,1,3,2,1,5,5,0,3,2,3,3,0,2,1,0,,,3,2,1,,,
"Jan 26, 2023 12:00 AM",7,0,7,1,1,0,1,1,0,1,1,0,0,0,0,0,0,0,0,5,5,0,0,4,0,0,0,1,0,0,,,0,0,0,,,
"Jan 26, 2023 1:00 AM",3,1,2,0,0,0,4,1,3,3,0,3,0,0,0,0,1,0,1,2,2,0,0,0,1,1,0,0,0,0,,,1,0,1,,,
"Jan 26, 2023 2:00 AM",4,3,1,0,0,0,0,0,0,0,0,0,0,0,0,0,0,0,0,0,0,0,0,2,0,0,0,0,0,0,,,0,0,0,,,
"Jan 26, 2023 3:00 AM",3,1,2,1,1,0,1,1,0,1,1,0,0,0,0,0,0,0,0,4,3,1,0,0,1,1,0,0,0,0,,,0,0,0,,,
"Jan 26, 2023 4:00 AM",4,2,2,1,0,1,0,0,0,0,0,0,0,0,0,1,3,3,0,1,1,0,3,0,0,0,0,1,0,0,,,0,0,0,,,
"Jan 26, 2023 5:00 AM",9,7,2,0,0,0,2,1,1,2,1,1,0,0,0,1,7,7,0,4,3,1,6,2,1,1,0,8,1,0,,,1,1,0,,,
"Jan 26, 2023 6:00 AM",36,21,15,8,3,5,11,4,7,9,6,3,0,0,0,3,18,18,0,7,5,2,17,19,6,0,6,25,0,2,,,0,0,0,,,
"Jan 26, 2023 7:00 AM",130,92,38,24,2,22,53,10,43,38,8,30,0,0,0,14,63,62,1,16,10,6,59,36,18,4,14,115,2,2,,,7,7,0,,,
"Jan 26, 2023 8:00 AM",288,225,63,68,12,56,136,40,96,92,28,64,0,0,0,32,204,201,3,31,22,9,146,47,73,28,45,236,6,5,,,17,15,2,,,
"Jan 26, 2023 9:00 AM",154,123,31,35,11,24,62,27,35,49,25,24,0,0,0,16,83,82,1,11,9,2,63,14,35,14,21,80,2,3,,,4,2,2,,,
"Jan 26, 2023 10:00 AM",72,54,18,42,17,25,45,19,26,43,23,20,0,0,0,12,52,49,3,14,9,5,28,12,20,12,8,31,0,1,,,3,3,0,,,
"Jan 26, 2023 11:00 AM",53,33,20,38,22,16,45,23,22,33,19,14,0,0,0,5,24,20,4,6,4,2,12,10,17,8,9,21,1,2,,,1,1,0,,,
"Jan 26, 2023 12:00 PM",65,33,32,54,19,35,57,27,30,35,16,19,0,0,0,12,38,37,1,24,21,3,25,9,25,11,14,20,1,4,,,5,5,0,,,
"Jan 26, 2023 1:00 PM",86,39,47,33,19,14,52,27,25,52,22,30,0,0,0,11,30,21,9,15,15,0,11,19,22,16,6,24,5,0,,,6,6,0,,,
"Jan 26, 2023 2:00 PM",71,25,46,31,16,15,57,24,33,30,17,13,0,0,0,18,26,21,5,25,24,1,15,24,32,14,18,16,1,3,,,7,3,4,,,
"Jan 26, 2023 3:00 PM",104,30,74,34,20,14,63,41,22,41,24,17,0,0,0,13,31,21,10,29,23,6,21,36,36,21,15,37,2,3,,,8,4,4,,,
"Jan 26, 2023 4:00 PM",150,37,113,43,26,17,59,37,22,37,27,10,0,0,0,14,37,22,15,56,50,6,21,49,26,19,7,38,9,3,,,9,4,5,,,
"Jan 26, 2023 5:00 PM",192,45,147,46,35,11,96,66,30,66,46,20,0,0,0,24,42,33,9,101,98,3,28,120,54,42,12,53,3,0,,,8,5,3,,,
"Jan 26, 2023 6:00 PM",196,42,154,54,42,12,87,60,27,73,50,23,0,0,0,14,25,19,6,93,90,3,14,91,47,34,13,35,3,3,,,3,2,1,,,
"Jan 26, 2023 7:00 PM",104,28,76,33,26,7,49,38,11,44,32,12,0,0,0,7,19,17,2,44,37,7,14,45,22,18,4,27,1,1,,,12,11,1,,,
"Jan 26, 2023 8:00 PM",81,27,54,8,4,4,30,21,9,16,7,9,0,0,0,3,17,14,3,26,25,1,11,23,10,8,2,13,3,1,,,6,3,3,,,
"Jan 26, 2023 9:00 PM",29,7,22,10,9,1,20,10,10,15,8,7,0,0,0,3,8,7,1,13,11,2,7,13,10,10,0,12,4,2,,,0,0,0,,,
"Jan 26, 2023 10:00 PM",39,7,32,6,6,0,7,4,3,8,5,3,0,0,0,4,12,6,6,15,13,2,5,11,5,3,2,3,0,1,,,0,0,0,,,
"Jan 26, 2023 11:00 PM",16,0,16,2,1,1,8,3,5,6,2,4,0,0,0,0,2,2,0,9,9,0,1,7,4,3,1,3,1,0,,,2,2,0,,,
"Jan 27, 2023 12:00 AM",6,1,5,0,0,0,2,2,0,4,4,0,0,0,0,0,1,1,0,5,4,1,1,6,1,1,0,1,0,0,,,1,0,1,,,
"Jan 27, 2023 1:00 AM",4,2,2,0,0,0,1,0,1,1,0,1,0,0,0,0,2,0,2,3,3,0,0,2,0,0,0,3,0,0,,,0,0,0,,,
"Jan 27, 2023 2:00 AM",3,2,1,0,0,0,0,0,0,0,0,0,0,0,0,0,1,0,1,0,0,0,0,2,0,0,0,1,0,0,,,0,0,0,,,
"Jan 27, 2023 3:00 AM",3,1,2,1,1,0,1,1,0,1,1,0,0,0,0,0,0,0,0,2,2,0,0,1,0,0,0,0,0,0,,,0,0,0,,,
"Jan 27, 2023 4:00 AM",3,1,2,0,0,0,0,0,0,0,0,0,0,0,0,0,2,2,0,1,1,0,2,1,0,0,0,0,0,0,,,1,1,0,,,
"Jan 27, 2023 5:00 AM",8,5,3,0,0,0,0,0,0,0,0,0,0,0,0,2,6,6,0,4,4,0,8,3,0,0,0,8,0,0,,,1,0,1,,,
"Jan 27, 2023 6:00 AM",40,24,16,17,5,12,19,8,11,15,7,8,0,0,0,3,14,14,0,3,3,0,11,10,6,4,2,34,0,1,,,0,0,0,,,
"Jan 27, 2023 7:00 AM",90,60,30,41,16,25,50,15,35,39,10,29,0,0,0,15,45,45,0,16,11,5,43,21,18,7,11,67,1,3,,,7,4,3,,,
"Jan 27, 2023 8:00 AM",187,144,43,72,27,45,108,33,75,83,44,39,0,0,0,35,123,115,8,26,20,6,93,30,54,20,34,141,6,6,,,16,11,5,,,
"Jan 27, 2023 9:00 AM",87,71,16,46,13,33,69,31,38,48,25,23,0,0,0,10,54,54,0,18,15,3,44,28,21,8,13,53,3,4,,,6,4,2,,,
"Jan 27, 2023 10:00 AM",64,45,19,30,13,17,38,15,23,37,16,21,0,0,0,3,31,26,5,6,5,1,20,13,11,8,3,31,1,0,,,0,0,0,,,
"Jan 27, 2023 11:00 AM",65,36,29,52,26,26,33,18,15,29,15,14,0,0,0,4,24,20,4,12,7,5,11,18,13,7,6,22,4,4,,,5,5,0,,,
"Jan 27, 2023 12:00 PM",73,27,46,58,34,24,55,25,30,51,23,28,0,0,0,5,23,19,4,6,6,0,15,15,14,6,8,25,3,5,,,4,2,2,,,
"Jan 27, 2023 1:00 PM",90,40,50,56,27,29,63,36,27,39,20,19,0,0,0,13,31,25,6,20,17,3,19,27,28,17,11,21,6,6,,,8,5,3,,,
"Jan 27, 2023 2:00 PM",69,25,44,37,15,22,48,25,23,36,22,14,0,0,0,6,18,15,3,28,24,4,11,27,25,8,17,18,6,3,,,8,4,4,,,
"Jan 27, 2023 3:00 PM",94,41,53,43,20,23,47,26,21,29,18,11,0,0,0,16,23,17,6,29,27,2,20,26,18,12,6,31,4,1,,,1,0,1,,,
"Jan 27, 2023 4:00 PM",119,26,93,28,19,9,59,35,24,38,21,17,0,0,0,18,28,22,6,38,36,2,20,51,39,25,14,26,4,1,,,8,7,1,,,
"Jan 27, 2023 5:00 PM",162,35,127,33,20,13,58,38,20,46,32,14,0,0,0,25,29,20,9,75,71,4,17,65,42,27,15,48,7,2,,,6,2,4,,,
"Jan 27, 2023 6:00 PM",104,28,76,38,31,7,62,43,19,44,29,15,0,0,0,9,24,18,6,50,48,2,12,54,41,28,13,23,3,3,,,9,6,3,,,
"Jan 27, 2023 7:00 PM",85,27,58,20,16,4,45,35,10,31,22,9,0,0,0,12,25,21,4,32,30,2,21,27,19,15,4,19,6,1,,,5,3,2,,,
"Jan 27, 2023 8:00 PM",66,27,39,7,6,1,19,15,4,13,12,1,0,0,0,8,14,10,4,19,18,1,9,9,8,7,1,9,2,1,,,6,4,2,,,
"Jan 27, 2023 9:00 PM",37,14,23,14,11,3,18,11,7,11,9,2,0,0,0,5,9,7,2,4,2,2,8,4,9,7,2,13,1,2,,,3,1,2,,,
"Jan 27, 2023 10:00 PM",32,10,22,5,4,1,10,5,5,5,2,3,0,0,0,5,9,9,0,11,10,1,9,2,10,7,3,11,2,0,,,2,0,2,,,
"Jan 27, 2023 11:00 PM",19,8,11,5,4,1,13,5,8,7,1,6,0,0,0,3,6,5,1,4,4,0,5,10,5,1,4,5,0,0,,,0,0,0,,,
"Jan 28, 2023 12:00 AM",11,4,7,0,0,0,0,0,0,0,0,0,0,0,0,0,2,2,0,3,3,0,2,1,4,2,2,4,1,0,,,0,0,0,,,
"Jan 28, 2023 1:00 AM",8,3,5,2,2,0,5,3,2,2,2,0,0,0,0,1,0,0,0,2,2,0,0,7,1,0,1,3,0,1,,,0,0,0,,,
"Jan 28, 2023 2:00 AM",6,4,2,3,3,0,3,3,0,2,2,0,0,0,0,0,1,0,1,3,3,0,0,3,1,1,0,2,0,0,,,0,0,0,,,
"Jan 28, 2023 3:00 AM",5,2,3,0,0,0,0,0,0,0,0,0,0,0,0,0,0,0,0,3,3,0,0,0,0,0,0,1,0,0,,,0,0,0,,,
"Jan 28, 2023 4:00 AM",7,1,6,0,0,0,0,0,0,0,0,0,0,0,0,0,0,0,0,1,1,0,0,1,1,1,0,0,0,0,,,0,0,0,,,
"Jan 28, 2023 5:00 AM",2,1,1,0,0,0,0,0,0,0,0,0,0,0,0,0,0,0,0,1,1,0,0,4,0,0,0,3,0,0,,,0,0,0,,,
"Jan 28, 2023 6:00 AM",7,5,2,2,2,0,0,0,0,2,2,0,0,0,0,1,2,2,0,1,1,0,2,3,0,0,0,5,0,0,,,1,0,1,,,
"Jan 28, 2023 7:00 AM",14,9,5,11,7,4,16,9,7,11,8,3,0,0,0,6,5,4,1,3,2,1,4,8,8,6,2,9,0,2,,,1,1,0,,,
"Jan 28, 2023 8:00 AM",34,19,15,28,14,14,26,15,11,21,15,6,0,0,0,11,16,15,1,5,4,1,15,9,11,6,5,18,1,2,,,1,0,1,,,
"Jan 28, 2023 9:00 AM",45,25,20,81,43,38,68,44,24,73,51,22,0,0,0,6,17,17,0,8,5,3,16,24,28,13,15,30,2,16,,,6,4,2,,,
"Jan 28, 2023 10:00 AM",46,18,28,89,39,50,66,28,38,59,30,29,0,0,0,6,26,26,0,6,6,0,23,23,18,13,5,17,6,2,,,10,8,2,,,
"Jan 28, 2023 11:00 AM",61,32,29,57,29,28,77,39,38,65,34,31,0,0,0,9,22,18,4,13,12,1,15,16,29,17,12,21,4,4,,,12,8,4,,,
"Jan 28, 2023 12:00 PM",51,22,29,47,13,34,48,25,23,43,21,22,0,0,0,16,22,19,3,17,13,4,17,22,26,12,14,25,5,4,,,7,5,2,,,
"Jan 28, 2023 1:00 PM",41,29,12,63,36,27,74,34,40,54,25,29,0,0,0,14,18,18,0,16,15,1,18,24,27,19,8,29,7,4,,,8,6,2,,,
"Jan 28, 2023 2:00 PM",53,22,31,59,35,24,73,37,36,54,32,22,0,0,0,19,22,21,1,11,10,1,14,12,26,10,16,18,4,0,,,6,5,1,,,
"Jan 28, 2023 3:00 PM",52,29,23,56,23,33,68,37,31,53,25,28,0,0,0,21,17,15,2,8,6,2,13,17,40,18,22,23,2,4,,,6,2,4,,,
"Jan 28, 2023 4:00 PM",50,32,18,60,33,27,67,23,44,50,27,23,0,0,0,16,16,14,2,17,13,4,15,16,36,18,18,30,4,2,,,4,4,0,,,
"Jan 28, 2023 5:00 PM",45,17,28,23,8,15,33,15,18,27,6,21,0,0,0,16,10,8,2,7,6,1,10,9,20,9,11,16,3,0,,,3,2,1,,,
"Jan 28, 2023 6:00 PM",26,8,18,13,6,7,20,11,9,12,5,7,0,0,0,12,9,8,1,16,16,0,6,7,4,3,1,11,1,1,,,2,2,0,,,
"Jan 28, 2023 7:00 PM",42,18,24,7,6,1,14,8,6,9,5,4,0,0,0,4,9,9,0,13,12,1,9,10,8,7,1,6,0,0,,,0,0,0,,,
"Jan 28, 2023 8:00 PM",40,18,22,2,2,0,5,3,2,7,5,2,0,0,0,1,10,10,0,6,5,1,10,10,3,1,2,9,0,1,,,3,2,1,,,
"Jan 28, 2023 9:00 PM",12,5,7,5,3,2,8,5,3,5,3,2,0,0,0,4,6,6,0,4,4,0,6,3,1,1,0,9,0,1,,,2,1,1,,,
"Jan 28, 2023 10:00 PM",14,6,8,2,1,1,2,1,1,4,2,2,0,0,0,1,6,5,1,6,5,1,6,5,5,3,2,3,0,0,,,0,0,0,,,
"Jan 28, 2023 11:00 PM",9,2,7,2,2,0,4,3,1,4,1,3,0,0,0,1,2,1,1,2,2,0,2,1,2,2,0,4,1,0,,,1,1,0,,,
"Jan 29, 2023 12:00 AM",9,2,7,0,0,0,2,2,0,3,1,2,0,0,0,0,4,4,0,0,0,0,3,7,3,3,0,5,0,0,,,0,0,0,,,
"Jan 29, 2023 1:00 AM",11,2,9,0,0,0,3,3,0,0,0,0,0,0,0,1,0,0,0,3,3,0,0,0,3,3,0,2,0,0,,,0,0,0,,,
"Jan 29, 2023 2:00 AM",3,0,3,1,1,0,2,2,0,0,0,0,0,0,0,0,1,1,0,1,1,0,1,3,0,0,0,0,0,0,,,0,0,0,,,
"Jan 29, 2023 3:00 AM",3,2,1,1,1,0,1,1,0,1,1,0,0,0,0,0,0,0,0,4,4,0,1,0,2,2,0,0,0,0,,,0,0,0,,,
"Jan 29, 2023 4:00 AM",1,0,1,1,0,1,0,0,0,1,0,1,0,0,0,0,0,0,0,2,2,0,0,1,0,0,0,1,1,0,,,0,0,0,,,
"Jan 29, 2023 5:00 AM",5,2,3,0,0,0,2,2,0,2,2,0,0,0,0,0,0,0,0,0,0,0,0,3,1,0,1,3,0,0,,,0,0,0,,,
"Jan 29, 2023 6:00 AM",9,7,2,1,1,0,3,2,1,2,2,0,0,0,0,2,2,2,0,0,0,0,2,2,1,1,0,2,0,0,,,0,0,0,,,
"Jan 29, 2023 7:00 AM",11,9,2,12,3,9,16,9,7,10,5,5,0,0,0,0,7,7,0,3,1,2,5,12,3,0,3,10,0,1,,,0,0,0,,,
"Jan 29, 2023 8:00 AM",35,17,18,36,21,15,47,22,25,31,16,15,0,0,0,2,13,13,0,7,5,2,10,15,15,7,8,19,1,0,,,1,0,1,,,
"Jan 29, 2023 9:00 AM",47,21,26,79,45,34,74,44,30,69,50,19,0,0,0,9,20,20,0,9,9,0,18,22,33,23,10,42,4,13,,,5,2,3,,,
"Jan 29, 2023 10:00 AM",47,27,20,120,67,53,101,58,43,93,54,39,0,0,0,11,22,20,2,9,7,2,18,14,30,21,9,26,2,4,,,2,1,1,,,
"Jan 29, 2023 11:00 AM",71,30,41,146,61,85,103,42,61,135,66,69,0,0,0,4,12,12,0,11,8,3,12,29,40,18,22,39,2,7,,,10,7,3,,,
"Jan 29, 2023 12:00 PM",54,29,25,142,50,92,124,53,71,129,53,76,0,0,0,13,16,14,2,15,14,1,12,16,41,17,24,29,8,3,,,5,4,1,,,
"Jan 29, 2023 1:00 PM",55,28,27,92,40,52,100,48,52,86,42,44,0,0,0,22,29,28,1,17,15,2,20,29,40,26,14,35,3,1,,,10,6,4,,,
"Jan 29, 2023 2:00 PM",66,34,32,92,41,51,72,33,39,80,37,43,0,0,0,18,18,14,4,18,12,6,11,15,37,23,14,20,6,6,,,3,2,1,,,
"Jan 29, 2023 3:00 PM",52,29,23,93,44,49,96,40,56,80,26,54,0,0,0,15,12,11,1,9,8,1,7,17,41,20,21,25,3,0,,,5,3,2,,,
"Jan 29, 2023 4:00 PM",41,22,19,60,39,21,69,28,41,47,19,28,0,0,0,22,18,17,1,9,8,1,15,14,28,12,16,22,2,1,,,2,1,1,,,
"Jan 29, 2023 5:00 PM",51,16,35,33,13,20,36,18,18,31,13,18,0,0,0,9,9,8,1,21,19,2,5,10,7,4,3,11,2,2,,,1,1,0,,,
"Jan 29, 2023 6:00 PM",50,18,32,7,4,3,21,10,11,11,4,7,0,0,0,4,6,5,1,13,11,2,3,5,5,3,2,19,1,1,,,3,2,1,,,
"Jan 29, 2023 7:00 PM",27,14,13,13,8,5,10,5,5,9,5,4,0,0,0,5,6,6,0,4,3,1,6,2,2,1,1,6,0,0,,,0,0,0,,,
"Jan 29, 2023 8:00 PM",22,10,12,6,1,5,9,3,6,6,3,3,0,0,0,3,4,4,0,5,4,1,5,3,3,2,1,7,1,0,,,0,0,0,,,
"Jan 29, 2023 9:00 PM",19,8,11,2,2,0,4,2,2,3,1,2,0,0,0,5,4,4,0,3,2,1,4,4,1,0,1,2,0,1,,,1,1,0,,,
"Jan 29, 2023 10:00 PM",11,5,6,3,2,1,6,1,5,4,0,4,0,0,0,1,6,4,2,2,2,0,4,1,0,0,0,2,0,1,,,0,0,0,,,
"Jan 29, 2023 11:00 PM",5,1,4,0,0,0,3,0,3,2,0,2,0,0,0,1,0,0,0,2,2,0,0,1,0,0,0,2,1,0,,,0,0,0,,,
"Jan 30, 2023 12:00 AM",1,1,0,0,0,0,0,0,0,0,0,0,0,0,0,0,0,0,0,2,2,0,0,3,0,0,0,0,1,0,,,1,1,0,,,
"Jan 30, 2023 1:00 AM",1,1,0,0,0,0,2,2,0,1,1,0,0,0,0,0,0,0,0,0,0,0,1,4,1,0,1,2,0,1,,,0,0,0,,,
"Jan 30, 2023 2:00 AM",1,1,0,1,1,0,1,1,0,1,1,0,0,0,0,1,0,0,0,0,0,0,0,0,0,0,0,1,0,0,,,0,0,0,,,
"Jan 30, 2023 3:00 AM",0,0,0,0,0,0,0,0,0,0,0,0,0,0,0,0,0,0,0,0,0,0,0,0,1,1,0,0,0,0,,,0,0,0,,,
"Jan 30, 2023 4:00 AM",1,0,1,1,0,1,2,1,1,1,0,1,0,0,0,0,1,1,0,1,1,0,1,0,1,0,1,0,1,0,,,1,1,0,,,
"Jan 30, 2023 5:00 AM",4,2,2,2,2,0,3,2,1,3,2,1,0,0,0,2,6,6,0,2,1,1,7,4,0,0,0,7,0,0,,,0,0,0,,,
"Jan 30, 2023 6:00 AM",36,22,14,17,5,12,20,6,14,16,4,12,0,0,0,2,11,11,0,4,4,0,9,8,7,2,5,28,2,1,,,1,1,0,,,
"Jan 30, 2023 7:00 AM",122,91,31,41,12,29,53,12,41,36,10,26,0,0,0,19,68,68,0,16,12,4,59,22,19,4,15,103,1,4,,,7,6,1,,,
"Jan 30, 2023 8:00 AM",255,191,64,68,16,52,141,35,106,88,25,63,0,0,0,32,201,192,9,37,20,17,167,39,68,16,52,209,9,6,,,13,11,2,,,
"Jan 30, 2023 9:00 AM",130,100,30,32,6,26,77,36,41,56,33,23,0,0,0,17,83,80,3,23,16,7,54,27,46,13,33,77,4,2,,,6,5,1,,,
"Jan 30, 2023 10:00 AM",60,50,10,35,17,18,43,23,20,38,23,15,0,0,0,3,46,43,3,9,7,2,25,15,19,11,8,34,0,5,,,0,0,0,,,
"Jan 30, 2023 11:00 AM",49,33,16,35,19,16,36,15,21,27,13,14,0,0,0,6,25,21,4,11,6,5,19,11,14,5,9,23,2,0,,,3,1,2,,,
"Jan 30, 2023 12:00 PM",63,33,30,38,11,27,45,22,23,30,12,18,0,0,0,7,34,30,4,15,14,1,19,17,18,10,8,25,3,2,,,4,1,3,,,
"Jan 30, 2023 1:00 PM",79,33,46,50,28,22,69,36,33,47,22,25,0,0,0,7,28,22,6,18,13,5,17,16,30,15,15,11,2,0,,,2,1,1,,,
"Jan 30, 2023 2:00 PM",60,29,31,31,14,17,47,22,25,29,15,14,0,0,0,6,25,22,3,23,20,3,13,11,26,13,13,20,3,5,,,3,2,1,,,
"Jan 30, 2023 3:00 PM",80,28,52,24,19,5,56,36,20,28,22,6,0,0,0,22,19,12,7,30,27,3,12,28,21,15,6,16,2,1,,,6,4,2,,,
"Jan 30, 2023 4:00 PM",160,40,120,44,31,13,72,48,24,56,31,25,0,0,0,20,26,20,6,52,50,2,15,61,36,23,13,41,1,2,,,7,3,4,,,
"Jan 30, 2023 5:00 PM",203,51,152,43,30,13,89,60,29,70,43,27,0,0,0,15,43,29,14,100,98,2,28,104,57,43,14,43,4,7,,,9,5,4,,,
"Jan 30, 2023 6:00 PM",177,46,131,44,38,6,92,67,25,60,40,20,0,0,0,11,30,21,9,98,95,3,24,92,53,40,13,34,4,4,,,8,2,6,,,
"Jan 30, 2023 7:00 PM",111,24,87,21,15,6,38,30,8,30,21,9,0,0,0,4,22,18,4,50,46,4,13,48,14,11,3,15,2,3,,,6,2,4,,,
"Jan 30, 2023 8:00 PM",81,19,62,10,9,1,19,14,5,10,7,3,0,0,0,2,15,11,4,21,21,0,7,19,15,11,4,16,1,5,,,4,4,0,,,
"Jan 30, 2023 9:00 PM",45,6,39,8,6,2,17,10,7,13,10,3,0,0,0,4,12,6,6,17,17,0,4,20,8,8,0,14,3,1,,,4,2,2,,,
"Jan 30, 2023 10:00 PM",28,4,24,3,3,0,4,1,3,3,1,2,0,0,0,4,7,2,5,16,16,0,2,5,3,1,2,6,0,0,,,4,2,2,,,
"Jan 30, 2023 11:00 PM",2,1,1,2,2,0,3,2,1,4,3,1,0,0,0,4,5,5,0,7,6,1,5,10,1,1,0,3,1,1,,,1,1,0,,,
"Jan 31, 2023 12:00 AM",3,1,2,0,0,0,1,1,0,1,1,0,0,0,0,0,1,1,0,2,2,0,0,4,0,0,0,4,0,0,,,1,1,0,,,
"Jan 31, 2023 1:00 AM",1,0,1,1,1,0,0,0,0,0,0,0,0,0,0,0,2,0,2,1,1,0,0,3,0,0,0,0,0,0,,,0,0,0,,,
"Jan 31, 2023 2:00 AM",3,3,0,0,0,0,0,0,0,0,0,0,0,0,0,0,0,0,0,0,0,0,0,1,0,0,0,0,0,0,,,0,0,0,,,
"Jan 31, 2023 3:00 AM",1,0,1,0,0,0,0,0,0,0,0,0,0,0,0,0,0,0,0,0,0,0,0,0,0,0,0,0,0,0,,,0,0,0,,,
"Jan 31, 2023 4:00 AM",3,1,2,1,0,1,1,0,1,1,0,1,0,0,0,0,1,1,0,0,0,0,2,0,1,0,1,0,0,0,,,0,0,0,,,
"Jan 31, 2023 5:00 AM",5,3,2,1,0,1,2,0,2,1,0,1,0,0,0,1,5,5,0,2,1,1,5,3,0,0,0,5,0,0,,,0,0,0,,,
"Jan 31, 2023 6:00 AM",51,30,21,12,3,9,18,5,13,14,5,9,0,0,0,6,11,11,0,7,6,1,9,9,4,2,2,29,0,4,,,3,3,0,,,
"Jan 31, 2023 7:00 AM",159,126,33,26,5,21,45,13,32,36,11,25,0,0,0,20,83,81,2,22,19,3,76,29,23,6,17,98,2,6,,,4,4,0,,,
"Jan 31, 2023 8:00 AM",291,226,65,68,15,53,135,47,88,85,28,57,0,0,0,36,210,205,5,42,27,15,188,49,72,25,47,240,5,7,,,12,9,3,,,
"Jan 31, 2023 9:00 AM",147,119,28,23,3,20,65,33,32,43,27,16,0,0,0,20,82,79,3,19,14,5,48,19,29,13,16,87,2,5,,,3,3,0,,,
"Jan 31, 2023 10:00 AM",58,46,12,35,18,17,41,23,18,28,16,12,0,0,0,3,53,50,3,11,9,2,29,10,13,5,8,28,3,2,,,0,0,0,,,
"Jan 31, 2023 11:00 AM",49,33,16,19,9,10,26,10,16,22,6,16,0,0,0,6,23,20,3,10,7,3,15,15,12,7,5,23,2,2,,,2,2,0,,,
"Jan 31, 2023 12:00 PM",60,28,32,19,8,11,30,16,14,25,12,13,0,0,0,3,30,23,7,13,12,1,13,14,11,8,3,30,7,1,,,6,6,0,,,
"Jan 31, 2023 1:00 PM",75,35,40,34,17,17,31,10,21,33,15,18,0,0,0,7,19,15,4,12,10,2,15,14,13,5,8,22,2,1,,,5,3,2,,,
"Jan 31, 2023 2:00 PM",64,25,39,33,15,18,26,13,13,21,9,12,0,0,0,11,28,19,9,28,21,7,11,23,29,13,16,24,1,1,,,5,2,3,,,
"Jan 31, 2023 3:00 PM",87,29,58,25,15,10,34,25,9,22,16,6,0,0,0,16,26,21,5,35,31,4,17,20,28,20,8,18,0,2,,,7,5,2,,,
"Jan 31, 2023 4:00 PM",153,33,120,30,23,7,61,36,25,39,25,14,0,0,0,25,37,30,7,46,43,3,26,63,39,24,15,31,6,1,,,10,7,3,,,
"Jan 31, 2023 5:00 PM",225,54,171,49,37,12,81,52,29,60,37,23,0,0,0,20,38,30,8,88,86,2,31,101,60,39,21,44,2,3,,,11,4,7,,,
"Jan 31, 2023 6:00 PM",227,53,174,36,29,7,90,57,33,70,42,28,0,0,0,22,34,24,10,103,97,6,18,114,54,39,15,45,4,3,,,8,6,2,,,
"Jan 31, 2023 7:00 PM",126,24,102,26,21,5,37,28,9,37,25,12,0,0,0,9,20,17,3,63,59,4,11,54,22,16,6,23,2,1,,,6,5,1,,,
"Jan 31, 2023 8:00 PM",72,24,48,13,10,3,31,21,10,21,13,8,0,0,0,14,6,5,1,22,21,1,6,29,11,8,3,17,3,3,,,1,1,0,,,
"Jan 31, 2023 9:00 PM",43,11,32,14,10,4,17,11,6,20,12,8,0,0,0,4,11,8,3,12,11,1,7,8,6,4,2,7,3,1,,,2,2,0,,,
"Jan 31, 2023 10:00 PM",26,6,20,3,2,1,5,4,1,2,1,1,0,0,0,4,8,6,2,10,9,1,6,5,2,1,1,5,1,1,,,2,0,2,,,
"Jan 31, 2023 11:00 PM",6,1,5,0,0,0,3,2,1,2,1,1,0,0,0,1,4,1,3,4,4,0,1,5,1,1,0,2,1,0,,,2,1,1,,,
"Feb 1, 2023 12:00 AM",3,0,3,0,0,0,1,1,0,0,0,0,0,0,0,1,0,0,0,7,7,0,0,3,0,0,0,1,0,0,,,0,0,0,,,
"Feb 1, 2023 1:00 AM",3,2,1,0,0,0,1,1,0,0,0,0,0,0,0,0,1,1,0,0,0,0,1,1,1,1,0,2,0,0,,,0,0,0,,,
"Feb 1, 2023 2:00 AM",3,0,3,0,0,0,0,0,0,0,0,0,0,0,0,0,1,0,1,1,1,0,0,0,0,0,0,1,0,0,,,0,0,0,,,
"Feb 1, 2023 3:00 AM",1,0,1,0,0,0,0,0,0,0,0,0,0,0,0,1,0,0,0,2,2,0,1,0,0,0,0,0,0,0,,,1,0,1,,,
"Feb 1, 2023 4:00 AM",3,1,2,1,0,1,1,0,1,1,0,1,0,0,0,0,2,2,0,0,0,0,2,0,1,0,1,0,0,0,,,0,0,0,,,
"Feb 1, 2023 5:00 AM",6,5,1,1,0,1,2,1,1,3,1,2,0,0,0,0,6,6,0,3,3,0,6,1,0,0,0,4,0,0,,,0,0,0,,,
"Feb 1, 2023 6:00 AM",42,24,18,9,4,5,12,5,7,9,4,5,0,0,0,5,13,13,0,6,5,1,11,10,2,1,1,33,2,1,,,3,3,0,,,
"Feb 1, 2023 7:00 AM",136,96,40,36,11,25,62,24,38,38,13,25,0,0,0,14,72,70,2,19,15,4,62,28,23,12,11,100,1,5,,,5,2,3,,,
"Feb 1, 2023 8:00 AM",276,215,61,72,21,51,135,36,99,72,24,48,0,0,0,42,196,191,5,36,25,11,166,36,62,17,45,219,7,3,,,11,10,1,,,
"Feb 1, 2023 9:00 AM",127,98,29,39,7,32,68,30,38,53,32,21,0,0,0,8,78,77,1,15,11,4,48,14,33,16,17,80,5,3,,,7,4,3,,,
"Feb 1, 2023 10:00 AM",67,49,18,29,12,17,46,20,26,30,16,14,0,0,0,6,49,46,3,19,12,7,31,8,21,11,10,31,2,0,,,1,1,0,,,
"Feb 1, 2023 11:00 AM",52,38,14,33,12,21,29,18,11,22,12,10,0,0,0,4,35,32,3,6,4,2,22,9,11,7,4,22,1,2,,,6,1,5,,,
"Feb 1, 2023 12:00 PM",56,26,30,19,8,11,34,18,16,23,11,12,0,0,0,7,32,25,7,17,17,0,15,14,21,11,10,20,2,1,,,2,2,0,,,
"Feb 1, 2023 1:00 PM",75,35,40,46,25,21,47,27,20,33,16,17,0,0,0,7,30,27,3,25,20,5,19,18,31,19,12,26,1,6,,,4,1,3,,,
"Feb 1, 2023 2:00 PM",60,34,26,24,14,10,39,27,12,22,14,8,0,0,0,7,25,18,7,21,16,5,14,25,29,14,15,19,5,2,,,11,4,7,,,
"Feb 1, 2023 3:00 PM",75,32,43,26,18,8,40,23,17,21,16,5,0,0,0,15,18,10,8,35,30,5,8,27,15,9,6,15,1,2,,,4,1,3,,,
"Feb 1, 2023 4:00 PM",133,30,103,29,17,12,55,28,27,45,20,25,0,0,0,14,38,22,16,53,53,0,22,50,31,15,16,33,3,0,,,6,3,3,,,
"Feb 1, 2023 5:00 PM",231,47,184,42,29,13,76,45,31,61,37,24,0,0,0,38,32,25,7,101,98,3,25,124,51,36,15,46,6,2,,,5,4,1,,,
"Feb 1, 2023 6:00 PM",211,60,151,54,38,16,78,61,17,52,38,14,0,0,0,24,32,23,9,91,88,3,23,87,56,44,12,36,6,0,,,7,7,0,,,
"Feb 1, 2023 7:00 PM",106,30,76,28,20,8,39,31,8,30,19,11,0,0,0,7,24,19,5,45,44,1,15,53,26,22,4,20,0,2,,,11,4,7,,,
"Feb 1, 2023 8:00 PM",77,17,60,9,9,0,20,15,5,15,9,6,0,0,0,8,15,11,4,25,24,1,11,28,17,11,6,17,2,5,,,2,1,1,,,
"Feb 1, 2023 9:00 PM",45,12,33,11,10,1,18,9,9,15,9,6,0,0,0,3,5,4,1,16,13,3,4,18,9,7,2,6,5,0,,,4,2,2,,,
"Feb 1, 2023 10:00 PM",33,11,22,4,4,0,3,2,1,5,3,2,0,0,0,1,8,6,2,9,9,0,7,9,5,4,1,7,1,0,,,2,1,1,,,
"Feb 1, 2023 11:00 PM",14,3,11,1,1,0,3,2,1,4,2,2,0,0,0,1,2,1,1,5,5,0,1,5,1,0,1,4,2,0,,,1,1,0,,,
"Feb 2, 2023 12:00 AM",5,0,5,0,0,0,1,1,0,0,0,0,0,0,0,1,1,1,0,2,2,0,1,4,1,1,0,0,0,0,,,0,0,0,,,
"Feb 2, 2023 1:00 AM",2,2,0,0,0,0,0,0,0,0,0,0,0,0,0,2,0,0,0,3,3,0,0,0,4,4,0,1,0,0,,,0,0,0,,,
"Feb 2, 2023 2:00 AM",6,5,1,0,0,0,0,0,0,0,0,0,0,0,0,0,0,0,0,0,0,0,0,1,0,0,0,0,0,0,,,0,0,0,,,
"Feb 2, 2023 3:00 AM",1,1,0,0,0,0,0,0,0,0,0,0,0,0,0,0,0,0,0,1,1,0,0,0,0,0,0,0,0,0,,,0,0,0,,,
"Feb 2, 2023 4:00 AM",3,0,3,1,0,1,1,0,1,1,0,1,0,0,0,0,3,3,0,0,0,0,3,0,1,0,1,0,0,0,,,0,0,0,,,
"Feb 2, 2023 5:00 AM",4,2,2,2,0,2,4,1,3,4,1,3,0,0,0,0,5,5,0,2,2,0,5,4,1,0,1,3,1,0,,,0,0,0,,,
"Feb 2, 2023 6:00 AM",50,31,19,18,8,10,14,6,8,17,11,6,0,0,0,6,14,14,0,6,4,2,15,15,4,0,4,31,0,4,,,0,0,0,,,
"Feb 2, 2023 7:00 AM",131,90,41,30,9,21,59,16,43,38,14,24,0,0,0,16,63,61,2,19,18,1,50,34,20,6,14,99,2,5,,,9,6,3,,,
"Feb 2, 2023 8:00 AM",276,214,62,80,20,60,132,36,96,91,28,63,0,0,0,35,196,191,5,32,19,13,153,45,67,12,55,195,3,4,,,13,10,3,,,
"Feb 2, 2023 9:00 AM",137,114,23,59,12,47,82,32,50,62,26,36,0,0,0,12,98,97,1,18,13,5,61,15,54,19,35,80,1,7,,,3,1,2,,,
"Feb 2, 2023 10:00 AM",63,44,19,37,13,24,42,14,28,32,11,21,0,0,0,15,52,49,3,17,9,8,34,11,21,11,10,35,0,2,,,2,2,0,,,
"Feb 2, 2023 11:00 AM",55,38,17,36,12,24,33,16,17,27,10,17,0,0,0,8,21,17,4,8,5,3,12,13,10,4,6,18,5,3,,,4,2,2,,,
"Feb 2, 2023 12:00 PM",66,30,36,35,22,13,46,25,21,33,21,12,0,0,0,6,29,27,2,19,14,5,17,12,17,7,10,14,1,3,,,3,3,0,,,
"Feb 2, 2023 1:00 PM",66,28,38,29,12,17,34,16,18,31,13,18,0,0,0,4,32,24,8,16,14,2,17,21,13,8,5,23,3,3,,,5,3,2,,,
"Feb 2, 2023 2:00 PM",72,30,42,17,10,7,40,13,27,23,11,12,0,0,0,4,26,19,7,23,19,4,16,15,22,10,12,21,3,1,,,8,5,3,,,
"Feb 2, 2023 3:00 PM",81,25,56,28,21,7,44,31,13,32,22,10,0,0,0,19,24,17,7,29,23,6,14,38,21,15,6,23,2,1,,,2,1,1,,,
"Feb 2, 2023 4:00 PM",156,47,109,31,23,8,44,30,14,39,25,14,0,0,0,22,39,26,13,41,38,3,19,52,24,18,6,26,3,1,,,8,4,4,,,
"Feb 2, 2023 5:00 PM",195,50,145,45,37,8,91,60,31,62,41,21,0,0,0,19,41,30,11,92,90,2,25,105,57,46,11,42,6,1,,,7,6,1,,,
"Feb 2, 2023 6:00 PM",193,45,148,41,37,4,79,63,16,59,45,14,0,0,0,17,30,25,5,87,81,6,24,76,48,39,9,38,5,1,,,7,3,4,,,
"Feb 2, 2023 7:00 PM",116,27,89,35,24,11,50,35,15,37,26,11,0,0,0,7,22,15,7,55,52,3,11,43,19,16,3,26,1,2,,,5,4,1,,,
"Feb 2, 2023 8:00 PM",87,26,61,16,14,2,22,16,6,15,12,3,0,0,0,8,18,14,4,23,21,2,10,22,4,4,0,13,1,2,,,5,3,2,,,
"Feb 2, 2023 9:00 PM",63,17,46,11,9,2,12,7,5,8,5,3,0,0,0,2,9,6,3,11,9,2,5,10,7,6,1,11,0,1,,,3,1,2,,,
"Feb 2, 2023 10:00 PM",24,5,19,6,4,2,9,4,5,3,1,2,0,0,0,6,4,2,2,22,21,1,3,14,5,1,4,5,0,0,,,0,0,0,,,
"Feb 2, 2023 11:00 PM",10,3,7,7,7,0,9,9,0,7,7,0,0,0,0,2,5,4,1,7,7,0,4,7,4,2,2,3,1,0,,,1,1,0,,,
"Feb 3, 2023 12:00 AM",7,1,6,0,0,0,0,0,0,1,0,1,0,0,0,0,1,1,0,5,4,1,1,10,0,0,0,3,0,0,,,0,0,0,,,
"Feb 3, 2023 1:00 AM",2,0,2,0,0,0,0,0,0,0,0,0,0,0,0,0,1,1,0,4,3,1,0,3,0,0,0,1,0,0,,,1,1,0,,,
"Feb 3, 2023 2:00 AM",4,4,0,0,0,0,0,0,0,0,0,0,0,0,0,0,0,0,0,1,1,0,0,4,1,1,0,0,0,0,,,0,0,0,,,
"Feb 3, 2023 3:00 AM",1,0,1,0,0,0,1,0,1,1,0,1,0,0,0,0,0,0,0,0,0,0,0,1,1,1,0,2,0,0,,,0,0,0,,,
"Feb 3, 2023 4:00 AM",2,1,1,1,0,1,1,0,1,1,0,1,0,0,0,0,1,1,0,0,0,0,1,0,1,0,1,2,0,0,,,0,0,0,,,
"Feb 3, 2023 5:00 AM",12,7,5,1,1,0,4,1,3,3,1,2,0,0,0,0,4,4,0,2,1,1,5,3,0,0,0,5,0,0,,,0,0,0,,,
"Feb 3, 2023 6:00 AM",33,22,11,14,5,9,18,10,8,12,6,6,0,0,0,4,16,16,0,5,4,1,12,10,4,3,1,15,0,3,,,1,1,0,,,
"Feb 3, 2023 7:00 AM",92,65,27,34,13,21,44,15,29,32,13,19,0,0,0,10,52,52,0,13,11,2,48,20,20,5,15,67,0,2,,,3,3,0,,,
"Feb 3, 2023 8:00 AM",183,146,37,74,16,58,127,48,79,84,31,53,0,0,0,27,119,113,6,26,19,7,86,34,63,25,38,113,8,2,,,16,13,3,,,
"Feb 3, 2023 9:00 AM",104,74,30,47,20,27,71,33,38,55,33,22,0,0,0,9,70,69,1,13,10,3,44,21,32,12,20,57,0,6,,,2,2,0,,,
"Feb 3, 2023 10:00 AM",61,37,24,34,11,23,43,27,16,29,17,12,0,0,0,7,35,33,2,17,12,5,22,15,13,8,5,31,4,5,,,4,2,2,,,
"Feb 3, 2023 11:00 AM",47,26,21,42,21,21,51,26,25,29,15,14,0,0,0,6,31,28,3,11,9,2,21,21,17,8,9,27,3,3,,,6,6,0,,,
"Feb 3, 2023 12:00 PM",81,37,44,53,24,29,60,32,28,59,34,25,0,0,0,6,18,15,3,11,10,1,11,18,23,12,11,22,3,1,,,6,2,4,,,
"Feb 3, 2023 1:00 PM",79,32,47,51,30,21,65,33,32,46,28,18,0,0,0,11,34,31,3,22,20,2,28,19,26,15,11,30,3,2,,,4,4,0,,,
"Feb 3, 2023 2:00 PM",76,32,44,46,24,22,59,33,26,49,29,20,0,0,0,15,22,17,5,22,19,3,14,30,15,7,8,26,4,5,,,5,3,2,,,
"Feb 3, 2023 3:00 PM",99,33,66,51,27,24,72,43,29,51,21,30,0,0,0,21,24,20,4,30,25,5,20,19,40,28,12,19,3,3,,,4,3,1,,,
"Feb 3, 2023 4:00 PM",111,36,75,55,31,24,72,37,35,72,38,34,0,0,0,25,32,16,16,40,38,2,19,53,36,27,9,30,7,2,,,5,4,1,,,
"Feb 3, 2023 5:00 PM",160,39,121,58,38,20,77,46,31,61,39,22,0,0,0,21,32,29,3,62,59,3,26,71,52,32,20,43,3,1,,,4,3,1,,,
"Feb 3, 2023 6:00 PM",106,25,81,31,22,9,69,49,20,56,35,21,0,0,0,20,20,18,2,57,54,3,19,48,38,22,16,27,0,0,,,7,3,4,,,
"Feb 3, 2023 7:00 PM",74,15,59,29,18,11,42,29,13,31,17,14,0,0,0,5,14,10,4,26,24,2,8,29,10,6,4,22,1,2,,,6,2,4,,,
"Feb 3, 2023 8:00 PM",57,17,40,8,7,1,17,13,4,16,12,4,0,0,0,8,10,7,3,12,10,2,7,6,14,12,2,12,1,2,,,3,1,2,,,
"Feb 3, 2023 9:00 PM",38,16,22,13,10,3,13,5,8,7,4,3,0,0,0,7,6,4,2,8,8,0,3,6,8,4,4,10,2,2,,,4,3,1,,,
"Feb 3, 2023 10:00 PM",28,8,20,11,8,3,12,6,6,13,4,9,0,0,0,6,7,7,0,8,7,1,8,7,9,8,1,8,0,0,,,2,1,1,,,
"Feb 3, 2023 11:00 PM",17,7,10,4,3,1,8,5,3,6,3,3,0,0,0,10,3,3,0,5,5,0,2,9,4,0,4,2,2,3,,,1,1,0,,,
"Feb 4, 2023 12:00 AM",11,3,8,1,1,0,1,1,0,7,4,3,0,0,0,2,3,2,1,6,5,1,2,9,6,2,4,5,0,0,,,1,1,0,,,
"Feb 4, 2023 1:00 AM",9,3,6,5,3,2,4,3,1,3,1,2,0,0,0,3,2,2,0,3,3,0,2,0,3,2,1,1,0,0,,,0,0,0,,,
"Feb 4, 2023 2:00 AM",7,2,5,0,0,0,2,1,1,1,1,0,0,0,0,0,0,0,0,1,1,0,0,2,0,0,0,3,0,0,,,2,1,1,,,
"Feb 4, 2023 3:00 AM",2,1,1,0,0,0,2,2,0,2,2,0,0,0,0,0,0,0,0,0,0,0,0,2,0,0,0,1,0,0,,,0,0,0,,,
"Feb 4, 2023 4:00 AM",4,1,3,0,0,0,0,0,0,0,0,0,0,0,0,0,0,0,0,0,0,0,0,1,1,1,0,0,1,0,,,0,0,0,,,
"Feb 4, 2023 5:00 AM",3,2,1,0,0,0,2,0,2,0,0,0,0,0,0,1,2,2,0,0,0,0,2,2,0,0,0,2,0,0,,,0,0,0,,,
"Feb 4, 2023 6:00 AM",10,6,4,2,1,1,3,2,1,3,1,2,0,0,0,1,3,2,1,0,0,0,2,3,0,0,0,6,0,0,,,0,0,0,,,
"Feb 4, 2023 7:00 AM",17,8,9,18,10,8,25,16,9,21,14,7,0,0,0,5,5,5,0,3,3,0,5,12,6,5,1,16,1,2,,,0,0,0,,,
"Feb 4, 2023 8:00 AM",47,24,23,40,28,12,49,37,12,42,34,8,0,0,0,2,17,15,2,4,3,1,16,18,13,7,6,17,1,3,,,3,2,1,,,
"Feb 4, 2023 9:00 AM",39,19,20,72,30,42,79,42,37,61,39,22,0,0,0,8,11,11,0,11,7,4,12,15,35,19,16,26,2,8,,,10,6,4,,,
"Feb 4, 2023 10:00 AM",54,30,24,79,38,41,91,57,34,64,41,23,0,0,0,16,21,20,1,6,5,1,16,32,21,14,7,28,1,2,,,2,1,1,,,
"Feb 4, 2023 11:00 AM",51,31,20,85,37,48,108,54,54,68,39,29,0,0,0,17,18,16,2,9,7,2,15,29,36,21,15,33,7,2,,,7,3,4,,,
"Feb 4, 2023 12:00 PM",56,33,23,91,45,46,92,40,52,71,32,39,0,0,0,20,19,16,3,14,12,2,14,23,37,11,26,31,4,7,,,4,3,1,,,
"Feb 4, 2023 1:00 PM",64,41,23,90,58,32,75,44,31,73,44,29,0,0,0,22,25,24,1,17,14,3,22,30,30,17,13,27,5,6,,,4,3,1,,,
"Feb 4, 2023 2:00 PM",60,28,32,38,11,27,41,17,24,24,9,15,0,0,0,6,25,21,4,16,14,2,15,14,24,13,11,22,6,5,,,5,3,2,,,
"Feb 4, 2023 3:00 PM",53,17,36,44,26,18,50,26,24,36,20,16,0,0,0,14,10,10,0,7,7,0,7,18,25,17,8,22,4,1,,,13,8,5,,,
"Feb 4, 2023 4:00 PM",30,14,16,25,11,14,36,14,22,33,15,18,0,0,0,14,12,11,1,20,19,1,11,11,18,8,10,15,3,0,,,6,3,3,,,
"Feb 4, 2023 5:00 PM",37,11,26,13,11,2,28,15,13,23,10,13,0,0,0,8,9,8,1,8,8,0,10,5,12,4,8,11,1,0,,,1,1,0,,,
"Feb 4, 2023 6:00 PM",37,18,19,13,4,9,9,4,5,14,5,9,0,0,0,8,13,11,2,13,11,2,11,7,4,3,1,14,1,2,,,5,2,3,,,
"Feb 4, 2023 7:00 PM",25,13,12,12,9,3,19,9,10,16,7,9,0,0,0,5,7,7,0,7,6,1,7,8,6,3,3,11,2,0,,,4,2,2,,,
"Feb 4, 2023 8:00 PM",23,5,18,3,2,1,7,1,6,9,2,7,0,0,0,4,8,8,0,2,2,0,8,5,2,1,1,9,0,1,,,2,0,2,,,
"Feb 4, 2023 9:00 PM",15,6,9,5,3,2,2,1,1,1,1,0,0,0,0,1,3,3,0,2,2,0,2,1,2,2,0,5,1,1,,,6,4,2,,,
"Feb 4, 2023 10:00 PM",10,4,6,4,3,1,4,2,2,3,2,1,0,0,0,0,5,4,1,2,2,0,4,5,2,1,1,4,1,0,,,2,1,1,,,
"Feb 4, 2023 11:00 PM",10,3,7,1,0,1,7,3,4,5,3,2,0,0,0,1,6,6,0,4,3,1,6,2,2,1,1,7,1,0,,,1,1,0,,,
"Feb 5, 2023 12:00 AM",8,4,4,0,0,0,0,0,0,4,2,2,0,0,0,2,3,3,0,1,0,1,3,6,0,0,0,2,0,0,,,0,0,0,,,
"Feb 5, 2023 1:00 AM",1,0,1,0,0,0,2,2,0,2,1,1,0,0,0,0,1,1,0,3,2,1,1,4,3,3,0,1,0,1,,,0,0,0,,,
"Feb 5, 2023 2:00 AM",9,6,3,2,2,0,2,2,0,1,1,0,0,0,0,0,3,2,1,1,1,0,2,0,1,1,0,4,0,0,,,0,0,0,,,
"Feb 5, 2023 3:00 AM",7,1,6,0,0,0,0,0,0,0,0,0,0,0,0,0,0,0,0,3,2,1,0,2,0,0,0,0,0,0,,,0,0,0,,,
"Feb 5, 2023 4:00 AM",3,0,3,0,0,0,0,0,0,0,0,0,0,0,0,0,1,1,0,0,0,0,1,0,2,2,0,1,1,0,,,0,0,0,,,
"Feb 5, 2023 5:00 AM",3,0,3,1,0,1,3,3,0,2,2,0,0,0,0,2,1,1,0,1,1,0,1,4,0,0,0,1,0,0,,,0,0,0,,,
"Feb 5, 2023 6:00 AM",8,4,4,3,1,2,4,2,2,1,0,1,0,0,0,1,1,1,0,1,0,1,1,2,2,1,1,3,1,0,,,0,0,0,,,
"Feb 5, 2023 7:00 AM",7,3,4,12,3,9,8,2,6,10,3,7,0,0,0,2,7,7,0,4,1,3,5,6,4,1,3,12,0,5,,,0,0,0,,,
"Feb 5, 2023 8:00 AM",26,21,5,30,10,20,35,19,16,26,18,8,0,0,0,2,9,9,0,3,3,0,6,5,15,8,7,20,0,0,,,2,0,2,,,
"Feb 5, 2023 9:00 AM",42,14,28,105,68,37,97,71,26,99,74,25,0,0,0,4,11,9,2,9,8,1,8,18,28,20,8,29,4,13,,,1,1,0,,,
"Feb 5, 2023 10:00 AM",44,27,17,96,59,37,82,55,27,73,52,21,0,0,0,8,10,10,0,33,32,1,11,28,42,29,13,28,4,12,,,4,4,0,,,
"Feb 5, 2023 11:00 AM",53,27,26,131,75,56,129,76,53,117,71,46,0,0,0,12,30,29,1,26,24,2,26,39,51,28,23,36,3,5,,,3,2,1,,,
"Feb 5, 2023 12:00 PM",42,28,14,133,55,78,168,88,80,129,66,63,0,0,0,10,48,45,3,21,20,1,41,30,46,29,17,34,5,2,,,13,8,5,,,
"Feb 5, 2023 1:00 PM",53,27,26,130,77,53,125,64,61,103,63,40,0,0,0,22,41,38,3,46,41,5,34,35,57,41,16,30,13,1,,,8,8,0,,,
"Feb 5, 2023 2:00 PM",54,31,23,125,50,75,136,72,64,103,54,49,0,0,0,21,49,45,4,16,14,2,55,21,66,47,19,27,3,3,,,10,4,6,,,
"Feb 5, 2023 3:00 PM",40,23,17,124,59,65,108,47,61,100,40,60,0,0,0,14,26,25,1,26,16,10,23,24,49,19,30,38,4,4,,,6,4,2,,,
"Feb 5, 2023 4:00 PM",47,22,25,78,35,43,82,31,51,59,26,33,0,0,0,17,39,37,2,9,6,3,33,14,38,18,20,34,4,2,,,2,2,0,,,
"Feb 5, 2023 5:00 PM",50,17,33,48,18,30,65,26,39,54,20,34,0,0,0,20,22,20,2,9,7,2,16,14,26,10,16,27,3,0,,,4,4,0,,,
"Feb 5, 2023 6:00 PM",53,22,31,14,6,8,21,6,15,22,6,16,0,0,0,7,9,7,2,9,8,1,6,7,8,1,7,16,3,0,,,2,1,1,,,
"Feb 5, 2023 7:00 PM",33,14,19,8,6,2,12,6,6,10,5,5,0,0,0,6,8,8,0,7,5,2,8,6,5,0,5,11,0,1,,,2,0,2,,,
"Feb 5, 2023 8:00 PM",28,9,19,6,5,1,7,3,4,2,1,1,0,0,0,2,9,8,1,6,5,1,9,5,2,1,1,6,0,3,,,1,0,1,,,
"Feb 5, 2023 9:00 PM",8,3,5,7,5,2,8,3,5,10,5,5,0,0,0,3,4,3,1,2,1,1,2,5,2,2,0,8,0,0,,,2,1,1,,,
"Feb 5, 2023 10:00 PM",15,6,9,1,0,1,2,0,2,4,2,2,0,0,0,1,6,5,1,1,1,0,4,2,0,0,0,3,0,0,,,1,1,0,,,
"Feb 5, 2023 11:00 PM",6,3,3,2,2,0,7,5,2,4,3,1,0,0,0,1,1,1,0,2,2,0,3,7,0,0,0,2,3,0,,,0,0,0,,,
"Feb 6, 2023 12:00 AM",6,0,6,0,0,0,2,0,2,2,0,2,0,0,0,1,0,0,0,2,2,0,0,0,0,0,0,3,0,0,,,0,0,0,,,
"Feb 6, 2023 1:00 AM",2,0,2,0,0,0,4,3,1,3,2,1,0,0,0,3,0,0,0,3,1,2,0,3,2,2,0,2,0,0,,,0,0,0,,,
"Feb 6, 2023 2:00 AM",5,3,2,0,0,0,1,0,1,1,0,1,0,0,0,0,1,0,1,0,0,0,0,1,0,0,0,5,1,0,,,1,1,0,,,
"Feb 6, 2023 3:00 AM",3,0,3,0,0,0,0,0,0,0,0,0,0,0,0,0,0,0,0,1,1,0,0,1,0,0,0,0,0,0,,,0,0,0,,,
"Feb 6, 2023 4:00 AM",2,0,2,0,0,0,0,0,0,0,0,0,0,0,0,0,0,0,0,0,0,0,0,0,0,0,0,0,0,0,,,0,0,0,,,
"Feb 6, 2023 5:00 AM",4,1,3,0,0,0,0,0,0,0,0,0,0,0,0,1,1,1,0,1,1,0,1,0,0,0,0,2,0,0,,,0,0,0,,,
"Feb 6, 2023 6:00 AM",17,9,8,4,3,1,3,1,2,1,1,0,0,0,0,1,2,2,0,0,0,0,2,3,1,0,1,5,0,0,,,1,1,0,,,
"Feb 6, 2023 7:00 AM",22,14,8,12,7,5,9,6,3,10,8,2,0,0,0,4,4,4,0,4,4,0,5,4,2,1,1,14,1,3,,,0,0,0,,,
"Feb 6, 2023 8:00 AM",18,10,8,26,14,12,40,23,17,35,24,11,0,0,0,2,9,9,0,3,3,0,7,14,8,2,6,13,5,5,,,2,2,0,,,
"Feb 6, 2023 9:00 AM",37,18,19,114,68,46,100,78,22,101,73,28,0,0,0,11,11,10,1,11,3,8,10,26,39,25,14,19,2,7,,,2,2,0,,,
"Feb 6, 2023 10:00 AM",44,18,26,119,71,48,113,66,47,95,57,38,0,0,0,14,11,11,0,12,10,2,9,21,46,28,18,33,4,4,,,4,2,2,,,
"Feb 6, 2023 11:00 AM",45,30,15,116,49,67,118,63,55,96,49,47,0,0,0,9,16,14,2,10,4,6,12,24,46,35,11,32,1,13,,,9,6,3,,,
"Feb 6, 2023 12:00 PM",49,24,25,124,51,73,125,61,64,101,43,58,0,0,0,18,27,27,0,12,9,3,20,18,68,35,33,33,6,2,,,9,6,3,,,
"Feb 6, 2023 1:00 PM",54,36,18,113,60,53,149,82,67,102,61,41,0,0,0,15,25,24,1,19,16,3,23,26,78,45,33,26,12,2,,,8,3,5,,,
"Feb 6, 2023 2:00 PM",55,21,34,101,53,48,127,63,64,106,55,51,0,0,0,20,17,14,3,19,16,3,13,24,62,37,25,29,4,5,,,2,2,0,,,
"Feb 6, 2023 3:00 PM",56,25,31,124,60,64,127,59,68,112,59,53,0,0,0,20,22,20,2,14,14,0,20,22,75,28,47,25,4,7,,,4,1,3,,,
"Feb 6, 2023 4:00 PM",48,22,26,101,38,63,105,40,65,110,45,65,0,0,0,11,20,19,1,14,10,4,12,10,25,7,18,24,7,0,,,7,5,2,,,
"Feb 6, 2023 5:00 PM",60,18,42,77,38,39,48,19,29,52,15,37,0,0,0,21,20,18,2,15,14,1,22,14,40,13,27,13,4,4,,,7,2,5,,,
"Feb 6, 2023 6:00 PM",55,23,32,21,7,14,25,9,16,22,7,15,0,0,0,16,12,11,1,16,15,1,8,17,16,4,12,17,3,0,,,3,1,2,,,
"Feb 6, 2023 7:00 PM",29,11,18,16,12,4,17,7,10,15,9,6,0,0,0,6,5,5,0,12,7,5,5,6,5,4,1,6,3,1,,,2,1,1,,,
"Feb 6, 2023 8:00 PM",28,12,16,6,5,1,9,6,3,8,7,1,0,0,0,6,5,2,3,7,6,1,2,8,3,1,2,7,0,2,,,1,0,1,,,
"Feb 6, 2023 9:00 PM",20,5,15,8,5,3,9,5,4,8,4,4,0,0,0,7,4,3,1,5,5,0,2,6,4,1,3,8,1,0,,,0,0,0,,,
"Feb 6, 2023 10:00 PM",8,1,7,1,1,0,3,1,2,3,1,2,0,0,0,0,5,5,0,6,6,0,4,1,1,0,1,4,0,0,,,1,0,1,,,
"Feb 6, 2023 11:00 PM",7,1,6,1,1,0,3,2,1,2,1,1,0,0,0,2,2,2,0,2,2,0,1,6,0,0,0,2,1,0,,,1,1,0,,,
"Feb 7, 2023 12:00 AM",5,1,4,0,0,0,1,1,0,2,1,1,0,0,0,1,0,0,0,0,0,0,1,2,0,0,0,1,0,0,,,0,0,0,,,
"Feb 7, 2023 1:00 AM",1,0,1,0,0,0,0,0,0,0,0,0,0,0,0,0,1,0,1,0,0,0,0,1,0,0,0,1,0,0,,,1,1,0,,,
"Feb 7, 2023 2:00 AM",7,4,3,2,2,0,1,1,0,1,1,0,0,0,0,0,1,1,0,1,0,1,1,4,0,0,0,1,0,0,,,0,0,0,,,
"Feb 7, 2023 3:00 AM",0,0,0,0,0,0,0,0,0,0,0,0,0,0,0,0,0,0,0,0,0,0,0,0,0,0,0,0,0,0,,,0,0,0,,,
"Feb 7, 2023 4:00 AM",1,0,1,0,0,0,0,0,0,0,0,0,0,0,0,0,2,2,0,1,1,0,2,0,0,0,0,1,0,0,,,1,1,0,,,
"Feb 7, 2023 5:00 AM",10,6,4,1,0,1,4,0,4,2,0,2,0,0,0,0,6,6,0,1,0,1,4,1,0,0,0,10,0,0,,,0,0,0,,,
"Feb 7, 2023 6:00 AM",54,37,17,10,3,7,10,3,7,10,2,8,0,0,0,11,16,16,0,9,5,4,15,11,4,1,3,26,0,2,,,3,2,1,,,
"Feb 7, 2023 7:00 AM",150,115,35,32,5,27,54,14,40,39,9,30,0,0,0,19,89,88,1,19,17,2,76,29,19,5,14,119,2,5,,,8,7,1,,,
"Feb 7, 2023 8:00 AM",292,235,57,71,14,57,127,36,91,93,30,63,0,0,0,40,219,216,3,33,22,11,186,45,78,25,53,223,10,7,,,10,9,1,,,
"Feb 7, 2023 9:00 AM",147,122,25,53,19,34,70,29,41,69,40,29,0,0,0,18,94,92,2,15,13,2,58,22,34,7,27,79,2,10,,,7,5,2,,,
"Feb 7, 2023 10:00 AM",79,55,24,40,16,24,47,22,25,34,17,17,0,0,0,16,44,43,1,6,5,1,37,12,15,7,8,26,0,4,,,0,0,0,,,
"Feb 7, 2023 11:00 AM",51,42,9,29,13,16,50,27,23,31,15,16,0,0,0,11,33,30,3,15,12,3,17,8,21,12,9,19,1,4,,,4,2,2,,,
"Feb 7, 2023 12:00 PM",68,35,33,53,28,25,42,22,20,41,21,20,0,0,0,5,38,37,1,18,17,1,24,23,23,13,10,20,7,2,,,2,2,0,,,
"Feb 7, 2023 1:00 PM",83,30,53,52,28,24,50,29,21,47,27,20,0,0,0,8,25,21,4,29,24,5,17,19,31,17,14,28,3,2,,,9,4,5,,,
"Feb 7, 2023 2:00 PM",82,39,43,24,9,15,60,25,35,36,18,18,0,0,0,17,24,20,4,26,23,3,15,29,32,14,18,21,5,3,,,4,4,0,,,
"Feb 7, 2023 3:00 PM",87,31,56,29,20,9,46,33,13,24,17,7,0,0,0,25,25,17,8,36,31,5,13,32,22,13,9,25,3,1,,,6,5,1,,,
"Feb 7, 2023 4:00 PM",149,29,120,40,20,20,66,35,31,36,18,18,0,0,0,17,37,28,9,54,51,3,29,51,40,30,10,40,4,1,,,10,5,5,,,
"Feb 7, 2023 5:00 PM",249,55,194,62,40,22,92,62,30,69,37,32,0,0,0,25,39,30,9,97,95,2,32,110,65,40,25,49,7,2,,,5,2,3,,,
"Feb 7, 2023 6:00 PM",212,40,172,56,39,17,92,61,31,68,41,27,0,0,0,13,42,33,9,99,94,5,31,115,59,46,13,36,6,3,,,13,8,5,,,
"Feb 7, 2023 7:00 PM",116,22,94,29,24,5,55,44,11,44,29,15,0,0,0,10,26,19,7,54,53,1,11,45,38,28,10,21,3,0,,,7,4,3,,,
"Feb 7, 2023 8:00 PM",85,25,60,10,6,4,23,15,8,15,12,3,0,0,0,4,10,8,2,37,36,1,9,29,17,10,7,15,0,4,,,4,1,3,,,
"Feb 7, 2023 9:00 PM",47,8,39,8,6,2,13,9,4,11,9,2,0,0,0,2,9,6,3,14,12,2,6,13,6,6,0,10,2,1,,,0,0,0,,,
"Feb 7, 2023 10:00 PM",27,3,24,6,5,1,9,7,2,8,5,3,0,0,0,5,7,7,0,13,10,3,7,9,2,1,1,5,3,2,,,3,2,1,,,
"Feb 7, 2023 11:00 PM",11,2,9,2,1,1,3,1,2,2,1,1,0,0,0,1,1,1,0,7,6,1,2,6,0,0,0,2,1,0,,,1,1,0,,,
"Feb 8, 2023 12:00 AM",2,0,2,0,0,0,0,0,0,1,0,1,0,0,0,0,3,3,0,3,2,1,1,1,0,0,0,1,0,0,,,2,1,1,,,
"Feb 8, 2023 1:00 AM",3,1,2,0,0,0,0,0,0,0,0,0,0,0,0,0,0,0,0,2,2,0,0,0,0,0,0,1,0,0,,,0,0,0,,,
"Feb 8, 2023 2:00 AM",3,3,0,0,0,0,0,0,0,0,0,0,0,0,0,0,1,1,0,1,1,0,1,2,0,0,0,0,0,0,,,0,0,0,,,
"Feb 8, 2023 3:00 AM",1,0,1,0,0,0,0,0,0,0,0,0,0,0,0,1,0,0,0,0,0,0,0,0,1,1,0,2,0,0,,,0,0,0,,,
"Feb 8, 2023 4:00 AM",5,1,4,0,0,0,0,0,0,0,0,0,0,0,0,0,3,3,0,0,0,0,3,0,0,0,0,2,0,0,,,0,0,0,,,
"Feb 8, 2023 5:00 AM",13,8,5,1,0,1,2,0,2,1,0,1,0,0,0,1,3,3,0,1,0,1,3,0,0,0,0,9,0,0,,,0,0,0,,,
"Feb 8, 2023 6:00 AM",52,36,16,14,4,10,16,3,13,10,3,7,0,0,0,4,20,20,0,4,4,0,18,13,9,2,7,29,0,3,,,0,0,0,,,
"Feb 8, 2023 7:00 AM",171,125,46,39,8,31,61,18,43,41,10,31,0,0,0,17,86,85,1,20,16,4,87,29,31,10,21,111,3,7,,,7,7,0,,,
"Feb 8, 2023 8:00 AM",328,258,70,82,19,63,146,51,95,104,46,58,0,0,0,41,231,227,4,44,29,15,200,53,71,18,53,230,8,10,,,13,9,4,,,
"Feb 8, 2023 9:00 AM",163,134,29,51,16,35,72,38,34,64,37,27,0,0,0,11,85,85,0,21,12,9,59,23,45,16,29,85,8,2,,,11,10,1,,,
"Feb 8, 2023 10:00 AM",62,44,18,39,18,21,42,23,19,28,18,10,0,0,0,7,49,46,3,14,13,1,31,12,22,15,7,37,1,5,,,3,2,1,,,
"Feb 8, 2023 11:00 AM",53,41,12,45,20,25,45,23,22,41,24,17,0,0,0,8,35,29,6,4,3,1,22,11,13,3,10,25,2,2,,,6,4,2,,,
"Feb 8, 2023 12:00 PM",58,31,27,48,24,24,60,33,27,39,22,17,0,0,0,10,29,24,5,17,13,4,15,18,31,20,11,26,10,0,,,5,4,1,,,
"Feb 8, 2023 1:00 PM",84,31,53,61,33,28,81,48,33,61,37,24,0,0,0,12,34,31,3,36,31,5,21,30,24,15,9,25,4,3,,,6,3,3,,,
"Feb 8, 2023 2:00 PM",60,23,37,41,18,23,64,30,34,37,19,18,0,0,0,17,31,25,6,30,27,3,21,27,39,26,13,20,5,8,,,6,4,2,,,
"Feb 8, 2023 3:00 PM",96,35,61,33,23,10,46,33,13,34,22,12,0,0,0,11,23,15,8,29,26,3,7,38,26,15,11,13,1,1,,,7,3,4,,,
"Feb 8, 2023 4:00 PM",146,41,105,37,28,9,66,41,25,56,33,23,0,0,0,13,37,29,8,44,40,4,29,60,37,22,15,35,4,0,,,5,3,2,,,
"Feb 8, 2023 5:00 PM",253,53,200,43,32,11,95,57,38,79,50,29,0,0,0,32,56,40,16,113,107,6,34,112,59,43,16,63,4,3,,,11,7,4,,,
"Feb 8, 2023 6:00 PM",229,41,188,47,39,8,94,58,36,67,36,31,0,0,0,18,38,26,12,97,92,5,26,90,56,38,18,49,5,2,,,8,7,1,,,
"Feb 8, 2023 7:00 PM",102,24,78,18,13,5,49,40,9,23,15,8,0,0,0,9,18,14,4,69,64,5,13,47,27,22,5,25,4,1,,,7,6,1,,,
"Feb 8, 2023 8:00 PM",70,22,48,12,11,1,23,15,8,17,13,4,0,0,0,5,12,9,3,26,25,1,9,32,12,5,7,18,3,3,,,5,1,4,,,
"Feb 8, 2023 9:00 PM",51,9,42,7,5,2,17,13,4,7,6,1,0,0,0,2,9,5,4,17,16,1,4,21,8,5,3,8,4,0,,,3,2,1,,,
"Feb 8, 2023 10:00 PM",34,8,26,7,7,0,6,3,3,4,3,1,0,0,0,4,6,5,1,15,15,0,5,9,5,4,1,7,2,0,,,5,3,2,,,
"Feb 8, 2023 11:00 PM",8,1,7,1,1,0,6,1,5,1,1,0,0,0,0,0,6,4,2,4,4,0,3,2,0,0,0,1,0,1,,,0,0,0,,,
"Feb 9, 2023 12:00 AM",5,1,4,0,0,0,0,0,0,0,0,0,0,0,0,0,4,3,1,4,4,0,2,1,0,0,0,0,0,0,,,0,0,0,,,
"Feb 9, 2023 1:00 AM",1,1,0,0,0,0,1,1,0,0,0,0,0,0,0,0,0,0,0,2,2,0,0,3,1,1,0,1,0,0,,,0,0,0,,,
"Feb 9, 2023 2:00 AM",5,5,0,0,0,0,0,0,0,0,0,0,0,0,0,0,1,0,1,1,1,0,0,1,0,0,0,0,0,0,,,0,0,0,,,
"Feb 9, 2023 3:00 AM",0,0,0,0,0,0,0,0,0,0,0,0,0,0,0,0,0,0,0,0,0,0,0,0,0,0,0,0,0,0,,,0,0,0,,,
"Feb 9, 2023 4:00 AM",3,1,2,0,0,0,1,1,0,0,0,0,0,0,0,1,1,1,0,1,1,0,1,0,0,0,0,1,0,0,,,1,1,0,,,
"Feb 9, 2023 5:00 AM",8,5,3,2,0,2,8,2,6,3,3,0,0,0,0,1,4,4,0,3,1,2,4,4,0,0,0,6,1,0,,,0,0,0,,,
"Feb 9, 2023 6:00 AM",42,25,17,21,8,13,15,4,11,15,6,9,0,0,0,3,13,13,0,7,7,0,13,13,3,0,3,31,0,4,,,0,0,0,,,
"Feb 9, 2023 7:00 AM",124,93,31,31,6,25,58,12,46,36,12,24,0,0,0,16,73,72,1,17,13,4,63,28,29,7,22,111,3,5,,,6,6,0,,,
"Feb 9, 2023 8:00 AM",318,258,60,85,18,67,125,36,89,98,31,67,0,0,0,35,193,188,5,37,25,12,157,43,79,22,57,223,6,4,,,24,14,10,,,
"Feb 9, 2023 9:00 AM",126,101,25,53,17,36,59,25,34,59,28,31,0,0,0,19,90,88,2,16,13,3,67,27,51,13,38,63,5,3,,,21,13,8,,,
"Feb 9, 2023 10:00 AM",74,60,14,41,13,28,49,27,22,41,23,18,0,0,0,11,44,41,3,12,8,4,27,14,21,11,10,37,3,1,,,5,1,4,,,
"Feb 9, 2023 11:00 AM",62,39,23,28,14,14,46,19,27,25,12,13,0,0,0,12,32,29,3,9,7,2,23,14,13,6,7,29,1,0,,,1,1,0,,,
"Feb 9, 2023 12:00 PM",63,32,31,31,12,19,51,28,23,27,12,15,0,0,0,13,30,29,1,16,15,1,16,19,26,14,12,24,5,2,,,5,4,1,,,
"Feb 9, 2023 1:00 PM",88,36,52,46,25,21,67,38,29,49,28,21,0,0,0,15,37,28,9,23,20,3,18,19,21,10,11,20,6,2,,,7,5,2,,,
"Feb 9, 2023 2:00 PM",79,30,49,25,14,11,41,18,23,29,15,14,0,0,0,15,22,17,5,25,23,2,14,19,31,20,11,32,0,0,,,5,2,3,,,
"Feb 9, 2023 3:00 PM",86,28,58,42,24,18,56,33,23,48,29,19,0,0,0,18,26,19,7,33,27,6,15,39,26,12,14,23,4,0,,,7,2,5,,,
"Feb 9, 2023 4:00 PM",133,38,95,29,24,5,65,40,25,60,32,28,0,0,0,19,31,24,7,49,46,3,22,58,44,31,13,29,8,1,,,6,4,2,,,
"Feb 9, 2023 5:00 PM",198,40,158,62,47,15,102,64,38,75,49,26,0,0,0,23,48,35,13,91,91,0,35,109,52,28,24,56,4,3,,,8,6,2,,,
"Feb 9, 2023 6:00 PM",207,43,164,54,42,12,94,66,28,73,55,18,0,0,0,24,37,29,8,93,87,6,26,91,46,30,16,38,5,4,,,6,5,1,,,
"Feb 9, 2023 7:00 PM",123,36,87,27,21,6,50,40,10,34,23,11,0,0,0,10,16,13,3,51,47,4,14,48,28,18,10,19,1,2,,,6,4,2,,,
"Feb 9, 2023 8:00 PM",81,27,54,16,11,5,22,17,5,23,17,6,0,0,0,11,10,8,2,24,24,0,8,31,9,6,3,13,3,2,,,5,2,3,,,
"Feb 9, 2023 9:00 PM",53,16,37,5,5,0,9,6,3,6,4,2,0,0,0,9,10,10,0,21,20,1,11,8,5,5,0,12,0,1,,,2,0,2,,,
"Feb 9, 2023 10:00 PM",40,7,33,7,5,2,15,8,7,9,4,5,0,0,0,10,10,5,5,15,14,1,6,10,4,3,1,5,0,1,,,2,1,1,,,
"Feb 9, 2023 11:00 PM",15,4,11,1,1,0,2,1,1,0,0,0,0,0,0,2,4,3,1,14,13,1,3,4,2,1,1,0,0,0,,,1,1,0,,,
"Feb 10, 2023 12:00 AM",12,1,11,2,2,0,2,2,0,7,5,2,0,0,0,2,0,0,0,7,6,1,0,6,2,1,1,2,0,0,,,0,0,0,,,
"Feb 10, 2023 1:00 AM",5,1,4,0,0,0,1,0,1,0,0,0,0,0,0,2,1,1,0,1,1,0,1,3,0,0,0,4,0,0,,,0,0,0,,,
"Feb 10, 2023 2:00 AM",2,0,2,0,0,0,1,0,1,0,0,0,0,0,0,0,0,0,0,0,0,0,0,1,0,0,0,0,0,0,,,0,0,0,,,
"Feb 10, 2023 3:00 AM",2,0,2,0,0,0,0,0,0,0,0,0,0,0,0,0,0,0,0,4,4,0,0,1,0,0,0,3,0,0,,,0,0,0,,,
"Feb 10, 2023 4:00 AM",1,1,0,0,0,0,0,0,0,0,0,0,0,0,0,1,1,1,0,1,1,0,1,0,0,0,0,1,0,0,,,0,0,0,,,
"Feb 10, 2023 5:00 AM",6,3,3,1,1,0,3,2,1,2,2,0,0,0,0,2,5,5,0,3,1,2,5,1,0,0,0,10,0,0,,,0,0,0,,,
"Feb 10, 2023 6:00 AM",39,25,14,13,6,7,18,9,9,14,7,7,0,0,0,4,14,14,0,4,4,0,12,14,5,5,0,28,0,2,,,1,1,0,,,
"Feb 10, 2023 7:00 AM",78,55,23,42,14,28,52,17,35,42,17,25,0,0,0,14,53,53,0,14,10,4,44,28,25,10,15,74,2,2,,,8,4,4,,,
"Feb 10, 2023 8:00 AM",218,168,50,53,16,37,105,36,69,75,38,37,0,0,0,23,134,129,5,31,27,4,111,34,56,21,35,127,9,5,,,19,13,6,,,
"Feb 10, 2023 9:00 AM",119,99,20,51,13,38,66,35,31,58,34,24,0,0,0,14,66,65,1,16,11,5,50,31,34,12,22,58,3,5,,,4,4,0,,,
"Feb 10, 2023 10:00 AM",68,49,19,43,23,20,44,24,20,41,23,18,0,0,0,10,42,38,4,13,8,5,26,10,13,7,6,34,1,2,,,4,1,3,,,
"Feb 10, 2023 11:00 AM",48,30,18,49,22,27,44,24,20,36,21,15,0,0,0,11,26,24,2,9,6,3,16,15,12,9,3,24,1,0,,,3,3,0,,,
"Feb 10, 2023 12:00 PM",72,36,36,41,19,22,65,31,34,41,18,23,0,0,0,7,37,30,7,15,15,0,18,23,15,7,8,20,2,3,,,2,2,0,,,
"Feb 10, 2023 1:00 PM",99,33,66,57,27,30,62,31,31,36,18,18,0,0,0,10,26,23,3,27,24,3,23,23,32,16,16,17,3,4,,,4,2,2,,,
"Feb 10, 2023 2:00 PM",79,40,39,41,26,15,64,34,30,40,23,17,0,0,0,15,25,23,2,33,31,2,22,27,28,14,14,23,3,0,,,10,6,4,,,
"Feb 10, 2023 3:00 PM",92,37,55,33,16,17,53,26,27,36,19,17,0,0,0,18,21,18,3,23,20,3,22,26,28,17,11,25,0,2,,,9,6,3,,,
"Feb 10, 2023 4:00 PM",121,29,92,44,28,16,77,48,29,56,33,23,0,0,0,19,27,19,8,40,37,3,19,39,42,25,17,33,7,1,,,9,5,4,,,
"Feb 10, 2023 5:00 PM",157,40,117,49,31,18,65,40,25,58,33,25,0,0,0,32,29,27,2,65,62,3,26,70,47,29,18,43,8,4,,,6,2,4,,,
"Feb 10, 2023 6:00 PM",123,31,92,32,23,9,63,47,16,45,28,17,0,0,0,15,29,22,7,59,57,2,16,61,34,25,9,26,7,2,,,7,4,3,,,
"Feb 10, 2023 7:00 PM",79,21,58,17,11,6,39,26,13,25,17,8,0,0,0,12,20,17,3,39,37,2,14,31,15,9,6,24,3,3,,,6,5,1,,,
"Feb 10, 2023 8:00 PM",69,29,40,6,4,2,17,11,6,21,15,6,0,0,0,10,14,11,3,19,15,4,13,17,4,3,1,13,1,1,,,5,4,1,,,
"Feb 10, 2023 9:00 PM",28,6,22,9,7,2,8,5,3,3,2,1,0,0,0,6,11,8,3,7,7,0,9,10,2,1,1,13,0,2,,,2,2,0,,,
"Feb 10, 2023 10:00 PM",28,8,20,12,8,4,10,5,5,8,1,7,0,0,0,3,12,10,2,8,5,3,7,1,4,2,2,1,0,0,,,3,2,1,,,
"Feb 10, 2023 11:00 PM",19,4,15,6,6,0,5,1,4,5,1,4,0,0,0,2,4,2,2,6,6,0,2,11,7,1,6,7,1,1,,,2,1,1,,,
"Feb 11, 2023 12:00 AM",4,0,4,0,0,0,1,0,1,4,1,3,0,0,0,1,5,5,0,9,8,1,4,2,1,1,0,8,0,0,,,1,1,0,,,
"Feb 11, 2023 1:00 AM",12,2,10,3,3,0,4,4,0,4,2,2,0,0,0,1,2,2,0,4,4,0,2,3,4,4,0,3,0,0,,,1,1,0,,,
"Feb 11, 2023 2:00 AM",4,1,3,4,3,1,5,3,2,4,3,1,0,0,0,3,2,2,0,1,1,0,1,3,0,0,0,2,0,1,,,2,2,0,,,
"Feb 11, 2023 3:00 AM",5,0,5,0,0,0,3,0,3,1,0,1,0,0,0,0,0,0,0,0,0,0,0,1,3,1,2,0,0,0,,,0,0,0,,,
"Feb 11, 2023 4:00 AM",2,1,1,0,0,0,0,0,0,0,0,0,0,0,0,0,0,0,0,2,2,0,0,1,0,0,0,1,0,0,,,0,0,0,,,
"Feb 11, 2023 5:00 AM",4,2,2,0,0,0,2,1,1,1,0,1,0,0,0,1,1,1,0,1,1,0,1,1,1,1,0,1,0,0,,,0,0,0,,,
"Feb 11, 2023 6:00 AM",11,6,5,3,3,0,7,4,3,3,3,0,0,0,0,4,1,1,0,1,1,0,3,2,1,0,1,4,1,0,,,0,0,0,,,
"Feb 11, 2023 7:00 AM",19,11,8,18,10,8,16,8,8,18,11,7,0,0,0,4,1,0,1,5,3,2,0,6,3,0,3,17,0,2,,,0,0,0,,,
"Feb 11, 2023 8:00 AM",34,20,14,56,44,12,45,35,10,44,38,6,0,0,0,7,13,13,0,6,4,2,13,18,7,4,3,12,1,3,,,2,1,1,,,
"Feb 11, 2023 9:00 AM",48,25,23,96,57,39,73,59,14,75,55,20,0,0,0,23,19,19,0,13,8,5,19,27,37,25,12,25,3,10,,,5,4,1,,,
"Feb 11, 2023 10:00 AM",49,27,22,120,68,52,103,58,45,99,66,33,0,0,0,13,29,28,1,13,11,2,29,25,30,16,14,27,5,7,,,5,3,2,,,
"Feb 11, 2023 11:00 AM",56,30,26,118,37,81,117,46,71,114,41,73,0,0,0,14,20,20,0,16,10,6,15,18,49,23,26,39,3,8,,,13,7,6,,,
"Feb 11, 2023 12:00 PM",64,37,27,96,48,48,101,55,46,81,43,38,0,0,0,22,27,24,3,17,16,1,28,30,46,21,25,39,5,6,,,15,13,2,,,
"Feb 11, 2023 1:00 PM",65,35,30,101,50,51,90,40,50,73,38,35,0,0,0,31,31,30,1,15,15,0,29,24,52,21,31,41,3,7,,,4,2,2,,,
"Feb 11, 2023 2:00 PM",47,24,23,38,22,16,53,29,24,32,17,15,0,0,0,7,16,14,2,14,12,2,17,20,39,22,17,25,3,1,,,9,6,3,,,
"Feb 11, 2023 3:00 PM",55,27,28,48,22,26,58,29,29,42,21,21,0,0,0,14,22,21,1,10,10,0,17,15,34,15,19,14,6,2,,,7,3,4,,,
"Feb 11, 2023 4:00 PM",49,23,26,39,17,22,57,16,41,37,8,29,0,0,0,13,15,14,1,10,10,0,12,12,28,13,15,20,2,4,,,12,9,3,,,
"Feb 11, 2023 5:00 PM",64,19,45,45,28,17,47,20,27,45,22,23,0,0,0,10,12,11,1,10,7,3,12,27,21,6,15,18,4,3,,,8,5,3,,,
"Feb 11, 2023 6:00 PM",60,27,33,21,11,10,21,12,9,13,8,5,0,0,0,7,9,9,0,12,10,2,8,15,21,7,14,10,4,0,,,8,6,2,,,
"Feb 11, 2023 7:00 PM",41,18,23,14,5,9,13,5,8,12,5,7,0,0,0,2,8,8,0,8,7,1,10,10,4,3,1,14,2,0,,,4,3,1,,,
"Feb 11, 2023 8:00 PM",26,11,15,7,4,3,9,4,5,13,7,6,0,0,0,3,7,6,1,9,6,3,4,6,1,1,0,8,1,0,,,2,1,1,,,
"Feb 11, 2023 9:00 PM",22,9,13,9,7,2,6,5,1,6,4,2,0,0,0,4,4,4,0,7,6,1,3,7,5,4,1,4,0,0,,,5,2,3,,,
"Feb 11, 2023 10:00 PM",16,7,9,6,5,1,6,4,2,9,4,5,0,0,0,0,6,4,2,1,1,0,4,3,1,0,1,7,0,0,,,1,0,1,,,
"Feb 11, 2023 11:00 PM",18,6,12,4,2,2,8,3,5,6,2,4,0,0,0,2,4,4,0,4,2,2,4,3,2,1,1,1,1,0,,,1,1,0,,,
"Feb 12, 2023 12:00 AM",11,5,6,3,3,0,5,4,1,7,4,3,0,0,0,0,1,1,0,6,6,0,1,4,1,1,0,5,1,0,,,1,1,0,,,
"Feb 12, 2023 1:00 AM",9,1,8,0,0,0,3,2,1,3,1,2,0,0,0,0,1,1,0,0,0,0,0,2,2,2,0,2,0,0,,,2,2,0,,,
"Feb 12, 2023 2:00 AM",3,1,2,3,3,0,4,4,0,2,2,0,0,0,0,0,2,2,0,1,1,0,1,1,0,0,0,0,0,0,,,1,1,0,,,
"Feb 12, 2023 3:00 AM",7,1,6,3,2,1,2,0,2,2,0,2,0,0,0,0,0,0,0,1,1,0,0,5,1,0,1,0,0,1,,,0,0,0,,,
"Feb 12, 2023 4:00 AM",3,1,2,0,0,0,0,0,0,0,0,0,0,0,0,0,1,0,1,1,1,0,0,1,1,1,0,2,0,0,,,0,0,0,,,
"Feb 12, 2023 5:00 AM",4,1,3,0,0,0,1,0,1,0,0,0,0,0,0,0,2,2,0,0,0,0,1,1,0,0,0,2,0,0,,,0,0,0,,,
"Feb 12, 2023 6:00 AM",12,7,5,0,0,0,7,6,1,4,4,0,0,0,0,1,5,5,0,1,1,0,5,3,3,3,0,8,2,1,,,1,1,0,,,
"Feb 12, 2023 7:00 AM",13,9,4,14,3,11,11,6,5,10,5,5,0,0,0,3,9,9,0,2,1,1,9,5,2,0,2,10,0,2,,,0,0,0,,,
"Feb 12, 2023 8:00 AM",33,17,16,72,38,34,49,28,21,48,36,12,0,0,0,1,32,31,1,14,10,4,30,11,25,11,14,21,0,4,,,2,1,1,,,
"Feb 12, 2023 9:00 AM",50,24,26,108,70,38,87,60,27,90,69,21,0,0,0,11,24,22,2,10,6,4,15,24,26,13,13,32,0,9,,,3,2,1,,,
"Feb 12, 2023 10:00 AM",50,35,15,113,65,48,112,61,51,99,60,39,0,0,0,15,24,23,1,11,9,2,20,25,45,24,21,21,6,3,,,3,3,0,,,
"Feb 12, 2023 11:00 AM",49,28,21,133,68,65,113,62,51,104,62,42,0,0,0,16,16,14,2,14,13,1,12,38,42,23,19,33,4,8,,,3,2,1,,,
"Feb 12, 2023 12:00 PM",62,31,31,149,59,90,138,79,59,127,62,65,0,0,0,18,22,21,1,16,12,4,22,31,80,44,36,37,5,1,,,1,1,0,,,
"Feb 12, 2023 1:00 PM",64,31,33,125,58,67,150,71,79,136,69,67,0,0,0,18,39,34,5,11,8,3,36,27,55,28,27,37,3,1,,,8,5,3,,,
"Feb 12, 2023 2:00 PM",51,21,30,138,74,64,136,77,59,117,59,58,0,0,0,22,18,18,0,16,13,3,20,33,79,44,35,29,7,1,,,7,4,3,,,
"Feb 12, 2023 3:00 PM",55,31,24,94,60,34,144,69,75,87,48,39,0,0,0,18,12,11,1,16,15,1,9,36,60,25,35,37,3,2,,,8,6,2,,,
"Feb 12, 2023 4:00 PM",37,15,22,82,35,47,84,24,60,81,29,52,0,0,0,26,14,14,0,13,10,3,14,20,25,6,19,31,3,3,,,3,3,0,,,
"Feb 12, 2023 5:00 PM",40,19,21,56,36,20,63,29,34,53,28,25,0,0,0,11,16,12,4,14,14,0,10,14,34,16,18,36,3,2,,,4,1,3,,,
"Feb 12, 2023 6:00 PM",59,24,35,21,8,13,26,8,18,25,7,18,0,0,0,6,9,7,2,14,11,3,9,9,20,11,9,19,3,0,,,5,4,1,,,
"Feb 12, 2023 7:00 PM",35,17,18,3,2,1,14,5,9,11,4,7,0,0,0,2,6,5,1,5,5,0,5,6,3,0,3,5,1,1,,,2,0,2,,,
"Feb 12, 2023 8:00 PM",30,13,17,6,0,6,8,2,6,10,3,7,0,0,0,8,7,6,1,6,6,0,6,6,4,1,3,10,1,1,,,2,1,1,,,
"Feb 12, 2023 9:00 PM",19,10,9,3,2,1,7,5,2,6,3,3,0,0,0,4,3,3,0,7,7,0,2,5,1,0,1,6,0,2,,,11,6,5,,,
"Feb 12, 2023 10:00 PM",17,7,10,5,1,4,6,2,4,6,2,4,0,0,0,2,6,6,0,5,5,0,7,2,4,2,2,2,0,0,,,3,1,2,,,
"Feb 12, 2023 11:00 PM",12,3,9,1,1,0,3,0,3,1,0,1,0,0,0,1,1,0,1,3,3,0,1,5,0,0,0,0,0,0,,,1,1,0,,,
"Feb 13, 2023 12:00 AM",10,4,6,0,0,0,0,0,0,0,0,0,0,0,0,2,0,0,0,1,1,0,0,3,0,0,0,2,0,0,,,0,0,0,,,
"Feb 13, 2023 1:00 AM",3,0,3,1,1,0,1,1,0,1,1,0,0,0,0,0,0,0,0,0,0,0,0,1,3,3,0,2,0,0,,,1,1,0,,,
"Feb 13, 2023 2:00 AM",1,0,1,0,0,0,3,3,0,2,2,0,0,0,0,0,0,0,0,2,2,0,0,0,1,1,0,1,0,0,,,1,0,1,,,
"Feb 13, 2023 3:00 AM",4,3,1,0,0,0,0,0,0,0,0,0,0,0,0,0,0,0,0,0,0,0,1,0,2,1,1,0,0,0,,,0,0,0,,,
"Feb 13, 2023 4:00 AM",5,1,4,0,0,0,0,0,0,0,0,0,0,0,0,0,1,1,0,3,3,0,2,1,0,0,0,0,0,0,,,0,0,0,,,
"Feb 13, 2023 5:00 AM",12,7,5,1,0,1,4,2,2,4,1,3,0,0,0,2,3,3,0,0,0,0,6,2,1,1,0,5,0,0,,,0,0,0,,,
"Feb 13, 2023 6:00 AM",40,22,18,14,5,9,20,9,11,15,6,9,0,0,0,3,18,18,0,6,6,0,16,11,7,3,4,26,1,1,,,0,0,0,,,
"Feb 13, 2023 7:00 AM",110,75,35,34,14,20,57,16,41,44,17,27,0,0,0,23,64,63,1,14,9,5,59,29,20,5,15,92,0,3,,,6,4,2,,,
"Feb 13, 2023 8:00 AM",224,183,41,57,13,44,93,37,56,66,34,32,0,0,0,22,148,144,4,18,8,10,134,45,44,16,28,150,4,2,,,5,2,3,,,
"Feb 13, 2023 9:00 AM",117,97,20,38,13,25,73,34,39,58,36,22,0,0,0,15,87,86,1,18,9,9,63,19,36,12,24,77,2,6,,,4,3,1,,,
"Feb 13, 2023 10:00 AM",76,59,17,48,15,33,53,23,30,50,25,25,0,0,0,11,41,37,4,12,9,3,25,14,17,11,6,22,1,3,,,1,1,0,,,
"Feb 13, 2023 11:00 AM",52,34,18,26,12,14,43,19,24,21,8,13,0,0,0,11,32,30,2,6,5,1,23,5,23,14,9,25,1,1,,,2,1,1,,,
"Feb 13, 2023 12:00 PM",51,27,24,52,22,30,46,24,22,46,23,23,0,0,0,9,34,31,3,9,9,0,15,13,21,11,10,19,4,2,,,4,4,0,,,
"Feb 13, 2023 1:00 PM",81,30,51,52,24,28,65,31,34,41,17,24,0,0,0,21,18,17,1,18,17,1,14,17,26,13,13,16,3,3,,,7,3,4,,,
"Feb 13, 2023 2:00 PM",82,41,41,44,19,25,67,36,31,45,27,18,0,0,0,29,28,19,9,27,25,2,8,20,37,20,17,26,3,1,,,3,1,2,,,
"Feb 13, 2023 3:00 PM",71,25,46,54,24,30,53,26,27,41,21,20,0,0,0,19,21,15,6,22,17,5,16,17,26,11,15,19,3,1,,,6,6,0,,,
"Feb 13, 2023 4:00 PM",135,41,94,35,23,12,82,49,33,59,30,29,0,0,0,23,36,21,15,38,36,2,15,69,59,35,24,41,2,3,,,4,2,2,,,
"Feb 13, 2023 5:00 PM",215,39,176,48,32,16,93,56,37,59,34,25,0,0,0,38,41,28,13,97,93,4,36,80,69,41,28,49,8,1,,,16,10,6,,,
"Feb 13, 2023 6:00 PM",188,39,149,51,41,10,74,52,22,57,38,19,0,0,0,21,35,23,12,94,94,0,19,96,49,38,11,32,4,4,,,8,4,4,,,
"Feb 13, 2023 7:00 PM",110,33,77,30,19,11,52,40,12,35,25,10,0,0,0,8,19,15,4,48,47,1,12,40,28,17,11,19,6,2,,,2,2,0,,,
"Feb 13, 2023 8:00 PM",58,18,40,6,5,1,20,10,10,14,6,8,0,0,0,1,18,16,2,28,26,2,15,30,11,6,5,14,1,4,,,4,3,1,,,
"Feb 13, 2023 9:00 PM",46,7,39,5,5,0,12,8,4,8,6,2,0,0,0,5,11,6,5,8,6,2,8,15,5,2,3,13,1,0,,,0,0,0,,,
"Feb 13, 2023 10:00 PM",22,5,17,3,3,0,5,5,0,4,3,1,0,0,0,1,8,4,4,16,16,0,5,7,3,3,0,8,0,0,,,1,0,1,,,
"Feb 13, 2023 11:00 PM",12,1,11,4,3,1,6,2,4,4,1,3,0,0,0,1,1,1,0,8,7,1,0,9,0,0,0,4,1,0,,,3,2,1,,,
"Feb 14, 2023 12:00 AM",6,2,4,0,0,0,0,0,0,0,0,0,0,0,0,2,1,0,1,0,0,0,0,0,0,0,0,2,0,0,,,0,0,0,,,
"Feb 14, 2023 1:00 AM",1,1,0,0,0,0,0,0,0,0,0,0,0,0,0,0,4,4,0,3,3,0,3,0,0,0,0,1,0,0,,,0,0,0,,,
"Feb 14, 2023 2:00 AM",5,3,2,0,0,0,0,0,0,0,0,0,0,0,0,0,0,0,0,0,0,0,0,1,1,0,1,0,0,0,,,0,0,0,,,
"Feb 14, 2023 3:00 AM",1,0,1,0,0,0,0,0,0,0,0,0,0,0,0,0,0,0,0,0,0,0,0,0,0,0,0,0,0,0,,,0,0,0,,,
"Feb 14, 2023 4:00 AM",3,1,2,1,0,1,0,0,0,0,0,0,0,0,0,1,2,2,0,0,0,0,2,0,1,0,1,0,0,0,,,0,0,0,,,
"Feb 14, 2023 5:00 AM",4,4,0,3,0,3,4,1,3,4,1,3,0,0,0,1,3,3,0,2,2,0,6,3,2,1,1,3,0,0,,,0,0,0,,,
"Feb 14, 2023 6:00 AM",42,23,19,10,4,6,17,7,10,10,5,5,0,0,0,6,16,15,1,6,5,1,17,11,8,2,6,33,0,4,,,1,1,0,,,
"Feb 14, 2023 7:00 AM",134,99,35,40,8,32,52,11,41,40,13,27,0,0,0,14,92,92,0,19,14,5,89,31,28,7,21,112,4,5,,,5,5,0,,,
"Feb 14, 2023 8:00 AM",262,207,55,80,25,55,107,38,69,82,33,49,0,0,0,25,205,202,3,28,15,13,166,57,66,23,43,187,3,10,,,10,6,4,,,
"Feb 14, 2023 9:00 AM",145,121,24,40,8,32,68,35,33,54,28,26,0,0,0,13,73,73,0,11,9,2,49,17,30,8,22,78,1,4,,,1,1,0,,,
"Feb 14, 2023 10:00 AM",61,52,9,35,6,29,39,16,23,26,13,13,0,0,0,13,35,34,1,7,5,2,26,7,25,13,12,29,4,5,,,2,2,0,,,
"Feb 14, 2023 11:00 AM",50,35,15,31,18,13,35,9,26,31,14,17,0,0,0,9,21,18,3,10,7,3,8,12,19,6,13,19,0,2,,,0,0,0,,,
"Feb 14, 2023 12:00 PM",75,39,36,25,12,13,39,24,15,34,17,17,0,0,0,16,28,23,5,10,8,2,11,18,16,9,7,14,7,1,,,6,5,1,,,
"Feb 14, 2023 1:00 PM",77,40,37,43,28,15,48,28,20,36,22,14,0,0,0,15,28,25,3,21,18,3,6,21,30,17,13,22,1,2,,,5,3,2,,,
"Feb 14, 2023 2:00 PM",68,34,34,44,24,20,47,24,23,34,23,11,0,0,0,14,27,20,7,22,20,2,6,25,20,14,6,24,5,2,,,6,3,3,,,
"Feb 14, 2023 3:00 PM",83,30,53,42,24,18,62,41,21,48,31,17,0,0,0,23,27,19,8,29,27,2,18,28,25,15,10,22,2,2,,,3,3,0,,,
"Feb 14, 2023 4:00 PM",154,38,116,45,26,19,74,47,27,48,24,24,0,0,0,21,34,21,13,36,36,0,21,55,48,34,14,42,9,0,,,11,8,3,,,
"Feb 14, 2023 5:00 PM",245,55,190,50,29,21,99,48,51,71,31,40,0,0,0,29,39,31,8,109,106,3,30,126,67,36,31,55,8,5,,,11,5,6,,,
"Feb 14, 2023 6:00 PM",198,40,158,37,27,10,96,67,29,60,39,21,0,0,0,21,41,34,7,96,90,6,33,120,54,33,21,40,6,3,,,12,6,6,,,
"Feb 14, 2023 7:00 PM",112,21,91,37,35,2,47,42,5,44,34,10,0,0,0,10,13,10,3,47,46,1,10,43,26,22,4,26,5,0,,,13,11,2,,,
"Feb 14, 2023 8:00 PM",79,17,62,19,14,5,31,19,12,25,14,11,0,0,0,8,13,12,1,32,27,5,12,24,10,7,3,21,3,7,,,11,6,5,,,
"Feb 14, 2023 9:00 PM",42,18,24,5,5,0,7,4,3,6,5,1,0,0,0,6,13,7,6,11,9,2,4,10,3,2,1,7,3,0,,,4,2,2,,,
"Feb 14, 2023 10:00 PM",34,6,28,2,2,0,7,4,3,5,3,2,0,0,0,2,5,3,2,8,6,2,2,10,0,0,0,8,1,0,,,1,1,0,,,
"Feb 14, 2023 11:00 PM",8,0,8,1,1,0,7,3,4,4,2,2,0,0,0,0,2,2,0,3,3,0,2,6,0,0,0,3,1,0,,,1,1,0,,,
"Feb 15, 2023 12:00 AM",7,1,6,1,1,0,1,1,0,0,0,0,0,0,0,1,2,2,0,2,2,0,1,0,0,0,0,0,1,1,,,1,0,1,,,
"Feb 15, 2023 1:00 AM",3,1,2,1,0,1,1,0,1,1,0,1,0,0,0,0,1,1,0,2,2,0,1,0,0,0,0,1,0,0,,,0,0,0,,,
"Feb 15, 2023 2:00 AM",4,2,2,0,0,0,0,0,0,0,0,0,0,0,0,0,1,0,1,1,1,0,0,0,0,0,0,0,0,0,,,0,0,0,,,
"Feb 15, 2023 3:00 AM",0,0,0,0,0,0,0,0,0,0,0,0,0,0,0,0,0,0,0,0,0,0,0,0,1,1,0,0,0,0,,,0,0,0,,,
"Feb 15, 2023 4:00 AM",2,2,0,1,1,0,0,0,0,0,0,0,0,0,0,0,1,1,0,1,1,0,3,0,0,0,0,0,0,0,,,0,0,0,,,
"Feb 15, 2023 5:00 AM",10,4,6,2,0,2,2,1,1,2,1,1,0,0,0,0,3,3,0,2,2,0,3,2,1,1,0,6,0,0,,,1,0,1,,,
"Feb 15, 2023 6:00 AM",25,15,10,5,1,4,11,4,7,6,2,4,0,0,0,2,13,13,0,3,2,1,12,9,3,1,2,25,0,1,,,0,0,0,,,
"Feb 15, 2023 7:00 AM",103,76,27,26,5,21,39,5,34,26,5,21,0,0,0,12,63,63,0,18,15,3,63,28,17,3,14,82,1,3,,,4,4,0,,,
"Feb 15, 2023 8:00 AM",227,182,45,48,10,38,90,33,57,69,29,40,0,0,0,26,151,151,0,26,18,8,132,43,52,15,37,144,7,6,,,9,6,3,,,
"Feb 15, 2023 9:00 AM",131,112,19,45,15,30,71,28,43,51,29,22,0,0,0,7,70,70,0,16,9,7,42,27,41,6,35,79,1,5,,,1,1,0,,,
"Feb 15, 2023 10:00 AM",57,40,17,33,14,19,31,12,19,25,11,14,0,0,0,8,48,43,5,13,8,5,30,10,11,7,4,26,3,1,,,2,2,0,,,
"Feb 15, 2023 11:00 AM",31,12,19,38,21,17,30,15,15,32,23,9,0,0,0,11,35,32,3,3,3,0,21,6,10,6,4,18,1,0,,,4,3,1,,,
"Feb 15, 2023 12:00 PM",55,35,20,39,22,17,45,32,13,36,23,13,0,0,0,13,37,28,9,14,11,3,17,22,25,13,12,17,4,1,,,4,3,1,,,
"Feb 15, 2023 1:00 PM",68,26,42,49,23,26,54,28,26,49,25,24,0,0,0,13,32,27,5,20,20,0,20,8,23,10,13,27,1,3,,,5,1,4,,,
"Feb 15, 2023 2:00 PM",45,18,27,29,15,14,33,18,15,28,17,11,0,0,0,16,29,24,5,20,20,0,16,17,28,15,13,14,0,3,,,5,2,3,,,
"Feb 15, 2023 3:00 PM",86,32,54,24,12,12,34,19,15,22,10,12,0,0,0,24,25,19,6,19,17,2,12,20,26,15,11,19,1,1,,,7,5,2,,,
"Feb 15, 2023 4:00 PM",108,26,82,31,21,10,74,42,32,45,29,16,0,0,0,19,35,24,11,43,41,2,23,56,32,21,11,37,7,1,,,2,2,0,,,
"Feb 15, 2023 5:00 PM",214,37,177,47,30,17,88,49,39,61,30,31,0,0,0,34,45,29,16,76,74,2,30,86,52,30,22,50,5,1,,,8,3,5,,,
"Feb 15, 2023 6:00 PM",184,41,143,42,33,9,95,64,31,57,35,22,0,0,0,17,41,30,11,83,80,3,26,90,58,40,18,36,5,2,,,8,7,1,,,
"Feb 15, 2023 7:00 PM",100,25,75,27,18,9,45,28,17,35,22,13,0,0,0,6,15,10,5,57,55,2,13,35,23,13,10,17,2,1,,,6,5,1,,,
"Feb 15, 2023 8:00 PM",68,18,50,11,8,3,11,7,4,13,7,6,0,0,0,7,20,17,3,19,18,1,20,32,8,6,2,8,3,4,,,4,2,2,,,
"Feb 15, 2023 9:00 PM",46,13,33,13,10,3,9,7,2,7,7,0,0,0,0,5,11,8,3,19,19,0,8,21,5,3,2,6,1,1,,,3,1,2,,,
"Feb 15, 2023 10:00 PM",48,9,39,5,5,0,10,7,3,8,5,3,0,0,0,6,11,8,3,14,13,1,8,8,4,2,2,3,3,0,,,0,0,0,,,
"Feb 15, 2023 11:00 PM",11,2,9,2,1,1,4,2,2,6,2,4,0,0,0,0,3,2,1,6,5,1,1,3,1,1,0,7,1,0,,,2,1,1,,,
"Feb 16, 2023 12:00 AM",5,2,3,0,0,0,3,1,2,1,1,0,0,0,0,1,2,1,1,1,1,0,1,2,1,1,0,2,0,0,,,0,0,0,,,
"Feb 16, 2023 1:00 AM",4,1,3,2,2,0,4,3,1,4,3,1,0,0,0,1,0,0,0,3,3,0,0,2,0,0,0,0,0,0,,,0,0,0,,,
"Feb 16, 2023 2:00 AM",3,2,1,0,0,0,1,0,1,0,0,0,0,0,0,0,0,0,0,0,0,0,0,0,0,0,0,3,0,0,,,0,0,0,,,
"Feb 16, 2023 3:00 AM",1,0,1,1,0,1,0,0,0,0,0,0,0,0,0,0,0,0,0,0,0,0,0,1,1,0,1,0,0,0,,,0,0,0,,,
"Feb 16, 2023 4:00 AM",2,2,0,0,0,0,0,0,0,0,0,0,0,0,0,0,1,1,0,1,1,0,1,0,0,0,0,1,0,0,,,2,1,1,,,
"Feb 16, 2023 5:00 AM",8,5,3,2,0,2,1,0,1,2,0,2,0,0,0,1,8,8,0,2,2,0,9,2,2,1,1,4,1,0,,,0,0,0,,,
"Feb 16, 2023 6:00 AM",39,23,16,16,8,8,12,4,8,14,8,6,0,0,0,6,12,12,0,4,4,0,13,16,6,0,6,22,0,2,,,0,0,0,,,
"Feb 16, 2023 7:00 AM",116,81,35,43,11,32,50,15,35,40,13,27,0,0,0,12,71,70,1,19,17,2,64,26,25,11,14,106,2,2,,,5,5,0,,,
"Feb 16, 2023 8:00 AM",251,202,49,64,16,48,101,35,66,69,28,41,0,0,0,19,158,157,1,28,16,12,132,45,58,14,44,185,3,6,,,6,4,2,,,
"Feb 16, 2023 9:00 AM",128,107,21,48,17,31,76,29,47,63,29,34,0,0,0,10,88,86,2,9,6,3,62,14,47,15,32,73,3,3,,,3,3,0,,,
"Feb 16, 2023 10:00 AM",67,55,12,36,14,22,46,19,27,38,20,18,0,0,0,12,38,34,4,8,5,3,20,5,17,7,10,23,0,3,,,10,10,0,,,
"Feb 16, 2023 11:00 AM",51,30,21,24,14,10,30,10,20,24,12,12,0,0,0,7,35,32,3,10,8,2,22,13,19,8,11,26,4,5,,,9,4,5,,,
"Feb 16, 2023 12:00 PM",68,32,36,36,19,17,37,24,13,28,17,11,0,0,0,11,26,23,3,17,13,4,13,15,21,13,8,21,7,3,,,4,3,1,,,
"Feb 16, 2023 1:00 PM",68,36,32,31,16,15,40,28,12,32,18,14,0,0,0,10,29,29,0,21,16,5,19,18,19,10,9,11,6,0,,,4,3,1,,,
"Feb 16, 2023 2:00 PM",72,31,41,45,20,25,43,25,18,35,17,18,0,0,0,8,26,18,8,21,19,2,15,27,28,13,15,16,4,3,,,7,4,3,,,
"Feb 16, 2023 3:00 PM",77,22,55,44,26,18,49,26,23,40,27,13,0,0,0,16,31,21,10,26,25,1,18,29,31,20,11,20,6,1,,,5,4,1,,,
"Feb 16, 2023 4:00 PM",126,34,92,37,26,11,65,36,29,50,26,24,0,0,0,28,30,22,8,38,37,1,22,55,35,20,15,37,3,5,,,9,6,3,,,
"Feb 16, 2023 5:00 PM",206,58,148,72,44,28,106,69,37,84,49,35,0,0,0,25,45,30,15,89,85,4,29,104,59,37,22,53,8,1,,,15,8,7,,,
"Feb 16, 2023 6:00 PM",176,34,142,56,36,20,98,60,38,84,54,30,0,0,0,15,39,24,15,82,80,2,23,87,51,33,18,34,5,2,,,9,8,1,,,
"Feb 16, 2023 7:00 PM",96,27,69,29,21,8,40,31,9,31,21,10,0,0,0,5,19,16,3,47,44,3,13,49,23,15,8,17,2,1,,,4,4,0,,,
"Feb 16, 2023 8:00 PM",81,18,63,12,11,1,30,19,11,23,14,9,0,0,0,10,20,15,5,23,20,3,16,33,16,12,4,9,3,2,,,4,2,2,,,
"Feb 16, 2023 9:00 PM",52,12,40,13,9,4,19,12,7,18,10,8,0,0,0,6,17,17,0,18,18,0,15,20,6,4,2,8,1,0,,,0,0,0,,,
"Feb 16, 2023 10:00 PM",43,11,32,8,7,1,4,1,3,6,3,3,0,0,0,5,8,7,1,20,18,2,7,15,4,1,3,6,2,0,,,1,0,1,,,
"Feb 16, 2023 11:00 PM",23,2,21,1,1,0,4,3,1,4,3,1,0,0,0,3,1,1,0,7,7,0,1,5,2,1,1,2,1,1,,,7,4,3,,,
"Feb 17, 2023 12:00 AM",6,1,5,0,0,0,2,2,0,0,0,0,0,0,0,1,0,0,0,9,8,1,0,2,2,2,0,1,0,0,,,0,0,0,,,
"Feb 17, 2023 1:00 AM",5,0,5,1,1,0,4,1,3,3,1,2,0,0,0,0,0,0,0,2,2,0,0,0,4,3,1,4,0,0,,,0,0,0,,,
"Feb 17, 2023 2:00 AM",5,3,2,2,2,0,5,5,0,4,4,0,0,0,0,1,1,1,0,1,1,0,0,2,0,0,0,0,0,0,,,0,0,0,,,
"Feb 17, 2023 3:00 AM",0,0,0,0,0,0,1,0,1,0,0,0,0,0,0,0,0,0,0,1,1,0,0,2,0,0,0,0,0,0,,,0,0,0,,,
"Feb 17, 2023 4:00 AM",3,2,1,0,0,0,1,0,1,0,0,0,0,0,0,0,4,4,0,0,0,0,1,0,1,0,1,1,0,0,,,0,0,0,,,
"Feb 17, 2023 5:00 AM",6,5,1,1,1,0,2,1,1,2,1,1,0,0,0,2,6,6,0,2,2,0,6,2,0,0,0,3,0,0,,,0,0,0,,,
"Feb 17, 2023 6:00 AM",33,21,12,9,6,3,17,10,7,11,7,4,0,0,0,4,5,5,0,6,5,1,4,7,4,3,1,18,0,0,,,0,0,0,,,
"Feb 17, 2023 7:00 AM",61,43,18,42,16,26,34,14,20,24,8,16,0,0,0,8,42,41,1,12,9,3,38,16,15,7,8,50,2,1,,,5,5,0,,,
"Feb 17, 2023 8:00 AM",157,125,32,46,12,34,79,22,57,54,21,33,0,0,0,18,82,81,1,16,9,7,63,30,33,13,20,101,4,2,,,5,3,2,,,
"Feb 17, 2023 9:00 AM",93,70,23,48,23,25,72,38,34,68,44,24,0,0,0,12,56,56,0,11,8,3,42,16,35,20,15,53,0,7,,,1,0,1,,,
"Feb 17, 2023 10:00 AM",62,47,15,40,16,24,63,35,28,42,22,20,0,0,0,7,30,29,1,9,7,2,18,14,19,8,11,19,0,2,,,5,3,2,,,
"Feb 17, 2023 11:00 AM",58,33,25,32,13,19,50,23,27,32,13,19,0,0,0,12,30,27,3,7,5,2,16,23,23,10,13,28,0,3,,,7,5,2,,,
"Feb 17, 2023 12:00 PM",66,32,34,39,24,15,63,28,35,36,21,15,0,0,0,20,32,28,4,9,7,2,27,15,29,19,10,25,6,1,,,9,6,3,,,
"Feb 17, 2023 1:00 PM",91,33,58,45,23,22,59,34,25,36,22,14,0,0,0,17,19,18,1,13,12,1,18,14,28,17,11,32,2,8,,,10,5,5,,,
"Feb 17, 2023 2:00 PM",72,35,37,64,33,31,61,34,27,55,30,25,0,0,0,18,24,19,5,23,21,2,15,26,31,18,13,17,4,2,,,6,4,2,,,
"Feb 17, 2023 3:00 PM",85,33,52,62,29,33,54,32,22,58,33,25,0,0,0,16,21,15,6,20,20,0,16,34,25,14,11,20,1,0,,,5,3,2,,,
"Feb 17, 2023 4:00 PM",106,28,78,35,19,16,70,40,30,52,25,27,0,0,0,25,28,19,9,38,37,1,16,37,20,13,7,28,5,2,,,12,7,5,,,
"Feb 17, 2023 5:00 PM",152,35,117,59,40,19,77,45,32,63,39,24,0,0,0,25,31,22,9,52,52,0,18,50,40,26,14,38,1,1,,,11,5,6,,,
"Feb 17, 2023 6:00 PM",109,41,68,38,25,13,74,38,36,65,31,34,0,0,0,16,28,22,6,45,43,2,17,35,34,27,7,36,5,2,,,9,4,5,,,
"Feb 17, 2023 7:00 PM",70,23,47,23,19,4,25,17,8,24,17,7,0,0,0,10,17,14,3,18,16,2,14,26,12,10,2,18,3,4,,,3,3,0,,,
"Feb 17, 2023 8:00 PM",77,29,48,15,6,9,21,10,11,20,7,13,0,0,0,8,10,6,4,17,15,2,7,15,10,7,3,16,0,0,,,2,2,0,,,
"Feb 17, 2023 9:00 PM",34,8,26,13,11,2,12,7,5,9,6,3,0,0,0,8,7,6,1,8,8,0,6,15,5,5,0,6,2,0,,,4,1,3,,,
"Feb 17, 2023 10:00 PM",30,11,19,9,3,6,11,8,3,7,2,5,0,0,0,5,5,4,1,8,6,2,3,13,6,3,3,3,1,0,,,2,1,1,,,
"Feb 17, 2023 11:00 PM",19,6,13,5,4,1,6,3,3,6,3,3,0,0,0,2,3,3,0,9,7,2,3,4,3,0,3,4,3,0,,,1,1,0,,,
"Feb 18, 2023 12:00 AM",9,3,6,0,0,0,1,0,1,1,0,1,0,0,0,2,2,1,1,7,7,0,1,5,1,0,1,4,0,0,,,0,0,0,,,
"Feb 18, 2023 1:00 AM",8,3,5,0,0,0,0,0,0,0,0,0,0,0,0,1,0,0,0,3,3,0,0,2,0,0,0,1,1,0,,,2,2,0,,,
"Feb 18, 2023 2:00 AM",5,1,4,0,0,0,0,0,0,0,0,0,0,0,0,1,0,0,0,4,4,0,0,2,0,0,0,1,0,0,,,0,0,0,,,
"Feb 18, 2023 3:00 AM",6,2,4,0,0,0,0,0,0,0,0,0,0,0,0,0,0,0,0,0,0,0,0,0,0,0,0,0,0,0,,,0,0,0,,,
"Feb 18, 2023 4:00 AM",5,1,4,0,0,0,0,0,0,0,0,0,0,0,0,0,0,0,0,0,0,0,0,1,0,0,0,0,0,0,,,0,0,0,,,
"Feb 18, 2023 5:00 AM",1,1,0,1,0,1,1,0,1,1,0,1,0,0,0,1,0,0,0,2,2,0,0,3,0,0,0,1,0,0,,,1,1,0,,,
"Feb 18, 2023 6:00 AM",9,8,1,5,1,4,6,3,3,4,1,3,0,0,0,2,2,2,0,1,1,0,3,3,2,1,1,9,0,1,,,1,1,0,,,
"Feb 18, 2023 7:00 AM",15,8,7,14,7,7,12,7,5,17,11,6,0,0,0,1,4,3,1,7,7,0,3,12,6,1,5,11,0,1,,,1,0,1,,,
"Feb 18, 2023 8:00 AM",37,17,20,37,14,23,35,19,16,34,22,12,0,0,0,7,17,17,0,4,3,1,16,17,15,7,8,27,1,6,,,4,3,1,,,
"Feb 18, 2023 9:00 AM",33,17,16,59,34,25,54,38,16,43,33,10,0,0,0,8,25,25,0,8,6,2,26,16,26,16,10,25,2,6,,,4,2,2,,,
"Feb 18, 2023 10:00 AM",53,37,16,66,34,32,87,55,32,65,38,27,0,0,0,12,26,26,0,7,6,1,26,12,39,28,11,22,4,7,,,5,5,0,,,
"Feb 18, 2023 11:00 AM",55,34,21,95,43,52,102,51,51,71,42,29,0,0,0,19,28,25,3,10,8,2,19,26,37,22,15,30,6,1,,,12,8,4,,,
"Feb 18, 2023 12:00 PM",69,35,34,88,47,41,88,44,44,81,48,33,0,0,0,19,23,17,6,20,17,3,16,22,46,20,26,30,10,5,,,10,8,2,,,
"Feb 18, 2023 1:00 PM",41,17,24,64,34,30,70,32,38,52,28,24,0,0,0,12,33,30,3,18,17,1,25,15,41,18,23,20,8,3,,,5,5,0,,,
"Feb 18, 2023 2:00 PM",46,26,20,71,41,30,75,40,35,66,45,21,0,0,0,17,14,9,5,20,18,2,9,15,36,22,14,30,5,1,,,6,5,1,,,
"Feb 18, 2023 3:00 PM",50,30,20,83,47,36,78,40,38,73,38,35,0,0,0,20,20,18,2,20,17,3,11,17,26,9,17,18,6,5,,,10,4,6,,,
"Feb 18, 2023 4:00 PM",42,19,23,72,37,35,78,42,36,64,31,33,0,0,0,10,17,17,0,13,12,1,13,17,35,18,17,22,5,1,,,9,8,1,,,
"Feb 18, 2023 5:00 PM",45,16,29,41,22,19,45,23,22,48,24,24,0,0,0,11,17,15,2,16,15,1,13,15,14,7,7,12,4,2,,,13,8,5,,,
"Feb 18, 2023 6:00 PM",44,24,20,24,15,9,33,17,16,17,3,14,0,0,0,7,16,12,4,11,10,1,11,12,10,3,7,15,2,0,,,4,3,1,,,
"Feb 18, 2023 7:00 PM",39,17,22,14,8,6,12,4,8,11,4,7,0,0,0,6,10,10,0,15,13,2,11,10,7,2,5,16,5,2,,,3,2,1,,,
"Feb 18, 2023 8:00 PM",22,17,5,9,6,3,14,5,9,9,7,2,0,0,0,2,6,5,1,9,8,1,6,8,3,2,1,7,0,1,,,2,0,2,,,
"Feb 18, 2023 9:00 PM",30,15,15,15,10,5,5,4,1,2,1,1,0,0,0,5,7,7,0,8,8,0,7,5,2,2,0,8,0,0,,,5,3,2,,,
"Feb 18, 2023 10:00 PM",15,3,12,9,6,3,6,4,2,4,3,1,0,0,0,6,4,2,2,5,4,1,3,5,2,2,0,5,0,0,,,1,0,1,,,
"Feb 18, 2023 11:00 PM",9,3,6,8,5,3,9,8,1,8,6,2,0,0,0,3,6,6,0,5,5,0,5,2,6,3,3,4,2,0,,,1,1,0,,,
"Feb 19, 2023 12:00 AM",6,1,5,0,0,0,1,0,1,6,1,5,0,0,0,0,2,2,0,1,1,0,2,3,2,1,1,6,0,0,,,1,1,0,,,
"Feb 19, 2023 1:00 AM",6,0,6,0,0,0,3,1,2,5,1,4,0,0,0,1,2,2,0,1,1,0,1,3,2,0,2,0,0,0,,,0,0,0,,,
"Feb 19, 2023 2:00 AM",5,0,5,0,0,0,0,0,0,0,0,0,0,0,0,0,2,2,0,1,1,0,3,1,0,0,0,0,0,0,,,0,0,0,,,
"Feb 19, 2023 3:00 AM",0,0,0,0,0,0,1,1,0,0,0,0,0,0,0,0,0,0,0,0,0,0,0,1,1,1,0,2,0,0,,,0,0,0,,,
"Feb 19, 2023 4:00 AM",6,1,5,1,1,0,1,1,0,2,2,0,0,0,0,0,0,0,0,0,0,0,1,1,0,0,0,1,0,1,,,0,0,0,,,
"Feb 19, 2023 5:00 AM",4,0,4,2,1,1,1,0,1,3,1,2,0,0,0,0,1,1,0,0,0,0,1,0,1,0,1,3,0,0,,,0,0,0,,,
"Feb 19, 2023 6:00 AM",7,5,2,9,4,5,6,3,3,7,3,4,0,0,0,2,2,2,0,2,2,0,2,6,0,0,0,3,0,0,,,0,0,0,,,
"Feb 19, 2023 7:00 AM",8,6,2,18,8,10,14,10,4,15,9,6,0,0,0,0,0,0,0,4,3,1,2,7,3,0,3,10,0,6,,,0,0,0,,,
"Feb 19, 2023 8:00 AM",41,18,23,79,51,28,65,46,19,60,42,18,0,0,0,4,19,18,1,10,8,2,12,12,21,16,5,20,4,3,,,2,2,0,,,
"Feb 19, 2023 9:00 AM",67,22,45,85,45,40,88,58,30,78,54,24,0,0,0,9,20,19,1,10,6,4,17,30,36,19,17,26,5,12,,,3,2,1,,,
"Feb 19, 2023 10:00 AM",58,45,13,130,67,63,135,78,57,107,64,43,0,0,0,14,26,23,3,12,9,3,19,24,45,28,17,34,4,0,,,5,5,0,,,
"Feb 19, 2023 11:00 AM",43,24,19,164,74,90,157,78,79,130,71,59,0,0,0,19,24,24,0,11,10,1,20,33,59,34,25,54,3,4,,,5,4,1,,,
"Feb 19, 2023 12:00 PM",55,31,24,138,74,64,167,89,78,122,61,61,0,0,0,16,15,14,1,15,15,0,15,25,63,37,26,51,8,6,,,13,8,5,,,
"Feb 19, 2023 1:00 PM",64,35,29,184,99,85,162,78,84,159,83,76,0,0,0,9,23,21,2,13,10,3,18,15,72,45,27,24,5,5,,,8,5,3,,,
"Feb 19, 2023 2:00 PM",56,35,21,135,79,56,126,62,64,113,59,54,0,0,0,19,26,23,3,23,19,4,22,24,69,31,38,34,4,2,,,7,2,5,,,
"Feb 19, 2023 3:00 PM",68,34,34,151,63,88,112,56,56,120,58,62,0,0,0,21,17,15,2,14,11,3,6,17,61,23,38,22,0,3,,,6,6,0,,,
"Feb 19, 2023 4:00 PM",46,26,20,131,69,62,101,38,63,87,32,55,0,0,0,11,19,16,3,10,8,2,14,16,41,18,23,27,2,3,,,10,8,2,,,
"Feb 19, 2023 5:00 PM",57,17,40,76,41,35,70,26,44,66,27,39,0,0,0,23,14,13,1,9,9,0,13,13,36,20,16,27,8,1,,,7,3,4,,,
"Feb 19, 2023 6:00 PM",45,23,22,41,15,26,42,15,27,33,8,25,0,0,0,8,13,12,1,13,13,0,10,5,13,5,8,14,4,1,,,5,3,2,,,
"Feb 19, 2023 7:00 PM",25,10,15,15,12,3,11,6,5,8,7,1,0,0,0,15,13,12,1,10,9,1,8,4,5,3,2,11,2,1,,,5,2,3,,,
"Feb 19, 2023 8:00 PM",23,8,15,10,6,4,15,8,7,6,3,3,0,0,0,3,5,5,0,11,9,2,5,4,5,1,4,10,0,0,,,0,0,0,,,
"Feb 19, 2023 9:00 PM",21,9,12,6,3,3,9,7,2,2,1,1,0,0,0,4,3,3,0,5,4,1,2,4,4,1,3,7,0,0,,,1,0,1,,,
"Feb 19, 2023 10:00 PM",19,9,10,3,2,1,11,3,8,6,2,4,0,0,0,3,5,3,2,2,2,0,3,6,1,1,0,6,1,0,,,1,1,0,,,
"Feb 19, 2023 11:00 PM",4,0,4,5,5,0,5,2,3,4,1,3,0,0,0,0,0,0,0,2,2,0,0,4,0,0,0,3,1,0,,,1,1,0,,,
"Feb 20, 2023 12:00 AM",2,1,1,0,0,0,3,2,1,3,2,1,0,0,0,0,2,2,0,1,0,1,2,1,0,0,0,3,0,0,,,0,0,0,,,
"Feb 20, 2023 1:00 AM",5,1,4,0,0,0,0,0,0,0,0,0,0,0,0,0,0,0,0,1,1,0,0,0,1,1,0,1,0,0,,,0,0,0,,,
"Feb 20, 2023 2:00 AM",0,0,0,0,0,0,0,0,0,0,0,0,0,0,0,0,0,0,0,0,0,0,0,0,1,1,0,0,0,0,,,0,0,0,,,
"Feb 20, 2023 3:00 AM",0,0,0,0,0,0,0,0,0,0,0,0,0,0,0,0,0,0,0,1,1,0,0,0,0,0,0,0,0,0,,,0,0,0,,,
"Feb 20, 2023 4:00 AM",1,0,1,1,0,1,1,0,1,1,0,1,0,0,0,1,2,2,0,0,0,0,2,0,1,0,1,1,0,0,,,0,0,0,,,
"Feb 20, 2023 5:00 AM",9,6,3,2,0,2,3,1,2,2,1,1,0,0,0,0,1,1,0,2,1,1,1,2,1,0,1,5,0,0,,,0,0,0,,,
"Feb 20, 2023 6:00 AM",38,25,13,12,4,8,22,7,15,15,6,9,0,0,0,5,22,22,0,6,4,2,18,11,10,6,4,32,1,1,,,1,1,0,,,
"Feb 20, 2023 7:00 AM",139,98,41,55,12,43,75,14,61,51,14,37,0,0,0,23,89,88,1,18,16,2,83,27,24,4,20,110,4,2,,,8,8,0,,,
"Feb 20, 2023 8:00 AM",273,215,58,70,21,49,116,38,78,97,44,53,0,0,0,38,173,169,4,36,24,12,156,52,61,9,52,218,8,3,,,15,13,2,,,
"Feb 20, 2023 9:00 AM",147,124,23,49,19,30,81,36,45,66,34,32,0,0,0,17,101,101,0,22,16,6,69,24,40,15,25,63,4,4,,,5,3,2,,,
"Feb 20, 2023 10:00 AM",68,51,17,36,19,17,46,22,24,39,23,16,0,0,0,9,44,41,3,7,5,2,27,14,18,7,11,24,0,2,,,5,3,2,,,
"Feb 20, 2023 11:00 AM",42,26,16,40,22,18,38,23,15,27,17,10,0,0,0,6,23,20,3,7,4,3,15,10,12,6,6,19,3,0,,,5,4,1,,,
"Feb 20, 2023 12:00 PM",55,33,22,62,28,34,55,27,28,40,20,20,0,0,0,4,34,31,3,13,10,3,13,17,26,16,10,23,2,3,,,4,2,2,,,
"Feb 20, 2023 1:00 PM",72,38,34,54,30,24,66,33,33,52,27,25,0,0,0,5,30,27,3,21,15,6,22,19,41,24,17,25,3,2,,,3,1,2,,,
"Feb 20, 2023 2:00 PM",67,33,34,52,28,24,53,26,27,43,27,16,0,0,0,9,25,17,8,24,20,4,13,31,36,15,21,16,2,1,,,8,2,6,,,
"Feb 20, 2023 3:00 PM",79,21,58,37,23,14,48,28,20,38,21,17,0,0,0,17,32,24,8,32,26,6,14,28,21,8,13,21,4,0,,,6,1,5,,,
"Feb 20, 2023 4:00 PM",137,41,96,62,43,19,91,63,28,70,46,24,0,0,0,20,37,30,7,50,46,4,31,65,49,26,23,38,4,2,,,5,2,3,,,
"Feb 20, 2023 5:00 PM",215,52,163,73,45,28,124,76,48,103,58,45,0,0,0,35,43,30,13,113,109,4,32,103,69,56,13,59,6,3,,,7,4,3,,,
"Feb 20, 2023 6:00 PM",197,46,151,75,48,27,95,64,31,86,50,36,0,0,0,27,45,27,18,98,92,6,25,108,48,33,15,32,3,6,,,14,7,7,,,
"Feb 20, 2023 7:00 PM",115,28,87,28,18,10,51,35,16,36,22,14,0,0,0,16,24,17,7,58,53,5,12,43,33,23,10,22,5,2,,,3,3,0,,,
"Feb 20, 2023 8:00 PM",75,20,55,19,11,8,26,16,10,15,10,5,0,0,0,8,14,9,5,20,20,0,7,23,9,7,2,17,3,0,,,4,2,2,,,
"Feb 20, 2023 9:00 PM",59,10,49,6,3,3,14,5,9,7,4,3,0,0,0,2,10,7,3,15,14,1,4,7,8,8,0,18,1,1,,,4,2,2,,,
"Feb 20, 2023 10:00 PM",39,12,27,5,3,2,5,3,2,5,1,4,0,0,0,3,4,2,2,18,18,0,1,4,5,3,2,7,3,0,,,3,3,0,,,
"Feb 20, 2023 11:00 PM",17,3,14,2,2,0,4,3,1,5,4,1,0,0,0,1,4,3,1,1,1,0,2,8,1,1,0,3,0,0,,,0,0,0,,,
"Feb 21, 2023 12:00 AM",2,0,2,0,0,0,0,0,0,2,2,0,0,0,0,0,1,1,0,2,2,0,0,1,0,0,0,1,0,0,,,0,0,0,,,
"Feb 21, 2023 1:00 AM",6,1,5,0,0,0,3,1,2,0,0,0,0,0,0,0,1,1,0,0,0,0,1,2,0,0,0,0,0,0,,,0,0,0,,,
"Feb 21, 2023 2:00 AM",6,6,0,0,0,0,0,0,0,0,0,0,0,0,0,0,0,0,0,0,0,0,0,1,0,0,0,1,0,0,,,0,0,0,,,
"Feb 21, 2023 3:00 AM",1,0,1,0,0,0,2,1,1,0,0,0,0,0,0,0,0,0,0,0,0,0,0,1,2,1,1,0,0,0,,,0,0,0,,,
"Feb 21, 2023 4:00 AM",2,1,1,1,0,1,1,0,1,1,0,1,0,0,0,0,3,3,0,1,1,0,3,1,2,1,1,1,0,0,,,0,0,0,,,
"Feb 21, 2023 5:00 AM",9,7,2,2,1,1,2,0,2,1,1,0,0,0,0,2,2,2,0,2,1,1,3,3,0,0,0,7,1,0,,,1,1,0,,,
"Feb 21, 2023 6:00 AM",50,28,22,14,5,9,20,9,11,16,8,8,0,0,0,6,17,17,0,6,5,1,15,11,4,1,3,36,0,3,,,3,3,0,,,
"Feb 21, 2023 7:00 AM",185,137,48,49,10,39,69,14,55,48,12,36,0,0,0,18,105,103,2,24,19,5,88,34,32,4,28,135,4,6,,,9,9,0,,,
"Feb 21, 2023 8:00 AM",345,269,76,97,27,70,162,48,114,113,48,65,0,0,0,36,225,222,3,39,26,13,189,63,90,24,66,268,11,11,,,14,12,2,,,
"Feb 21, 2023 9:00 AM",162,131,31,57,16,41,93,40,53,75,41,34,0,0,0,49,103,101,2,22,17,5,67,19,55,27,28,89,1,5,,,2,1,1,,,
"Feb 21, 2023 10:00 AM",81,64,17,55,33,22,72,47,25,61,37,24,0,0,0,8,48,46,2,13,6,7,29,18,23,12,11,29,2,2,,,1,1,0,,,
"Feb 21, 2023 11:00 AM",55,40,15,53,30,23,67,30,37,41,21,20,0,0,0,5,34,32,2,16,12,4,25,15,20,12,8,26,1,4,,,7,4,3,,,
"Feb 21, 2023 12:00 PM",66,32,34,52,27,25,66,35,31,42,20,22,0,0,0,17,29,26,3,14,11,3,23,22,43,24,19,36,2,1,,,3,0,3,,,
"Feb 21, 2023 1:00 PM",89,41,48,66,31,35,85,46,39,56,29,27,0,0,0,15,31,28,3,20,18,2,20,35,56,27,29,31,3,2,,,5,4,1,,,
"Feb 21, 2023 2:00 PM",81,34,47,46,23,23,59,26,33,37,19,18,0,0,0,15,23,18,5,26,22,4,14,12,50,27,23,21,3,6,,,7,6,1,,,
"Feb 21, 2023 3:00 PM",100,33,67,58,29,29,82,44,38,52,31,21,0,0,0,15,29,18,11,38,32,6,14,32,45,24,21,28,3,5,,,9,5,4,,,
"Feb 21, 2023 4:00 PM",158,39,119,70,46,24,117,70,47,76,48,28,0,0,0,16,41,23,18,63,56,7,23,82,56,40,16,47,3,1,,,5,3,2,,,
"Feb 21, 2023 5:00 PM",284,61,223,80,54,26,120,73,47,98,60,38,0,0,0,28,48,35,13,132,127,5,35,136,85,46,39,52,14,5,,,18,10,8,,,
"Feb 21, 2023 6:00 PM",244,67,177,79,64,15,125,91,34,93,64,29,0,0,0,25,39,27,12,127,116,11,21,129,73,56,17,51,5,3,,,5,4,1,,,
"Feb 21, 2023 7:00 PM",136,38,98,33,21,12,58,38,20,43,27,16,0,0,0,21,28,23,5,59,55,4,21,54,31,19,12,21,7,1,,,9,7,2,,,
"Feb 21, 2023 8:00 PM",94,23,71,24,17,7,28,21,7,26,17,9,0,0,0,8,17,11,6,29,27,2,9,27,8,7,1,20,5,2,,,6,1,5,,,
"Feb 21, 2023 9:00 PM",58,12,46,7,5,2,25,13,12,18,9,9,0,0,0,6,9,6,3,11,10,1,4,18,5,3,2,17,2,1,,,2,0,2,,,
"Feb 21, 2023 10:00 PM",36,7,29,5,4,1,12,7,5,9,5,4,0,0,0,6,11,10,1,16,14,2,9,9,6,5,1,3,1,0,,,2,1,1,,,
"Feb 21, 2023 11:00 PM",9,1,8,1,1,0,6,3,3,3,2,1,0,0,0,1,1,1,0,5,5,0,1,4,0,0,0,7,1,0,,,2,1,1,,,
"Feb 22, 2023 12:00 AM",3,0,3,0,0,0,0,0,0,1,1,0,0,0,0,1,1,1,0,2,2,0,1,4,0,0,0,2,0,0,,,0,0,0,,,
"Feb 22, 2023 1:00 AM",3,0,3,0,0,0,0,0,0,0,0,0,0,0,0,0,0,0,0,0,0,0,0,0,0,0,0,1,0,0,,,1,0,1,,,
"Feb 22, 2023 2:00 AM",8,4,4,0,0,0,0,0,0,0,0,0,0,0,0,1,0,0,0,0,0,0,0,2,0,0,0,1,0,0,,,0,0,0,,,
"Feb 22, 2023 3:00 AM",0,0,0,1,0,1,1,0,1,1,0,1,0,0,0,0,0,0,0,0,0,0,1,0,0,0,0,0,0,0,,,0,0,0,,,
"Feb 22, 2023 4:00 AM",3,1,2,0,0,0,0,0,0,0,0,0,0,0,0,0,3,3,0,0,0,0,3,0,1,0,1,1,0,0,,,0,0,0,,,
"Feb 22, 2023 5:00 AM",9,6,3,1,0,1,2,1,1,1,1,0,0,0,0,0,6,6,0,2,2,0,6,2,0,0,0,5,0,0,,,0,0,0,,,
"Feb 22, 2023 6:00 AM",41,27,14,23,9,14,17,7,10,17,7,10,0,0,0,5,19,18,1,3,2,1,15,15,2,1,1,32,0,0,,,0,0,0,,,
"Feb 22, 2023 7:00 AM",136,101,35,49,13,36,68,15,53,53,17,36,0,0,0,18,89,88,1,25,22,3,87,32,29,12,17,106,5,5,,,7,5,2,,,
"Feb 22, 2023 8:00 AM",327,265,62,76,20,56,128,32,96,87,34,53,0,0,0,39,229,224,5,46,31,15,197,50,74,25,49,244,8,9,,,20,16,4,,,
"Feb 22, 2023 9:00 AM",150,120,30,60,18,42,78,42,36,52,29,23,0,0,0,14,108,107,1,13,11,2,73,16,48,19,29,86,4,5,,,6,5,1,,,
"Feb 22, 2023 10:00 AM",59,46,13,46,20,26,44,19,25,44,17,27,0,0,0,11,48,47,1,10,8,2,35,9,33,18,15,28,3,3,,,4,3,1,,,
"Feb 22, 2023 11:00 AM",62,36,26,28,13,15,31,20,11,25,13,12,0,0,0,13,40,33,7,11,8,3,20,16,16,7,9,21,2,1,,,3,3,0,,,
"Feb 22, 2023 12:00 PM",61,35,26,36,20,16,62,31,31,46,21,25,0,0,0,10,39,30,9,16,13,3,18,18,30,14,16,15,1,2,,,2,2,0,,,
"Feb 22, 2023 1:00 PM",83,33,50,51,22,29,56,24,32,43,20,23,0,0,0,5,13,12,1,19,16,3,11,38,32,16,16,25,5,3,,,5,3,2,,,
"Feb 22, 2023 2:00 PM",87,41,46,28,14,14,44,25,19,37,24,13,0,0,0,10,22,16,6,21,17,4,14,23,28,15,13,19,0,3,,,6,3,3,,,
"Feb 22, 2023 3:00 PM",76,29,47,28,20,8,43,25,18,30,18,12,0,0,0,12,24,21,3,29,24,5,12,31,30,15,15,23,5,1,,,6,3,3,,,
"Feb 22, 2023 4:00 PM",136,44,92,40,28,12,61,37,24,60,35,25,0,0,0,12,36,25,11,52,47,5,24,55,26,16,10,50,1,0,,,9,3,6,,,
"Feb 22, 2023 5:00 PM",275,60,215,53,36,17,100,62,38,70,38,32,0,0,0,24,51,29,22,110,106,4,26,110,63,35,28,57,4,4,,,5,3,2,,,
"Feb 22, 2023 6:00 PM",209,48,161,49,40,9,87,64,23,62,43,19,0,0,0,18,43,31,12,105,103,2,25,103,59,40,19,37,2,4,,,13,9,4,,,
"Feb 22, 2023 7:00 PM",122,31,91,29,22,7,34,29,5,30,27,3,0,0,0,5,23,15,8,44,42,2,9,49,23,20,3,18,4,1,,,6,2,4,,,
"Feb 22, 2023 8:00 PM",77,20,57,15,10,5,23,16,7,23,15,8,0,0,0,6,19,13,6,32,30,2,17,27,14,12,2,16,8,5,,,6,6,0,,,
"Feb 22, 2023 9:00 PM",52,12,40,6,5,1,12,6,6,5,4,1,0,0,0,6,7,6,1,17,17,0,6,17,8,4,4,12,4,0,,,2,2,0,,,
"Feb 22, 2023 10:00 PM",37,10,27,5,5,0,5,3,2,5,1,4,0,0,0,2,6,4,2,12,12,0,4,17,4,2,2,5,2,0,,,3,1,2,,,
"Feb 22, 2023 11:00 PM",10,3,7,1,1,0,8,4,4,2,1,1,0,0,0,1,1,1,0,9,9,0,1,6,1,1,0,2,1,0,,,1,1,0,,,
"Feb 23, 2023 12:00 AM",7,0,7,0,0,0,1,0,1,1,0,1,0,0,0,1,0,0,0,4,4,0,0,5,3,2,1,3,0,0,,,0,0,0,,,
"Feb 23, 2023 1:00 AM",3,0,3,0,0,0,1,1,0,0,0,0,0,0,0,2,5,5,0,1,1,0,1,0,1,1,0,0,0,0,,,0,0,0,,,
"Feb 23, 2023 2:00 AM",8,5,3,0,0,0,0,0,0,0,0,0,0,0,0,0,0,0,0,1,1,0,0,0,0,0,0,1,0,0,,,0,0,0,,,
"Feb 23, 2023 3:00 AM",0,0,0,1,0,1,1,0,1,1,0,1,0,0,0,0,0,0,0,0,0,0,0,0,0,0,0,1,0,0,,,0,0,0,,,
"Feb 23, 2023 4:00 AM",4,2,2,0,0,0,0,0,0,0,0,0,0,0,0,1,1,1,0,0,0,0,1,0,1,0,1,0,0,0,,,1,1,0,,,
"Feb 23, 2023 5:00 AM",5,5,0,0,0,0,3,1,2,1,1,0,0,0,0,0,6,6,0,3,2,1,6,3,1,1,0,5,1,0,,,1,1,0,,,
"Feb 23, 2023 6:00 AM",42,22,20,8,2,6,18,7,11,12,7,5,0,0,0,5,17,17,0,4,4,0,14,9,5,1,4,27,1,2,,,2,2,0,,,
"Feb 23, 2023 7:00 AM",130,100,30,49,11,38,52,12,40,42,12,30,0,0,0,19,76,73,3,22,13,9,74,36,29,9,20,109,4,1,,,8,6,2,,,
"Feb 23, 2023 8:00 AM",294,225,69,87,24,63,124,33,91,96,39,57,0,0,0,27,177,175,2,35,26,9,153,49,61,18,43,243,14,4,,,16,13,3,,,
"Feb 23, 2023 9:00 AM",155,129,26,44,18,26,73,31,42,59,33,26,0,0,0,18,104,104,0,15,12,3,80,24,45,12,33,92,0,7,,,9,5,4,,,
"Feb 23, 2023 10:00 AM",64,48,16,41,14,27,35,17,18,39,20,19,0,0,0,7,42,39,3,14,8,6,21,11,18,11,7,41,1,4,,,2,2,0,,,
"Feb 23, 2023 11:00 AM",54,28,26,45,29,16,55,26,29,33,18,15,0,0,0,4,41,34,7,13,9,4,23,20,24,14,10,20,3,2,,,3,2,1,,,
"Feb 23, 2023 12:00 PM",69,44,25,54,29,25,62,34,28,38,21,17,0,0,0,11,31,29,2,12,10,2,18,14,25,12,13,22,2,0,,,5,3,2,,,
"Feb 23, 2023 1:00 PM",76,28,48,52,28,24,77,48,29,51,29,22,0,0,0,7,29,27,2,14,12,2,22,26,39,24,15,19,4,3,,,4,2,2,,,
"Feb 23, 2023 2:00 PM",88,35,53,50,28,22,63,33,30,47,35,12,0,0,0,16,30,24,6,24,21,3,20,19,33,14,19,25,6,4,,,13,5,8,,,
"Feb 23, 2023 3:00 PM",93,37,56,40,24,16,44,20,24,34,15,19,0,0,0,21,20,14,6,27,27,0,11,34,30,11,19,22,2,2,,,5,4,1,,,
"Feb 23, 2023 4:00 PM",125,39,86,34,24,10,77,45,32,53,35,18,0,0,0,22,35,28,7,52,48,4,25,66,26,16,10,37,2,6,,,9,6,3,,,
"Feb 23, 2023 5:00 PM",234,50,184,49,36,13,86,54,32,69,42,27,0,0,0,23,42,33,9,112,109,3,24,114,58,29,29,72,9,3,,,10,5,5,,,
"Feb 23, 2023 6:00 PM",187,37,150,48,44,4,85,57,28,64,44,20,0,0,0,18,44,33,11,88,84,4,33,116,44,31,13,41,3,4,,,11,3,8,,,
"Feb 23, 2023 7:00 PM",125,39,86,19,12,7,37,25,12,26,16,10,0,0,0,8,23,22,1,51,49,2,18,52,29,21,8,16,7,3,,,13,8,5,,,
"Feb 23, 2023 8:00 PM",83,28,55,17,13,4,29,18,11,24,13,11,0,0,0,4,15,12,3,29,29,0,11,25,14,11,3,18,2,3,,,5,3,2,,,
"Feb 23, 2023 9:00 PM",46,8,38,12,9,3,20,12,8,13,8,5,0,0,0,4,13,11,2,30,28,2,12,17,5,4,1,7,2,1,,,2,1,1,,,
"Feb 23, 2023 10:00 PM",55,9,46,6,3,3,14,9,5,8,3,5,0,0,0,5,11,9,2,19,17,2,9,14,6,4,2,8,1,0,,,0,0,0,,,
"Feb 23, 2023 11:00 PM",18,1,17,5,4,1,14,9,5,9,5,4,0,0,0,1,3,2,1,5,5,0,2,10,3,2,1,4,1,0,,,1,0,1,,,
"Feb 24, 2023 12:00 AM",5,1,4,0,0,0,4,3,1,6,4,2,0,0,0,1,1,1,0,3,3,0,1,3,0,0,0,2,0,0,,,0,0,0,,,
"Feb 24, 2023 1:00 AM",4,1,3,2,2,0,2,2,0,1,1,0,0,0,0,1,1,1,0,3,3,0,1,3,1,1,0,1,1,0,,,0,0,0,,,
"Feb 24, 2023 2:00 AM",6,5,1,0,0,0,2,2,0,0,0,0,0,0,0,0,0,0,0,1,1,0,0,4,1,1,0,0,0,0,,,0,0,0,,,
"Feb 24, 2023 3:00 AM",2,0,2,2,1,1,2,1,1,3,1,2,0,0,0,0,0,0,0,0,0,0,0,3,1,0,1,0,0,0,,,3,1,2,,,
"Feb 24, 2023 4:00 AM",6,2,4,0,0,0,1,0,1,0,0,0,0,0,0,0,2,2,0,0,0,0,1,0,1,1,0,0,0,0,,,1,1,0,,,
"Feb 24, 2023 5:00 AM",5,3,2,1,1,0,4,1,3,3,1,2,0,0,0,3,4,4,0,3,3,0,4,1,0,0,0,6,0,0,,,0,0,0,,,
"Feb 24, 2023 6:00 AM",40,24,16,9,5,4,21,11,10,11,8,3,0,0,0,4,13,13,0,2,2,0,10,8,6,6,0,23,1,1,,,3,3,0,,,
"Feb 24, 2023 7:00 AM",90,61,29,53,18,35,48,13,35,34,13,21,0,0,0,12,59,58,1,18,13,5,55,23,21,4,17,69,1,1,,,5,5,0,,,
"Feb 24, 2023 8:00 AM",205,160,45,61,20,41,90,31,59,66,32,34,0,0,0,31,132,128,4,29,23,6,114,45,43,13,30,132,9,3,,,17,12,5,,,
"Feb 24, 2023 9:00 AM",108,86,22,57,20,37,70,34,36,57,31,26,0,0,0,16,65,64,1,13,8,5,50,12,26,11,15,65,0,2,,,3,2,1,,,
"Feb 24, 2023 10:00 AM",68,52,16,42,21,21,44,22,22,39,19,20,0,0,0,4,32,31,1,11,5,6,23,14,16,9,7,35,1,2,,,4,0,4,,,
"Feb 24, 2023 11:00 AM",59,39,20,51,24,27,54,28,26,43,25,18,0,0,0,4,37,34,3,12,8,4,27,12,21,10,11,26,4,0,,,3,2,1,,,
"Feb 24, 2023 12:00 PM",75,35,40,38,17,21,45,24,21,42,23,19,0,0,0,10,26,20,6,18,13,5,13,22,13,5,8,14,2,3,,,6,2,4,,,
"Feb 24, 2023 1:00 PM",88,40,48,38,21,17,51,26,25,43,22,21,0,0,0,17,20,15,5,27,26,1,13,34,34,19,15,22,4,4,,,5,5,0,,,
"Feb 24, 2023 2:00 PM",86,28,58,37,20,17,53,33,20,25,15,10,0,0,0,16,18,13,5,18,18,0,8,30,27,19,8,19,4,3,,,5,2,3,,,
"Feb 24, 2023 3:00 PM",91,39,52,21,10,11,54,23,31,31,17,14,0,0,0,22,22,16,6,20,19,1,12,44,24,10,14,35,2,2,,,8,4,4,,,
"Feb 24, 2023 4:00 PM",112,47,65,42,28,14,71,44,27,56,37,19,0,0,0,27,22,16,6,43,40,3,18,53,36,19,17,35,3,7,,,8,5,3,,,
"Feb 24, 2023 5:00 PM",156,47,109,55,38,17,70,44,26,66,43,23,0,0,0,27,27,20,7,68,67,1,16,65,48,30,18,53,4,7,,,5,4,1,,,
"Feb 24, 2023 6:00 PM",118,37,81,47,30,17,63,37,26,60,36,24,0,0,0,25,37,28,9,60,58,2,22,42,36,23,13,24,3,1,,,13,9,4,,,
"Feb 24, 2023 7:00 PM",93,32,61,19,11,8,37,26,11,28,19,9,0,0,0,12,18,16,2,34,32,2,12,22,18,14,4,20,5,1,,,8,3,5,,,
"Feb 24, 2023 8:00 PM",68,21,47,10,7,3,14,8,6,10,5,5,0,0,0,4,13,9,4,11,10,1,10,13,5,2,3,19,4,3,,,5,3,2,,,
"Feb 24, 2023 9:00 PM",36,10,26,9,5,4,15,12,3,12,9,3,0,0,0,5,7,5,2,16,15,1,2,13,5,4,1,8,2,0,,,1,0,1,,,
"Feb 24, 2023 10:00 PM",21,4,17,3,3,0,10,3,7,10,1,9,0,0,0,2,7,7,0,8,7,1,7,9,7,3,4,6,1,0,,,7,4,3,,,
"Feb 24, 2023 11:00 PM",19,7,12,12,11,1,17,8,9,10,6,4,0,0,0,2,2,2,0,6,6,0,2,10,2,1,1,8,1,1,,,3,2,1,,,
"Feb 25, 2023 12:00 AM",14,4,10,0,0,0,1,1,0,2,1,1,0,0,0,1,2,2,0,7,7,0,2,6,2,2,0,5,1,0,,,0,0,0,,,
"Feb 25, 2023 1:00 AM",8,0,8,2,2,0,5,3,2,1,0,1,0,0,0,0,3,2,1,7,6,1,3,6,3,1,2,3,1,2,,,0,0,0,,,
"Feb 25, 2023 2:00 AM",8,4,4,0,0,0,1,1,0,0,0,0,0,0,0,0,0,0,0,1,1,0,0,2,0,0,0,1,0,0,,,0,0,0,,,
"Feb 25, 2023 3:00 AM",6,1,5,0,0,0,0,0,0,0,0,0,0,0,0,1,0,0,0,3,3,0,0,1,0,0,0,0,0,0,,,0,0,0,,,
"Feb 25, 2023 4:00 AM",4,2,2,0,0,0,1,1,0,0,0,0,0,0,0,0,0,0,0,3,3,0,0,0,1,1,0,0,1,0,,,0,0,0,,,
"Feb 25, 2023 5:00 AM",8,4,4,1,1,0,1,0,1,2,1,1,0,0,0,2,1,1,0,0,0,0,1,4,0,0,0,1,0,0,,,0,0,0,,,
"Feb 25, 2023 6:00 AM",11,6,5,2,1,1,4,2,2,2,1,1,0,0,0,2,4,4,0,3,2,1,4,4,0,0,0,5,0,1,,,1,0,1,,,
"Feb 25, 2023 7:00 AM",24,9,15,18,11,7,20,12,8,22,16,6,0,0,0,5,9,9,0,4,3,1,10,18,5,4,1,11,0,2,,,1,1,0,,,
"Feb 25, 2023 8:00 AM",46,25,21,54,31,23,47,29,18,44,26,18,0,0,0,10,14,14,0,10,8,2,14,11,22,13,9,27,3,4,,,3,2,1,,,
"Feb 25, 2023 9:00 AM",37,22,15,75,40,35,90,56,34,82,58,24,0,0,0,17,22,21,1,8,7,1,20,26,32,19,13,39,5,10,,,7,5,2,,,
"Feb 25, 2023 10:00 AM",74,45,29,76,31,45,62,35,27,69,40,29,0,0,0,12,22,21,1,9,7,2,22,34,46,27,19,29,3,10,,,9,7,2,,,
"Feb 25, 2023 11:00 AM",54,28,26,89,40,49,95,49,46,87,47,40,0,0,0,17,21,20,1,14,13,1,20,23,55,32,23,30,8,8,,,6,5,1,,,
"Feb 25, 2023 12:00 PM",73,39,34,97,46,51,111,49,62,89,43,46,0,0,0,22,31,25,6,20,17,3,23,34,59,38,21,43,11,10,,,8,6,2,,,
"Feb 25, 2023 1:00 PM",82,44,38,81,36,45,102,51,51,87,49,38,0,0,0,30,21,19,2,13,13,0,17,26,36,21,15,33,11,8,,,5,2,3,,,
"Feb 25, 2023 2:00 PM",56,24,32,42,21,21,61,22,39,39,20,19,0,0,0,16,16,15,1,15,15,0,9,19,27,11,16,25,9,3,,,11,8,3,,,
"Feb 25, 2023 3:00 PM",37,18,19,29,18,11,22,14,8,33,17,16,0,0,0,13,11,11,0,5,2,3,5,11,32,15,17,23,1,1,,,0,0,0,,,
"Feb 25, 2023 4:00 PM",56,29,27,38,24,14,42,22,20,37,21,16,0,0,0,22,14,12,2,9,7,2,14,17,23,9,14,28,4,3,,,6,4,2,,,
"Feb 25, 2023 5:00 PM",44,17,27,46,24,22,46,16,30,45,21,24,0,0,0,19,16,15,1,15,15,0,17,21,20,10,10,21,3,0,,,4,4,0,,,
"Feb 25, 2023 6:00 PM",41,19,22,22,13,9,27,11,16,27,12,15,0,0,0,5,12,11,1,8,7,1,9,14,14,7,7,16,2,3,,,2,1,1,,,
"Feb 25, 2023 7:00 PM",39,17,22,13,5,8,22,10,12,17,9,8,0,0,0,4,9,9,0,5,4,1,10,7,5,3,2,11,0,3,,,3,1,2,,,
"Feb 25, 2023 8:00 PM",37,20,17,3,3,0,11,6,5,8,6,2,0,0,0,2,6,6,0,5,3,2,3,9,3,1,2,9,1,1,,,1,1,0,,,
"Feb 25, 2023 9:00 PM",19,7,12,5,2,3,10,6,4,7,4,3,0,0,0,0,7,4,3,7,5,2,5,4,5,5,0,10,0,0,,,2,1,1,,,
"Feb 25, 2023 10:00 PM",12,4,8,8,7,1,6,5,1,2,1,1,0,0,0,4,6,6,0,1,1,0,3,2,0,0,0,6,0,0,,,0,0,0,,,
"Feb 25, 2023 11:00 PM",12,2,10,4,4,0,9,8,1,7,6,1,0,0,0,4,3,3,0,6,5,1,4,4,3,2,1,3,1,0,,,1,1,0,,,
"Feb 26, 2023 12:00 AM",5,2,3,0,0,0,2,0,2,3,1,2,0,0,0,1,2,1,1,2,2,0,3,4,4,4,0,3,0,0,,,0,0,0,,,
"Feb 26, 2023 1:00 AM",10,2,8,1,1,0,3,1,2,1,0,1,0,0,0,1,0,0,0,3,3,0,0,2,2,0,2,1,0,0,,,0,0,0,,,
"Feb 26, 2023 2:00 AM",2,0,2,3,3,0,0,0,0,2,2,0,0,0,0,0,0,0,0,0,0,0,1,1,1,1,0,3,0,0,,,0,0,0,,,
"Feb 26, 2023 3:00 AM",2,1,1,0,0,0,0,0,0,0,0,0,0,0,0,0,1,0,1,0,0,0,1,1,0,0,0,0,0,0,,,0,0,0,,,
"Feb 26, 2023 4:00 AM",3,1,2,0,0,0,0,0,0,0,0,0,0,0,0,0,0,0,0,2,2,0,0,0,0,0,0,0,0,0,,,0,0,0,,,
"Feb 26, 2023 5:00 AM",4,1,3,1,1,0,1,1,0,1,1,0,0,0,0,0,1,1,0,0,0,0,1,2,3,2,1,2,0,0,,,0,0,0,,,
"Feb 26, 2023 6:00 AM",10,7,3,7,3,4,9,4,5,6,3,3,0,0,0,1,3,3,0,2,2,0,4,5,2,1,1,4,0,0,,,0,0,0,,,
"Feb 26, 2023 7:00 AM",15,9,6,22,12,10,21,14,7,24,15,9,0,0,0,4,10,10,0,5,3,2,8,14,2,0,2,10,0,2,,,1,1,0,,,
"Feb 26, 2023 8:00 AM",34,18,16,71,47,24,63,48,15,63,53,10,0,0,0,6,16,15,1,13,9,4,10,23,20,10,10,21,1,3,,,2,2,0,,,
"Feb 26, 2023 9:00 AM",34,15,19,57,34,23,74,53,21,78,60,18,0,0,0,9,13,13,0,13,12,1,11,28,29,20,9,43,2,16,,,2,2,0,,,
"Feb 26, 2023 10:00 AM",61,36,25,91,56,35,106,59,47,92,58,34,0,0,0,10,24,17,7,18,16,2,17,38,31,16,15,35,6,16,,,12,5,7,,,
"Feb 26, 2023 11:00 AM",61,38,23,135,69,66,109,58,51,112,57,55,0,0,0,4,20,19,1,6,5,1,13,22,39,25,14,36,9,9,,,7,6,1,,,
"Feb 26, 2023 12:00 PM",58,28,30,123,53,70,105,55,50,103,59,44,0,0,0,18,28,26,2,16,13,3,20,21,50,30,20,31,10,2,,,6,4,2,,,
"Feb 26, 2023 1:00 PM",71,38,33,119,60,59,110,58,52,109,51,58,0,0,0,22,23,23,0,17,15,2,14,41,48,23,25,36,8,3,,,8,7,1,,,
"Feb 26, 2023 2:00 PM",52,24,28,96,50,46,112,53,59,96,48,48,0,0,0,10,20,17,3,15,11,4,17,18,42,19,23,29,5,6,,,4,4,0,,,
"Feb 26, 2023 3:00 PM",52,30,22,64,30,34,99,49,50,60,26,34,0,0,0,23,14,13,1,16,14,2,14,15,33,18,15,19,4,7,,,9,5,4,,,
"Feb 26, 2023 4:00 PM",40,16,24,61,27,34,69,21,48,46,17,29,0,0,0,9,16,13,3,20,18,2,15,10,38,13,25,32,8,2,,,10,8,2,,,
"Feb 26, 2023 5:00 PM",42,14,28,59,29,30,64,21,43,47,20,27,0,0,0,20,12,10,2,10,10,0,8,16,32,17,15,19,4,4,,,4,3,1,,,
"Feb 26, 2023 6:00 PM",42,12,30,15,8,7,27,13,14,21,9,12,0,0,0,14,16,14,2,15,11,4,11,14,13,5,8,15,1,0,,,0,0,0,,,
"Feb 26, 2023 7:00 PM",35,17,18,11,7,4,8,3,5,7,4,3,0,0,0,9,5,5,0,9,7,2,5,7,2,1,1,12,1,1,,,5,2,3,,,
"Feb 26, 2023 8:00 PM",21,4,17,4,2,2,6,1,5,3,1,2,0,0,0,4,9,8,1,2,2,0,9,12,3,2,1,10,0,0,,,3,1,2,,,
"Feb 26, 2023 9:00 PM",13,7,6,1,0,1,6,3,3,2,1,1,0,0,0,3,6,6,0,2,2,0,4,3,2,1,1,3,0,1,,,0,0,0,,,
"Feb 26, 2023 10:00 PM",11,1,10,2,2,0,3,3,0,4,2,2,0,0,0,1,7,6,1,5,5,0,7,7,2,2,0,5,1,0,,,0,0,0,,,
"Feb 26, 2023 11:00 PM",10,1,9,2,2,0,6,2,4,3,1,2,0,0,0,3,2,2,0,1,1,0,2,4,0,0,0,3,0,1,,,2,2,0,,,
"Feb 27, 2023 12:00 AM",8,4,4,0,0,0,1,1,0,0,0,0,0,0,0,0,3,3,0,0,0,0,2,0,0,0,0,1,0,0,,,0,0,0,,,
"Feb 27, 2023 1:00 AM",4,3,1,0,0,0,0,0,0,0,0,0,0,0,0,0,1,1,0,1,1,0,1,1,0,0,0,3,0,1,,,0,0,0,,,
"Feb 27, 2023 2:00 AM",0,0,0,0,0,0,0,0,0,0,0,0,0,0,0,1,2,0,2,0,0,0,0,0,0,0,0,2,0,0,,,0,0,0,,,
"Feb 27, 2023 3:00 AM",0,0,0,0,0,0,0,0,0,0,0,0,0,0,0,0,0,0,0,1,1,0,0,0,0,0,0,0,1,0,,,0,0,0,,,
"Feb 27, 2023 4:00 AM",1,0,1,0,0,0,0,0,0,0,0,0,0,0,0,0,2,2,0,1,1,0,2,0,0,0,0,0,0,0,,,0,0,0,,,
"Feb 27, 2023 5:00 AM",9,7,2,0,0,0,1,0,1,0,0,0,0,0,0,0,9,9,0,1,0,1,7,0,0,0,0,6,1,0,,,0,0,0,,,
"Feb 27, 2023 6:00 AM",48,30,18,17,5,12,18,4,14,11,3,8,0,0,0,7,18,18,0,5,4,1,16,10,8,2,6,33,2,2,,,2,2,0,,,
"Feb 27, 2023 7:00 AM",133,95,38,50,12,38,60,15,45,49,12,37,0,0,0,11,83,83,0,16,12,4,78,23,25,5,20,95,4,6,,,5,4,1,,,
"Feb 27, 2023 8:00 AM",296,234,62,61,10,51,115,34,81,79,27,52,0,0,0,52,157,152,5,38,24,14,140,50,55,13,42,212,8,4,,,16,14,2,,,
"Feb 27, 2023 9:00 AM",132,102,30,36,12,24,75,26,49,50,22,28,0,0,0,13,103,101,2,19,13,6,63,29,32,12,20,74,1,0,,,5,4,1,,,
"Feb 27, 2023 10:00 AM",62,48,14,29,16,13,44,27,17,33,24,9,0,0,0,7,34,32,2,9,3,6,19,10,17,13,4,30,1,0,,,3,2,1,,,
"Feb 27, 2023 11:00 AM",49,40,9,23,11,12,31,16,15,19,10,9,0,0,0,7,16,16,0,5,3,2,14,8,13,7,6,26,3,2,,,4,3,1,,,
"Feb 27, 2023 12:00 PM",54,28,26,31,16,15,35,16,19,25,9,16,0,0,0,4,32,30,2,16,13,3,15,13,14,5,9,16,1,6,,,4,2,2,,,
"Feb 27, 2023 1:00 PM",74,34,40,29,8,21,46,20,26,39,13,26,0,0,0,10,20,18,2,14,13,1,14,16,21,12,9,21,2,0,,,2,1,1,,,
"Feb 27, 2023 2:00 PM",55,24,31,20,9,11,28,15,13,15,5,10,0,0,0,6,26,17,9,25,20,5,10,18,14,9,5,16,3,3,,,7,4,3,,,
"Feb 27, 2023 3:00 PM",98,30,68,20,10,10,29,20,9,20,14,6,0,0,0,24,16,12,4,23,20,3,7,29,15,10,5,20,5,2,,,3,1,2,,,
"Feb 27, 2023 4:00 PM",109,28,81,29,24,5,49,36,13,38,25,13,0,0,0,25,40,31,9,47,40,7,23,56,39,30,9,38,3,2,,,5,4,1,,,
"Feb 27, 2023 5:00 PM",212,57,155,63,47,16,109,72,37,72,48,24,0,0,0,21,32,18,14,102,98,4,19,104,60,41,19,42,7,7,,,8,5,3,,,
"Feb 27, 2023 6:00 PM",166,38,128,50,40,10,88,66,22,62,41,21,0,0,0,21,35,25,10,105,100,5,23,121,47,29,18,36,4,5,,,8,4,4,,,
"Feb 27, 2023 7:00 PM",125,22,103,16,9,7,36,26,10,23,15,8,0,0,0,13,22,18,4,45,43,2,16,40,24,20,4,23,7,3,,,8,6,2,,,
"Feb 27, 2023 8:00 PM",61,22,39,15,10,5,20,14,6,14,8,6,0,0,0,10,12,6,6,24,23,1,5,20,9,7,2,13,4,3,,,9,8,1,,,
"Feb 27, 2023 9:00 PM",45,14,31,9,7,2,15,9,6,11,7,4,0,0,0,9,10,9,1,13,13,0,9,15,7,6,1,10,2,1,,,1,0,1,,,
"Feb 27, 2023 10:00 PM",29,4,25,9,8,1,7,7,0,5,4,1,0,0,0,1,5,1,4,6,6,0,1,11,3,2,1,3,2,1,,,3,3,0,,,
"Feb 27, 2023 11:00 PM",13,3,10,1,1,0,5,4,1,5,2,3,0,0,0,3,3,3,0,9,8,1,2,6,1,1,0,3,1,0,,,1,1,0,,,
"Feb 28, 2023 12:00 AM",4,2,2,0,0,0,0,0,0,0,0,0,0,0,0,1,1,1,0,1,1,0,1,0,0,0,0,1,1,0,,,1,0,1,,,
"Feb 28, 2023 1:00 AM",1,1,0,0,0,0,3,2,1,0,0,0,0,0,0,0,0,0,0,0,0,0,0,4,0,0,0,0,0,0,,,0,0,0,,,
"Feb 28, 2023 2:00 AM",5,3,2,0,0,0,0,0,0,0,0,0,0,0,0,0,0,0,0,0,0,0,0,1,1,0,1,0,0,0,,,1,1,0,,,
"Feb 28, 2023 3:00 AM",0,0,0,0,0,0,0,0,0,0,0,0,0,0,0,0,0,0,0,0,0,0,0,1,0,0,0,0,0,0,,,0,0,0,,,
"Feb 28, 2023 4:00 AM",3,1,2,0,0,0,0,0,0,0,0,0,0,0,0,0,4,4,0,0,0,0,4,0,0,0,0,1,0,0,,,0,0,0,,,
"Feb 28, 2023 5:00 AM",5,3,2,0,0,0,2,1,1,1,1,0,0,0,0,0,3,3,0,3,2,1,3,3,0,0,0,2,0,1,,,0,0,0,,,
"Feb 28, 2023 6:00 AM",42,29,13,13,4,9,23,7,16,17,6,11,0,0,0,6,22,22,0,6,4,2,22,14,5,2,3,38,0,3,,,0,0,0,,,
"Feb 28, 2023 7:00 AM",149,113,36,41,9,32,56,10,46,48,9,39,0,0,0,19,90,88,2,19,16,3,87,41,25,8,17,134,4,5,,,6,5,1,,,
"Feb 28, 2023 8:00 AM",290,226,64,73,14,59,156,43,113,106,35,71,0,0,0,32,225,220,5,40,27,13,200,57,69,22,47,230,3,11,,,12,11,1,,,
"Feb 28, 2023 9:00 AM",149,122,27,56,18,38,73,34,39,60,36,24,0,0,0,15,95,93,2,21,15,6,63,20,42,16,26,84,3,3,,,3,1,2,,,
"Feb 28, 2023 10:00 AM",73,57,16,40,15,25,48,22,26,39,18,21,0,0,0,6,42,40,2,10,3,7,22,16,19,9,10,33,3,2,,,5,4,1,,,
"Feb 28, 2023 11:00 AM",44,32,12,33,15,18,38,18,20,31,13,18,0,0,0,8,35,32,3,12,9,3,17,10,21,10,11,27,0,5,,,1,0,1,,,
"Feb 28, 2023 12:00 PM",69,40,29,31,19,12,29,14,15,27,12,15,0,0,0,12,33,28,5,19,15,4,23,11,13,5,8,19,1,2,,,4,3,1,,,
"Feb 28, 2023 1:00 PM",80,36,44,27,16,11,42,27,15,29,19,10,0,0,0,9,36,32,4,16,13,3,27,25,18,8,10,16,4,2,,,11,10,1,,,
"Feb 28, 2023 2:00 PM",76,34,42,33,19,14,33,21,12,21,16,5,0,0,0,14,25,17,8,21,18,3,14,17,16,8,8,28,3,6,,,9,1,8,,,
"Feb 28, 2023 3:00 PM",95,38,57,32,16,16,47,28,19,41,27,14,0,0,0,39,19,15,4,28,26,2,11,37,28,20,8,20,2,2,,,6,3,3,,,
"Feb 28, 2023 4:00 PM",137,35,102,35,27,8,67,39,28,49,31,18,0,0,0,20,34,20,14,46,43,3,20,72,32,22,10,38,8,4,,,8,5,3,,,
"Feb 28, 2023 5:00 PM",221,56,165,45,33,12,92,54,38,69,39,30,0,0,0,27,46,31,15,100,98,2,29,119,61,44,17,49,11,4,,,11,6,5,,,
"Feb 28, 2023 6:00 PM",226,59,167,47,41,6,105,77,28,63,43,20,0,,0,17,36,29,7,93,88,5,28,125,70,54,16,46,8,2,,,7,4,3,,,
"Feb 28, 2023 7:00 PM",137,33,104,29,25,4,45,33,12,39,29,10,0,,0,11,28,18,10,45,39,6,18,52,30,21,9,19,0,2,,,12,7,5,,,
"Feb 28, 2023 8:00 PM",120,37,83,9,6,3,30,23,7,23,18,5,0,,0,6,10,8,2,29,28,1,6,27,12,9,3,11,6,3,,,5,3,2,,,
"Feb 28, 2023 9:00 PM",37,7,30,13,8,5,25,11,14,14,8,6,0,0,0,4,14,9,5,17,15,2,7,11,11,4,7,11,2,0,,,2,1,1,,,
"Feb 28, 2023 10:00 PM",42,8,34,6,6,0,14,12,2,9,7,2,0,0,0,0,6,4,2,13,11,2,3,14,8,6,2,6,4,0,,,1,1,0,,,
"Feb 28, 2023 11:00 PM",12,2,10,2,2,0,2,0,2,1,0,1,0,,0,0,0,0,0,3,3,0,0,2,1,0,1,2,1,1,,,1,1,0,,,
"Mar 1, 2023 12:00 AM",4,0,4,0,0,0,1,1,0,2,2,0,0,,0,0,6,4,2,4,4,0,3,0,1,1,0,1,0,0,,,1,1,0,,,
"Mar 1, 2023 1:00 AM",2,1,1,0,0,0,3,1,2,1,1,0,0,,0,0,0,0,0,0,0,0,0,0,2,2,0,0,0,0,,,0,0,0,,,
"Mar 1, 2023 2:00 AM",5,4,1,1,1,0,1,1,0,0,0,0,0,,0,0,0,0,0,1,1,0,0,2,1,1,0,1,0,1,,,0,0,0,,,
"Mar 1, 2023 3:00 AM",0,0,0,1,1,0,0,0,0,0,0,0,0,,0,0,0,0,0,1,1,0,0,0,0,0,0,0,0,0,,,0,0,0,,,
"Mar 1, 2023 4:00 AM",3,1,2,0,0,0,0,0,0,0,0,0,0,0,0,0,3,3,0,0,0,0,3,0,0,0,0,2,0,0,,,0,0,0,,,
"Mar 1, 2023 5:00 AM",11,6,5,1,0,1,2,1,1,2,1,1,0,0,0,2,4,4,0,2,2,0,5,4,1,0,1,6,0,0,,,0,0,0,,,
"Mar 1, 2023 6:00 AM",42,27,15,14,6,8,19,6,13,11,4,7,0,0,0,4,21,21,0,8,7,1,20,15,3,1,2,36,0,1,,,1,1,0,,,
"Mar 1, 2023 7:00 AM",139,108,31,51,9,42,73,20,53,51,16,35,0,0,0,11,97,95,2,22,18,4,91,41,26,10,16,126,4,4,,,5,4,1,,,
"Mar 1, 2023 8:00 AM",312,245,67,63,16,47,124,38,86,92,37,55,0,0,0,31,188,183,5,43,30,13,166,57,69,21,48,217,2,10,,,12,9,3,,,
"Mar 1, 2023 9:00 AM",121,100,21,41,7,34,68,27,41,56,26,30,0,0,0,18,77,77,0,26,18,8,60,21,36,14,22,70,4,4,,,5,4,1,,,
"Mar 1, 2023 10:00 AM",69,52,17,26,8,18,38,14,24,27,11,16,0,0,0,9,37,36,1,11,9,2,24,7,7,5,2,20,3,3,,,3,3,0,,,
"Mar 1, 2023 11:00 AM",44,34,10,30,7,23,26,15,11,19,11,8,0,0,0,2,28,24,4,11,5,6,15,13,7,4,3,24,1,0,,,1,1,0,,,
"Mar 1, 2023 12:00 PM",58,35,23,36,19,17,46,21,25,45,22,23,0,0,0,8,31,27,4,11,10,1,20,25,16,6,10,25,2,1,,,5,2,3,,,
"Mar 1, 2023 1:00 PM",81,32,49,53,26,27,46,27,19,49,25,24,0,0,0,10,20,18,2,26,21,5,12,26,25,17,8,43,2,2,,,1,1,0,,,
"Mar 1, 2023 2:00 PM",68,35,33,30,14,16,35,17,18,28,13,15,0,0,0,25,21,16,5,27,25,2,13,21,18,9,9,25,3,1,,,7,2,5,,,
"Mar 1, 2023 3:00 PM",89,34,55,20,12,8,49,30,19,27,17,10,0,0,0,18,28,20,8,26,24,2,14,31,27,21,6,21,3,1,,,6,1,5,,,
"Mar 1, 2023 4:00 PM",138,40,98,44,30,14,72,41,31,46,27,19,0,0,0,15,24,19,5,40,34,6,11,57,36,24,12,39,5,1,,,7,4,3,,,
"Mar 1, 2023 5:00 PM",240,51,189,64,50,14,99,63,36,73,47,26,0,0,0,27,43,33,10,93,92,1,37,139,78,48,30,63,7,3,,,10,8,2,,,
"Mar 1, 2023 6:00 PM",202,52,150,53,40,13,97,67,30,72,46,26,0,0,0,20,27,27,0,114,112,2,25,101,53,36,17,44,6,1,,,10,8,2,,,
"Mar 1, 2023 7:00 PM",129,31,98,25,13,12,43,36,7,29,23,6,0,,0,9,32,16,16,52,50,2,11,60,30,25,5,20,3,5,,,5,2,3,,,
"Mar 1, 2023 8:00 PM",85,25,60,15,12,3,30,21,9,27,17,10,0,,0,8,18,14,4,22,21,1,13,36,11,7,4,19,6,3,,,7,2,5,,,
"Mar 1, 2023 9:00 PM",54,9,45,6,5,1,13,9,4,4,3,1,0,0,0,7,10,8,2,20,18,2,7,21,5,3,2,11,3,0,,,2,2,0,,,
"Mar 1, 2023 10:00 PM",40,11,29,2,2,0,4,4,0,3,3,0,0,0,0,4,7,6,1,15,15,0,8,14,2,1,1,7,1,0,,,1,1,0,,,
"Mar 1, 2023 11:00 PM",10,1,9,3,1,2,4,3,1,2,1,1,0,0,0,2,3,2,1,2,2,0,3,5,1,1,0,6,1,0,,,3,1,2,,,
"Mar 2, 2023 12:00 AM",2,0,2,0,0,0,1,0,1,3,1,2,0,0,0,0,0,0,0,2,2,0,0,5,1,0,1,2,0,0,,,3,1,2,,,
"Mar 2, 2023 1:00 AM",5,1,4,0,0,0,2,1,1,0,0,0,0,0,0,0,0,0,0,0,0,0,0,1,1,0,1,0,0,1,,,0,0,0,,,
"Mar 2, 2023 2:00 AM",4,3,1,0,0,0,2,1,1,0,0,0,0,,0,0,0,0,0,0,0,0,0,0,2,1,1,2,0,0,,,0,0,0,,,
"Mar 2, 2023 3:00 AM",2,2,0,0,0,0,3,0,3,0,0,0,0,,0,0,0,0,0,0,0,0,0,1,0,0,0,0,0,0,,,0,0,0,,,
"Mar 2, 2023 4:00 AM",4,2,2,0,0,0,1,0,1,1,1,0,,,,0,4,4,0,0,0,0,4,0,0,0,0,1,0,0,,,1,1,0,,,
"Mar 2, 2023 5:00 AM",13,9,4,0,0,0,3,1,2,2,1,1,,,,3,3,3,0,2,1,1,5,2,0,0,0,5,1,0,,,0,0,0,,,
"Mar 2, 2023 6:00 AM",42,29,13,23,10,13,23,11,12,21,14,7,,,,4,15,15,0,5,4,1,12,13,7,1,6,28,0,2,,,1,1,0,,,
"Mar 2, 2023 7:00 AM",126,94,32,37,10,27,60,13,47,35,8,27,,,,17,75,73,2,24,19,5,64,40,35,11,24,103,2,3,,,4,4,0,,,
"Mar 2, 2023 8:00 AM",291,232,59,62,13,49,108,28,80,73,22,51,0,,0,20,199,194,5,40,25,15,167,35,62,17,45,198,5,4,,,17,14,3,,,
"Mar 2, 2023 9:00 AM",129,105,24,51,16,35,87,38,49,49,26,23,0,0,0,13,93,93,0,21,12,9,74,19,40,16,24,79,0,8,,,2,1,1,,,
"Mar 2, 2023 10:00 AM",64,47,17,26,9,17,34,14,20,30,13,17,0,0,0,11,44,42,2,6,5,1,27,10,18,8,10,24,1,3,,,6,5,1,,,
"Mar 2, 2023 11:00 AM",43,30,13,37,19,18,39,22,17,32,20,12,0,,0,6,29,25,4,11,8,3,19,7,21,11,10,20,2,2,,,5,2,3,,,
"Mar 2, 2023 12:00 PM",47,29,18,25,14,11,41,18,23,27,15,12,0,,0,15,28,25,3,13,10,3,17,15,17,11,6,13,2,1,,,4,2,2,,,
"Mar 2, 2023 1:00 PM",66,24,42,40,27,13,47,25,22,46,28,18,0,0,0,5,20,18,2,21,18,3,12,15,17,10,7,16,3,2,,,9,6,3,,,
"Mar 2, 2023 2:00 PM",73,28,45,35,15,20,34,19,15,31,17,14,0,0,0,16,26,19,7,12,10,2,17,21,22,15,7,18,3,2,,,10,7,3,,,
"Mar 2, 2023 3:00 PM",68,25,43,22,13,9,34,17,17,26,17,9,0,0,0,10,23,15,8,36,30,6,10,34,25,13,12,25,1,2,,,4,1,3,,,
"Mar 2, 2023 4:00 PM",126,37,89,39,31,8,59,36,23,47,28,19,0,0,0,19,26,15,11,58,56,2,19,53,43,29,14,32,1,3,,,6,3,3,,,
"Mar 2, 2023 5:00 PM",202,57,145,56,36,20,93,59,34,64,32,32,0,0,0,32,39,24,15,104,97,7,24,111,64,44,20,53,6,0,,,11,9,2,,,
"Mar 2, 2023 6:00 PM",187,33,154,41,33,8,89,62,27,59,42,17,0,0,0,21,44,36,8,105,102,3,32,117,59,41,18,33,4,4,,,4,4,0,,,
"Mar 2, 2023 7:00 PM",107,23,84,23,16,7,47,32,15,25,14,11,0,0,0,12,18,13,5,38,36,2,12,48,28,18,10,21,3,1,,,9,9,0,,,
"Mar 2, 2023 8:00 PM",87,28,59,20,13,7,26,19,7,20,13,7,0,0,0,10,14,14,0,35,32,3,11,32,13,9,4,16,3,1,,,7,3,4,,,
"Mar 2, 2023 9:00 PM",60,15,45,11,9,2,10,6,4,11,8,3,0,0,0,4,11,7,4,21,20,1,9,16,13,9,4,7,3,2,,,0,0,0,,,
"Mar 2, 2023 10:00 PM",25,5,20,3,2,1,10,5,5,4,2,2,0,0,0,8,6,3,3,19,19,0,2,13,2,2,0,5,2,0,,,1,0,1,,,
"Mar 2, 2023 11:00 PM",19,2,17,5,5,0,4,3,1,4,4,0,0,0,0,2,5,3,2,6,6,0,3,6,1,1,0,2,1,0,,,1,1,0,,,
"Mar 3, 2023 12:00 AM",6,1,5,1,1,0,3,2,1,2,1,1,0,0,0,1,1,1,0,3,3,0,1,9,1,0,1,3,0,0,,,0,0,0,,,
"Mar 3, 2023 1:00 AM",6,2,4,0,0,0,0,0,0,0,0,0,0,0,0,0,1,0,1,3,3,0,0,0,1,0,1,1,0,0,,,0,0,0,,,
"Mar 3, 2023 2:00 AM",7,5,2,0,0,0,1,1,0,1,1,0,0,0,0,0,1,0,1,2,2,0,0,3,1,1,0,0,0,0,,,0,0,0,,,
"Mar 3, 2023 3:00 AM",1,0,1,0,0,0,4,3,1,0,0,0,0,0,0,1,0,0,0,2,2,0,0,1,0,0,0,0,0,0,,,0,0,0,,,
"Mar 3, 2023 4:00 AM",5,3,2,1,1,0,0,0,0,0,0,0,0,0,0,0,3,3,0,1,1,0,3,0,0,0,0,1,0,0,,,2,2,0,,,
"Mar 3, 2023 5:00 AM",13,11,2,1,0,1,2,0,2,1,1,0,0,0,0,2,3,3,0,3,1,2,6,5,0,0,0,8,0,0,,,0,0,0,,,
"Mar 3, 2023 6:00 AM",39,25,14,9,4,5,19,9,10,11,6,5,0,0,0,3,16,16,0,4,3,1,15,11,4,2,2,31,2,1,,,2,2,0,,,
"Mar 3, 2023 7:00 AM",97,71,26,40,11,29,43,14,29,33,10,23,0,0,0,19,44,44,0,15,10,5,41,30,8,1,7,65,4,3,,,5,3,2,,,
"Mar 3, 2023 8:00 AM",193,145,48,58,20,38,95,32,63,66,33,33,0,0,0,27,129,128,1,23,21,2,111,38,49,16,33,119,8,2,,,19,17,2,,,
"Mar 3, 2023 9:00 AM",114,89,25,54,26,28,66,30,36,55,32,23,0,0,0,17,53,51,2,16,13,3,44,27,35,20,15,57,1,3,,,3,3,0,,,
"Mar 3, 2023 10:00 AM",65,41,24,36,21,15,52,28,24,30,15,15,0,0,0,13,33,29,4,12,7,5,23,16,19,9,10,24,1,3,,,5,3,2,,,
"Mar 3, 2023 11:00 AM",60,38,22,15,9,6,18,8,10,11,6,5,0,0,0,8,27,25,2,14,13,1,15,6,14,5,9,17,6,1,,,3,1,2,,,
"Mar 3, 2023 12:00 PM",76,35,41,41,17,24,40,19,21,40,23,17,0,0,0,9,28,25,3,14,11,3,16,18,7,5,2,24,1,0,,,4,3,1,,,
"Mar 3, 2023 1:00 PM",83,35,48,31,22,9,35,21,14,41,25,16,0,0,0,9,26,22,4,28,25,3,16,13,28,16,12,22,0,2,,,3,1,2,,,
"Mar 3, 2023 2:00 PM",78,31,47,42,19,23,38,18,20,29,15,14,0,0,0,11,26,21,5,18,15,3,19,28,19,12,7,19,2,3,,,11,4,7,,,
"Mar 3, 2023 3:00 PM",76,33,43,29,21,8,36,19,17,34,21,13,0,0,0,12,24,17,7,20,20,0,9,32,16,9,7,31,2,5,,,4,3,1,,,
"Mar 3, 2023 4:00 PM",123,35,88,36,24,12,49,30,19,36,21,15,0,0,0,28,24,14,10,35,32,3,16,54,25,15,10,34,12,4,,,11,9,2,,,
"Mar 3, 2023 5:00 PM",151,35,116,48,28,20,62,37,25,50,29,21,0,0,0,29,29,24,5,61,59,2,18,68,30,17,13,41,4,4,,,13,8,5,,,
"Mar 3, 2023 6:00 PM",131,29,102,26,17,9,60,39,21,40,21,19,0,0,0,24,29,25,4,45,42,3,22,46,44,26,18,23,1,1,,,8,4,4,,,
"Mar 3, 2023 7:00 PM",81,22,59,27,16,11,34,24,10,25,17,8,0,0,0,19,19,16,3,29,28,1,13,25,17,11,6,21,0,0,,,5,3,2,,,
"Mar 3, 2023 8:00 PM",57,18,39,9,8,1,17,10,7,14,7,7,0,0,0,5,7,6,1,9,8,1,5,14,10,8,2,13,0,1,,,3,3,0,,,
"Mar 3, 2023 9:00 PM",32,16,16,8,6,2,8,6,2,7,4,3,0,0,0,7,8,6,2,10,7,3,8,8,5,3,2,6,0,1,,,1,0,1,,,
"Mar 3, 2023 10:00 PM",27,10,17,9,7,2,19,6,13,13,5,8,0,0,0,1,8,7,1,4,4,0,5,7,4,3,1,11,3,0,,,1,0,1,,,
"Mar 3, 2023 11:00 PM",24,7,17,5,5,0,4,3,1,3,3,0,0,0,0,1,5,4,1,6,6,0,4,6,1,0,1,3,2,1,,,3,2,1,,,
"Mar 4, 2023 12:00 AM",8,1,7,0,0,0,2,0,2,4,1,3,,,,0,3,2,1,5,4,1,1,12,4,2,2,3,0,0,,,2,2,0,,,
"Mar 4, 2023 1:00 AM",8,2,6,1,1,0,3,0,3,0,0,0,,,,0,0,0,0,3,3,0,0,7,1,1,0,4,0,3,,,1,1,0,,,
"Mar 4, 2023 2:00 AM",6,4,2,0,0,0,1,0,1,1,0,1,,,,0,0,0,0,2,2,0,0,0,0,0,0,1,1,0,,,2,2,0,,,
"Mar 4, 2023 3:00 AM",3,1,2,1,0,1,0,0,0,2,0,2,,,,1,0,0,0,1,1,0,2,0,0,0,0,0,0,0,,,0,0,0,,,
"Mar 4, 2023 4:00 AM",5,1,4,0,0,0,2,2,0,2,2,0,,,,0,0,0,0,1,1,0,1,5,0,0,0,2,0,0,,,0,0,0,,,
"Mar 4, 2023 5:00 AM",2,1,1,0,0,0,0,0,0,1,0,1,,,,1,1,1,0,1,1,0,1,2,0,0,0,1,0,0,,,0,0,0,,,
"Mar 4, 2023 6:00 AM",11,8,3,6,5,1,8,6,2,5,4,1,,,,1,4,4,0,1,1,0,5,2,2,2,0,6,1,1,,,3,3,0,,,
"Mar 4, 2023 7:00 AM",17,9,8,17,10,7,23,16,7,24,17,7,,,,7,12,11,1,1,1,0,9,15,3,1,2,7,1,1,,,0,0,0,,,
"Mar 4, 2023 8:00 AM",32,15,17,42,22,20,36,19,17,29,21,8,,,,4,18,18,0,5,4,1,15,16,19,10,9,20,2,6,,,1,0,1,,,
"Mar 4, 2023 9:00 AM",39,28,11,83,53,30,78,54,24,72,54,18,,,,6,19,19,0,5,3,2,19,21,22,17,5,29,4,7,,,6,5,1,,,
"Mar 4, 2023 10:00 AM",55,30,25,91,49,42,112,65,47,81,52,29,,,,13,25,25,0,5,5,0,24,19,43,27,16,38,9,6,,,7,5,2,,,
"Mar 4, 2023 11:00 AM",43,20,23,97,37,60,111,50,61,85,35,50,,,,7,14,12,2,11,9,2,9,29,40,18,22,37,4,6,,,6,4,2,,,
"Mar 4, 2023 12:00 PM",50,23,27,94,39,55,81,30,51,72,29,43,,,,18,24,19,5,14,10,4,15,21,33,19,14,31,10,8,,,20,15,5,,,
"Mar 4, 2023 1:00 PM",47,22,25,52,27,25,58,31,27,46,20,26,,,,23,24,23,1,23,22,1,20,16,32,8,24,23,1,8,,,8,5,3,,,
"Mar 4, 2023 2:00 PM",64,40,24,49,26,23,57,34,23,59,35,24,,,,20,15,15,0,14,13,1,16,22,32,18,14,29,4,4,,,12,7,5,,,
"Mar 4, 2023 3:00 PM",42,26,16,53,23,30,63,30,33,58,33,25,,,,25,20,20,0,10,9,1,20,16,26,12,14,22,4,2,,,3,2,1,,,
"Mar 4, 2023 4:00 PM",49,24,25,40,23,17,60,25,35,46,19,27,,,,40,11,11,0,15,10,5,9,14,42,17,25,16,8,1,,,12,9,3,,,
"Mar 4, 2023 5:00 PM",44,18,26,29,14,15,30,16,14,24,9,15,,,,18,12,11,1,17,13,4,14,19,15,8,7,22,2,0,,,4,4,0,,,
"Mar 4, 2023 6:00 PM",47,19,28,29,14,15,41,19,22,30,14,16,,,,10,13,12,1,10,10,0,11,8,13,7,6,16,2,2,,,8,5,3,,,
"Mar 4, 2023 7:00 PM",51,25,26,12,4,8,14,3,11,7,1,6,,,,6,14,12,2,6,3,3,9,10,4,1,3,10,0,0,,,9,5,4,,,
"Mar 4, 2023 8:00 PM",27,12,15,7,2,5,7,3,4,8,4,4,,,,2,5,5,0,5,5,0,6,14,2,1,1,6,1,0,,,1,0,1,,,
"Mar 4, 2023 9:00 PM",18,7,11,6,4,2,5,1,4,6,1,5,,,,6,3,3,0,3,3,0,5,2,4,3,1,9,1,1,,,0,0,0,,,
"Mar 4, 2023 10:00 PM",15,8,7,1,0,1,7,5,2,7,4,3,,,,2,3,3,0,7,7,0,3,2,4,1,3,5,1,1,,,1,1,0,,,
"Mar 4, 2023 11:00 PM",21,5,16,3,3,0,6,1,5,4,1,3,,,,2,3,3,0,2,2,0,3,2,6,2,4,2,1,0,,,0,0,0,,,
"Mar 5, 2023 12:00 AM",7,1,6,0,0,0,3,1,2,7,3,4,,,,2,0,0,0,4,4,0,0,2,4,1,3,7,0,2,,,0,0,0,,,
"Mar 5, 2023 1:00 AM",12,5,7,0,0,0,4,1,3,2,0,2,,,,0,3,3,0,4,4,0,1,4,0,0,0,2,0,0,,,0,0,0,,,
"Mar 5, 2023 2:00 AM",7,4,3,1,1,0,1,1,0,0,0,0,,,,1,0,0,0,0,0,0,0,0,1,1,0,3,2,0,,,2,1,1,,,
"Mar 5, 2023 3:00 AM",4,0,4,0,0,0,2,1,1,2,1,1,0,,0,0,1,1,0,0,0,0,1,2,0,0,0,1,1,0,,,1,1,0,,,
"Mar 5, 2023 4:00 AM",3,0,3,0,0,0,2,2,0,3,3,0,0,,0,0,0,0,0,0,0,0,0,4,0,0,0,0,0,0,,,0,0,0,,,
"Mar 5, 2023 5:00 AM",5,2,3,0,0,0,0,0,0,0,0,0,0,,0,0,1,1,0,1,1,0,1,0,0,0,0,1,0,0,,,0,0,0,,,
"Mar 5, 2023 6:00 AM",9,6,3,5,2,3,5,4,1,4,2,2,,,,0,3,3,0,1,1,0,3,2,1,0,1,5,2,1,,,0,0,0,,,
"Mar 5, 2023 7:00 AM",17,6,11,14,5,9,17,10,7,18,11,7,0,0,0,3,10,10,0,4,2,2,10,4,7,3,4,10,1,1,,,1,0,1,,,
"Mar 5, 2023 8:00 AM",47,22,25,48,29,19,43,30,13,44,32,12,,,,0,4,3,1,18,16,2,2,24,8,5,3,15,1,4,,,1,1,0,,,
"Mar 5, 2023 9:00 AM",39,23,16,76,46,30,74,57,17,75,62,13,,,,12,20,20,0,5,5,0,16,20,36,27,9,25,2,11,,,5,3,2,,,
"Mar 5, 2023 10:00 AM",63,39,24,122,76,46,145,73,72,112,70,42,0,,0,7,32,29,3,14,14,0,21,36,51,29,22,54,7,7,,,4,3,1,,,
"Mar 5, 2023 11:00 AM",49,30,19,171,80,91,145,72,73,124,60,64,,,,24,19,19,0,10,10,0,17,20,55,26,29,65,8,6,,,7,4,3,,,
"Mar 5, 2023 12:00 PM",65,36,29,136,65,71,117,60,57,98,52,46,0,,0,4,27,25,2,19,16,3,23,17,52,37,15,42,7,7,,,15,7,8,,,
"Mar 5, 2023 1:00 PM",58,27,31,108,52,56,122,63,59,96,40,56,0,0,0,14,26,24,2,16,16,0,20,34,57,35,22,27,2,6,,,2,0,2,,,
"Mar 5, 2023 2:00 PM",46,20,26,92,45,47,102,42,60,98,45,53,0,0,0,24,21,20,1,22,20,2,16,17,54,34,20,32,6,6,,,13,6,7,,,
"Mar 5, 2023 3:00 PM",50,25,25,126,66,60,92,47,45,98,48,50,0,0,0,34,10,9,1,9,7,2,10,29,52,21,31,25,1,2,,,6,2,4,,,
"Mar 5, 2023 4:00 PM",57,32,25,76,33,43,82,27,55,60,20,40,0,0,0,17,15,15,0,9,7,2,15,17,48,18,30,22,4,4,,,8,6,2,,,
"Mar 5, 2023 5:00 PM",40,16,24,55,32,23,59,29,30,52,29,23,0,0,0,21,11,10,1,15,15,0,8,18,43,18,25,20,0,0,,,5,3,2,,,
"Mar 5, 2023 6:00 PM",55,16,39,42,23,19,46,22,24,39,15,24,0,0,0,12,12,12,0,12,8,4,12,5,9,4,5,22,4,2,,,7,5,2,,,
"Mar 5, 2023 7:00 PM",51,19,32,7,4,3,11,5,6,7,4,3,0,0,0,6,9,6,3,11,9,2,5,13,8,3,5,11,2,2,,,7,3,4,,,
"Mar 5, 2023 8:00 PM",21,8,13,4,2,2,9,2,7,4,2,2,0,0,0,6,3,2,1,5,5,0,3,7,1,0,1,9,1,0,,,4,1,3,,,
"Mar 5, 2023 9:00 PM",22,12,10,8,5,3,5,3,2,4,1,3,0,0,0,1,5,5,0,2,2,0,6,7,2,2,0,3,0,0,,,2,0,2,,,
"Mar 5, 2023 10:00 PM",10,4,6,3,3,0,4,3,1,3,2,1,0,0,0,2,5,4,1,4,4,0,4,2,2,1,1,1,0,0,,,0,0,0,,,
"Mar 5, 2023 11:00 PM",7,1,6,1,1,0,2,0,2,1,0,1,0,0,0,0,2,1,1,3,2,1,1,3,0,0,0,2,0,0,,,1,1,0,,,
"Mar 6, 2023 12:00 AM",8,2,6,0,0,0,0,0,0,0,0,0,,,,1,2,0,2,3,3,0,0,1,2,1,1,8,0,0,,,2,1,1,,,
"Mar 6, 2023 1:00 AM",2,0,2,0,0,0,1,1,0,0,0,0,,,,0,1,1,0,1,1,0,0,0,0,0,0,0,0,2,,,0,0,0,,,
"Mar 6, 2023 2:00 AM",4,3,1,0,0,0,0,0,0,0,0,0,,,,0,0,0,0,0,0,0,0,0,0,0,0,0,0,0,,,0,0,0,,,
"Mar 6, 2023 3:00 AM",1,0,1,0,0,0,0,0,0,0,0,0,,,,0,0,0,0,1,1,0,0,0,0,0,0,0,0,0,,,0,0,0,,,
"Mar 6, 2023 4:00 AM",3,1,2,0,0,0,0,0,0,0,0,0,,,,0,1,1,0,0,0,0,1,0,0,0,0,1,0,0,,,1,1,0,,,
"Mar 6, 2023 5:00 AM",10,8,2,0,0,0,1,0,1,0,0,0,,,,1,7,7,0,1,1,0,7,3,0,0,0,4,0,0,,,0,0,0,,,
"Mar 6, 2023 6:00 AM",44,26,18,14,5,9,15,5,10,8,2,6,,,,6,13,13,0,5,4,1,11,11,3,0,3,26,2,1,,,2,1,1,,,
"Mar 6, 2023 7:00 AM",136,92,44,44,12,32,63,12,51,42,11,31,,,,11,72,72,0,23,19,4,70,26,24,8,16,111,3,2,,,7,5,2,,,
"Mar 6, 2023 8:00 AM",260,211,49,71,14,57,126,37,89,89,38,51,,,,42,185,181,4,39,28,11,168,48,65,14,51,181,5,4,,,18,13,5,,,
"Mar 6, 2023 9:00 AM",129,108,21,32,8,24,65,27,38,46,25,21,,,,11,97,94,3,18,16,2,67,28,44,16,28,71,2,3,,,7,4,3,,,
"Mar 6, 2023 10:00 AM",69,55,14,35,20,15,49,29,20,37,26,11,,,,6,40,36,4,13,7,6,18,17,21,12,9,24,1,2,,,6,3,3,,,
"Mar 6, 2023 11:00 AM",35,24,11,22,14,8,26,15,11,24,16,8,,,,8,18,17,1,9,9,0,13,7,15,11,4,22,5,4,,,9,4,5,,,
"Mar 6, 2023 12:00 PM",56,31,25,21,6,15,47,17,30,25,11,14,,,,4,24,22,2,7,6,1,15,13,15,12,3,12,3,4,,,8,4,4,,,
"Mar 6, 2023 1:00 PM",64,28,36,27,19,8,33,17,16,18,9,9,,,,10,22,20,2,23,20,3,16,14,10,5,5,12,2,2,,,3,1,2,,,
"Mar 6, 2023 2:00 PM",51,21,30,9,6,3,20,10,10,13,5,8,,,,7,15,12,3,21,19,2,9,18,15,12,3,18,5,2,,,2,1,1,,,
"Mar 6, 2023 3:00 PM",62,18,44,12,10,2,18,16,2,13,9,4,,,,12,9,7,2,18,12,6,6,29,5,3,2,8,4,3,,,9,3,6,,,
"Mar 6, 2023 4:00 PM",102,29,73,26,16,10,31,21,10,29,20,9,,,,11,31,22,9,41,38,3,18,38,25,17,8,29,3,2,,,10,4,6,,,
"Mar 6, 2023 5:00 PM",177,35,142,27,24,3,49,37,12,38,25,13,,,,18,29,23,6,92,88,4,25,104,42,31,11,40,5,2,,,7,5,2,,,
"Mar 6, 2023 6:00 PM",142,21,121,26,23,3,63,52,11,40,29,11,,,,21,31,22,9,94,88,6,20,85,35,29,6,26,1,2,,,3,1,2,,,
"Mar 6, 2023 7:00 PM",87,20,67,14,14,0,24,22,2,17,16,1,,,,6,20,11,9,41,39,2,7,33,14,11,3,15,3,1,,,2,0,2,,,
"Mar 6, 2023 8:00 PM",60,11,49,2,2,0,10,5,5,12,6,6,,,,5,17,13,4,20,19,1,11,20,9,8,1,11,2,1,,,2,2,0,,,
"Mar 6, 2023 9:00 PM",32,4,28,5,4,1,10,8,2,9,5,4,,,,4,6,3,3,9,9,0,2,11,2,1,1,6,1,0,,,5,4,1,,,
"Mar 6, 2023 10:00 PM",13,3,10,2,2,0,6,3,3,6,4,2,,,,3,8,2,6,7,7,0,2,6,1,1,0,2,0,0,,,1,0,1,,,
"Mar 6, 2023 11:00 PM",10,4,6,3,2,1,4,1,3,1,1,0,,,,2,2,1,1,3,2,1,1,1,2,0,2,1,0,0,,,3,3,0,,,
"Mar 7, 2023 12:00 AM",8,1,7,0,0,0,0,0,0,0,0,0,,,,1,0,0,0,3,3,0,0,4,0,0,0,0,0,0,,,1,0,1,,,
"Mar 7, 2023 1:00 AM",2,0,2,0,0,0,0,0,0,0,0,0,,,,0,0,0,0,0,0,0,0,1,0,0,0,0,0,0,,,0,0,0,,,
"Mar 7, 2023 2:00 AM",2,2,0,0,0,0,1,0,1,0,0,0,,,,0,0,0,0,0,0,0,0,0,0,0,0,0,0,0,,,0,0,0,,,
"Mar 7, 2023 3:00 AM",0,0,0,0,0,0,0,0,0,0,0,0,,,,0,0,0,0,0,0,0,0,0,0,0,0,0,0,0,,,0,0,0,,,
"Mar 7, 2023 4:00 AM",4,1,3,0,0,0,0,0,0,0,0,0,,,,0,0,0,0,0,0,0,0,0,0,0,0,2,0,0,,,0,0,0,,,
"Mar 7, 2023 5:00 AM",6,5,1,2,1,1,4,2,2,4,3,1,,,,0,6,6,0,4,3,1,7,2,1,1,0,2,1,0,,,0,0,0,,,
"Mar 7, 2023 6:00 AM",35,25,10,8,1,7,18,4,14,9,5,4,,,,9,7,7,0,8,7,1,6,8,4,1,3,27,0,4,,,1,0,1,,,
"Mar 7, 2023 7:00 AM",137,101,36,32,5,27,39,7,32,32,5,27,,,,13,75,73,2,14,12,2,72,34,24,5,19,98,4,4,,,6,4,2,,,
"Mar 7, 2023 8:00 AM",275,209,66,57,12,45,116,27,89,69,28,41,,,,34,169,162,7,35,26,9,136,54,60,20,40,211,5,7,,,13,12,1,,,
"Mar 7, 2023 9:00 AM",172,148,24,43,15,28,69,36,33,56,33,23,,,,17,88,86,2,14,11,3,68,14,43,17,26,87,0,3,,,1,1,0,,,
"Mar 7, 2023 10:00 AM",58,44,14,61,42,19,54,36,18,48,36,12,,,,13,36,35,1,7,4,3,22,27,18,10,8,23,2,2,,,2,1,1,,,
"Mar 7, 2023 11:00 AM",51,41,10,32,14,18,37,18,19,28,12,16,,,,15,34,33,1,7,4,3,26,13,19,16,3,15,2,1,,,2,2,0,,,
"Mar 7, 2023 12:00 PM",58,28,30,33,18,15,61,30,31,39,20,19,,,,8,29,25,4,18,16,2,21,15,26,9,17,20,2,1,,,5,5,0,,,
"Mar 7, 2023 1:00 PM",71,27,44,53,29,24,64,28,36,46,25,21,,,,13,23,20,3,15,13,2,16,16,25,14,11,21,3,4,,,10,7,3,,,
"Mar 7, 2023 2:00 PM",68,36,32,44,20,24,38,18,20,38,21,17,,,,14,30,26,4,21,17,4,18,21,19,14,5,22,4,2,,,4,1,3,,,
"Mar 7, 2023 3:00 PM",80,34,46,39,23,16,55,34,21,42,25,17,,,,21,18,11,7,29,24,5,7,37,25,15,10,25,4,3,,,7,5,2,,,
"Mar 7, 2023 4:00 PM",131,43,88,46,29,17,65,43,22,44,32,12,,,,15,37,25,12,42,37,5,22,57,36,19,17,31,0,3,,,5,2,3,,,
"Mar 7, 2023 5:00 PM",217,56,161,69,44,25,108,63,45,82,45,37,,,,26,47,35,12,90,88,2,35,114,52,32,20,57,6,8,,,15,12,3,,,
"Mar 7, 2023 6:00 PM",215,45,170,51,36,15,91,60,31,60,38,22,,,,23,41,32,9,100,88,12,27,117,78,64,14,39,4,2,,,12,10,2,,,
"Mar 7, 2023 7:00 PM",108,24,84,27,16,11,52,37,15,35,21,14,,,,10,18,13,5,57,56,1,10,34,41,33,8,20,1,2,,,7,6,1,,,
"Mar 7, 2023 8:00 PM",101,28,73,9,6,3,50,30,20,27,9,18,,,,13,13,10,3,27,26,1,11,33,20,12,8,15,4,0,,,7,2,5,,,
"Mar 7, 2023 9:00 PM",48,14,34,10,8,2,17,10,7,12,9,3,,,,9,11,9,2,19,18,1,9,8,4,2,2,17,1,0,,,3,1,2,,,
"Mar 7, 2023 10:00 PM",23,5,18,3,2,1,6,5,1,5,4,1,,,,4,8,3,5,10,8,2,3,7,5,3,2,7,1,0,,,1,1,0,,,
"Mar 7, 2023 11:00 PM",9,2,7,2,2,0,3,2,1,0,0,0,,,,0,0,0,0,7,6,1,0,3,5,2,3,3,1,0,,,5,3,2,,,
"Mar 8, 2023 12:00 AM",3,0,3,0,0,0,0,0,0,2,1,1,,,,0,2,1,1,4,3,1,2,2,3,3,0,0,0,0,,,0,0,0,,,
"Mar 8, 2023 1:00 AM",3,0,3,0,0,0,3,3,0,0,0,0,,,,0,0,0,0,0,0,0,0,1,0,0,0,0,0,0,,,0,0,0,,,
"Mar 8, 2023 2:00 AM",3,3,0,0,0,0,0,0,0,0,0,0,,,,0,0,0,0,0,0,0,0,1,0,0,0,3,0,0,,,0,0,0,,,
"Mar 8, 2023 3:00 AM",1,0,1,0,0,0,0,0,0,0,0,0,,,,1,0,0,0,0,0,0,0,0,0,0,0,0,0,0,,,0,0,0,,,
"Mar 8, 2023 4:00 AM",4,2,2,0,0,0,0,0,0,0,0,0,,,,0,0,0,0,0,0,0,1,0,0,0,0,3,0,0,,,0,0,0,,,
"Mar 8, 2023 5:00 AM",8,7,1,1,0,1,2,2,0,3,2,1,,,,1,3,3,0,4,2,2,5,3,2,1,1,3,0,0,,,0,0,0,,,
"Mar 8, 2023 6:00 AM",47,29,18,12,4,8,19,5,14,9,2,7,,,,7,14,14,0,2,2,0,13,14,6,2,4,34,2,2,,,5,4,1,,,
"Mar 8, 2023 7:00 AM",123,92,31,33,11,22,48,8,40,31,10,21,,,,13,84,84,0,16,14,2,77,30,27,9,18,109,6,4,,,5,5,0,,,
"Mar 8, 2023 8:00 AM",290,235,55,72,13,59,136,40,96,82,29,53,,,,40,194,187,7,38,28,10,164,55,64,19,45,194,4,6,,,20,15,5,,,
"Mar 8, 2023 9:00 AM",136,110,26,46,14,32,62,30,32,52,29,23,,,,13,85,84,1,23,17,6,61,22,36,13,23,79,2,7,,,3,3,0,,,
"Mar 8, 2023 10:00 AM",64,51,13,32,13,19,46,16,30,31,12,19,,,,7,40,39,1,11,8,3,23,12,17,8,9,22,1,1,,,4,4,0,,,
"Mar 8, 2023 11:00 AM",47,33,14,30,15,15,33,24,9,22,17,5,0,0,0,5,30,28,2,9,4,5,17,17,16,13,3,19,5,1,,,2,2,0,,,
"Mar 8, 2023 12:00 PM",70,36,34,27,17,10,36,17,19,27,16,11,,,,5,27,23,4,13,13,0,16,12,16,9,7,24,5,3,,,5,3,2,,,
"Mar 8, 2023 1:00 PM",75,34,41,46,22,24,51,25,26,44,21,23,,,,11,25,22,3,30,24,6,22,20,27,14,13,24,2,4,,,12,8,4,,,
"Mar 8, 2023 2:00 PM",55,24,31,39,16,23,45,22,23,34,14,20,,,,11,16,13,3,20,19,1,11,23,17,6,11,24,6,0,,,7,5,2,,,
"Mar 8, 2023 3:00 PM",72,25,47,25,15,10,45,30,15,31,21,10,,,,16,27,21,6,28,23,5,14,24,16,12,4,24,4,1,,,7,5,2,,,
"Mar 8, 2023 4:00 PM",132,43,89,34,20,14,62,39,23,52,27,25,,,,20,25,20,5,35,32,3,18,54,41,21,20,27,4,1,,,9,8,1,,,
"Mar 8, 2023 5:00 PM",228,57,171,34,30,4,70,45,25,55,38,17,,,,15,46,30,16,87,85,2,29,114,49,31,18,48,4,2,,,6,3,3,,,
"Mar 8, 2023 6:00 PM",194,37,157,48,35,13,82,63,19,54,38,16,,,,19,37,28,9,96,91,5,26,115,59,43,16,33,2,3,,,9,7,2,,,
"Mar 8, 2023 7:00 PM",108,26,82,17,16,1,36,33,3,21,19,2,0,0,0,8,13,10,3,50,47,3,9,35,22,20,2,10,1,2,,,4,1,3,,,
"Mar 8, 2023 8:00 PM",70,20,50,6,4,2,13,8,5,8,4,4,,,,8,7,6,1,30,26,4,6,27,8,5,3,16,7,2,,,5,3,2,,,
"Mar 8, 2023 9:00 PM",45,8,37,5,3,2,12,10,2,6,4,2,0,0,0,2,9,6,3,12,10,2,5,20,5,2,3,7,3,0,,,4,2,2,,,
"Mar 8, 2023 10:00 PM",32,8,24,4,4,0,7,4,3,6,3,3,0,0,0,7,4,3,1,4,4,0,3,14,2,1,1,4,0,0,,,0,0,0,,,
"Mar 8, 2023 11:00 PM",12,1,11,0,0,0,0,0,0,0,0,0,0,0,0,1,4,3,1,7,6,1,3,4,0,0,0,3,1,0,,,1,1,0,,,
"Mar 9, 2023 12:00 AM",3,1,2,0,0,0,3,3,0,5,4,1,0,0,0,0,2,0,2,1,1,0,0,2,3,3,0,1,0,0,,,0,0,0,,,
"Mar 9, 2023 1:00 AM",1,0,1,0,0,0,1,1,0,1,1,0,0,0,0,0,2,0,2,0,0,0,0,1,0,0,0,0,0,0,,,1,1,0,,,
"Mar 9, 2023 2:00 AM",2,2,0,0,0,0,0,0,0,0,0,0,0,0,0,0,1,1,0,0,0,0,0,0,0,0,0,1,0,1,,,0,0,0,,,
"Mar 9, 2023 3:00 AM",0,0,0,0,0,0,0,0,0,0,0,0,0,0,0,0,0,0,0,0,0,0,0,0,0,0,0,0,0,0,,,0,0,0,,,
"Mar 9, 2023 4:00 AM",3,2,1,0,0,0,0,0,0,0,0,0,0,0,0,0,1,1,0,1,1,0,1,0,0,0,0,2,0,0,,,0,0,0,,,
"Mar 9, 2023 5:00 AM",4,4,0,0,0,0,3,0,3,0,0,0,0,0,0,3,1,1,0,4,2,2,1,1,1,0,1,1,0,0,,,0,0,0,,,
"Mar 9, 2023 6:00 AM",27,16,11,2,0,2,7,3,4,6,3,3,0,0,0,2,9,9,0,3,3,0,7,6,3,1,2,19,0,1,,,1,1,0,,,
"Mar 9, 2023 7:00 AM",61,46,15,8,1,7,20,6,14,12,3,9,0,0,0,6,41,39,2,8,7,1,40,14,7,1,6,50,2,0,,,2,2,0,,,
"Mar 9, 2023 8:00 AM",165,132,33,20,5,15,34,11,23,27,10,17,0,0,0,14,73,72,1,15,7,8,63,21,16,2,14,116,1,2,,,13,13,0,,,
"Mar 9, 2023 9:00 AM",78,71,7,17,5,12,23,6,17,19,9,10,0,0,0,9,41,40,1,10,7,3,33,8,13,3,10,34,0,3,,,2,0,2,,,
"Mar 9, 2023 10:00 AM",30,24,6,6,0,6,13,3,10,4,1,3,0,0,0,8,19,19,0,2,2,0,10,4,5,1,4,10,0,1,,,2,1,1,,,
"Mar 9, 2023 11:00 AM",20,17,3,6,3,3,1,1,0,6,2,4,0,0,0,0,11,8,3,5,4,1,5,0,2,0,2,3,0,0,,,0,0,0,,,
"Mar 9, 2023 12:00 PM",35,23,12,3,2,1,5,1,4,4,2,2,0,0,0,5,9,8,1,6,4,2,4,3,2,2,0,7,0,0,,,1,1,0,,,
"Mar 9, 2023 1:00 PM",37,17,20,11,7,4,12,8,4,11,5,6,0,0,0,4,11,10,1,9,9,0,10,10,8,6,2,8,1,2,,,1,0,1,,,
"Mar 9, 2023 2:00 PM",27,9,18,5,4,1,16,9,7,10,5,5,0,0,0,2,10,8,2,7,6,1,4,11,5,4,1,12,1,0,,,4,1,3,,,
"Mar 9, 2023 3:00 PM",38,16,22,9,8,1,11,8,3,9,7,2,0,0,0,6,10,5,5,13,12,1,3,15,3,3,0,6,1,0,,,2,1,1,,,
"Mar 9, 2023 4:00 PM",72,16,56,8,4,4,16,12,4,10,8,2,0,0,0,4,21,12,9,19,16,3,12,37,9,8,1,7,2,1,,,3,1,2,,,
"Mar 9, 2023 5:00 PM",101,20,81,11,8,3,22,16,6,13,10,3,0,0,0,9,18,13,5,39,38,1,11,57,10,9,1,24,4,1,,,2,2,0,,,
"Mar 9, 2023 6:00 PM",88,16,72,14,11,3,28,20,8,13,10,3,0,0,0,6,13,10,3,47,46,1,8,43,16,14,2,15,2,0,,,4,2,2,,,
"Mar 9, 2023 7:00 PM",56,13,43,9,7,2,10,8,2,8,4,4,0,0,0,4,9,8,1,16,16,0,5,16,10,9,1,6,1,0,,,5,3,2,,,
"Mar 9, 2023 8:00 PM",31,9,22,1,1,0,1,1,0,2,2,0,0,0,0,1,6,4,2,16,15,1,6,9,0,0,0,6,1,0,,,1,1,0,,,
"Mar 9, 2023 9:00 PM",19,2,17,0,0,0,3,1,2,2,0,2,0,0,0,2,3,1,2,6,6,0,1,1,1,1,0,5,0,0,,,0,0,0,,,
"Mar 9, 2023 10:00 PM",17,2,15,0,0,0,2,1,1,1,0,1,0,0,0,2,4,3,1,5,5,0,4,0,1,1,0,2,0,0,,,0,0,0,,,
"Mar 9, 2023 11:00 PM",7,0,7,1,1,0,5,3,2,2,1,1,0,0,0,0,1,0,1,2,2,0,0,1,0,0,0,3,0,0,,,0,0,0,,,
"Mar 10, 2023 12:00 AM",2,0,2,0,0,0,0,0,0,0,0,0,0,0,0,0,1,1,0,1,1,0,1,5,1,1,0,0,0,0,,,0,0,0,,,
"Mar 10, 2023 1:00 AM",2,1,1,0,0,0,1,1,0,0,0,0,,,,0,1,1,0,1,1,0,1,1,0,0,0,1,0,0,,,0,0,0,,,
"Mar 10, 2023 2:00 AM",0,0,0,0,0,0,0,0,0,0,0,0,,,,0,0,0,0,0,0,0,0,0,0,0,0,1,0,0,,,0,0,0,,,
"Mar 10, 2023 3:00 AM",1,0,1,1,1,0,1,1,0,2,2,0,,,,0,0,0,0,0,0,0,0,0,1,1,0,2,0,0,,,0,0,0,,,
"Mar 10, 2023 4:00 AM",1,1,0,0,0,0,0,0,0,0,0,0,,,,0,0,0,0,0,0,0,0,0,0,0,0,1,0,0,,,0,0,0,,,
"Mar 10, 2023 5:00 AM",9,7,2,1,0,1,1,0,1,0,0,0,,,,1,0,0,0,3,2,1,0,2,0,0,0,3,0,0,,,0,0,0,,,
"Mar 10, 2023 6:00 AM",15,8,7,1,0,1,5,4,1,4,2,2,,,,1,2,2,0,4,3,1,2,4,3,2,1,12,0,0,,,1,1,0,,,
"Mar 10, 2023 7:00 AM",29,12,17,10,2,8,19,3,16,13,4,9,,,,4,14,13,1,5,5,0,11,12,6,2,4,34,1,0,,,6,6,0,,,
"Mar 10, 2023 8:00 AM",45,31,14,37,2,35,50,10,40,33,8,25,,,,9,59,55,4,12,9,3,47,21,27,5,22,60,3,0,,,6,5,1,,,
"Mar 10, 2023 9:00 AM",40,26,14,16,5,11,28,11,17,21,12,9,0,0,0,6,27,27,0,13,9,4,16,8,13,5,8,31,0,2,,,1,1,0,,,
"Mar 10, 2023 10:00 AM",35,30,5,10,4,6,28,15,13,19,9,10,0,0,0,2,17,17,0,5,3,2,11,13,14,7,7,18,0,0,,,3,1,2,,,
"Mar 10, 2023 11:00 AM",29,14,15,29,12,17,25,13,12,16,9,7,0,0,0,2,18,17,1,5,2,3,16,10,10,4,6,16,1,1,,,3,2,1,,,
"Mar 10, 2023 12:00 PM",43,24,19,28,11,17,40,15,25,21,12,9,0,0,0,6,13,11,2,11,8,3,8,10,14,6,8,14,0,1,,,2,1,1,,,
"Mar 10, 2023 1:00 PM",47,19,28,50,27,23,55,36,19,48,29,19,,,,7,14,12,2,16,11,5,7,9,33,22,11,18,3,1,,,10,6,4,,,
"Mar 10, 2023 2:00 PM",56,29,27,43,18,25,44,27,17,31,17,14,,,,5,10,10,0,15,13,2,9,20,16,10,6,21,4,0,,,4,1,3,,,
"Mar 10, 2023 3:00 PM",44,22,22,42,20,22,45,27,18,38,23,15,,,,13,16,15,1,13,12,1,14,21,25,19,6,19,2,6,,,3,1,2,,,
"Mar 10, 2023 4:00 PM",55,16,39,32,21,11,42,21,21,39,23,16,,,,9,18,16,2,29,25,4,14,31,18,7,11,17,1,2,,,9,4,5,,,
"Mar 10, 2023 5:00 PM",82,19,63,61,37,24,59,40,19,46,31,15,,,,15,16,9,7,33,33,0,11,37,35,21,14,34,2,3,,,3,2,1,,,
"Mar 10, 2023 6:00 PM",73,29,44,33,24,9,42,33,9,30,19,11,,,,9,19,14,5,19,18,1,11,27,23,18,5,28,1,0,,,4,1,3,,,
"Mar 10, 2023 7:00 PM",69,25,44,15,8,7,33,20,13,17,8,9,,,,7,20,17,3,20,17,3,17,18,20,15,5,17,1,0,,,2,2,0,,,
"Mar 10, 2023 8:00 PM",45,24,21,8,5,3,9,6,3,9,5,4,,,,5,12,8,4,8,8,0,8,18,6,6,0,8,4,1,,,4,3,1,,,
"Mar 10, 2023 9:00 PM",22,8,14,7,6,1,5,3,2,5,3,2,,,,5,3,2,1,12,10,2,1,7,4,3,1,7,0,1,,,2,2,0,,,
"Mar 10, 2023 10:00 PM",21,13,8,1,1,0,6,4,2,4,2,2,0,0,0,3,7,3,4,6,5,1,4,7,4,2,2,6,2,1,,,3,2,1,,,
"Mar 10, 2023 11:00 PM",22,8,14,2,2,0,9,5,4,5,2,3,0,0,0,3,4,2,2,5,4,1,2,6,1,0,1,3,3,0,,,4,2,2,,,
"Mar 11, 2023 12:00 AM",9,2,7,0,0,0,1,0,1,5,2,3,0,0,0,0,2,2,0,5,5,0,1,0,3,0,3,4,0,0,,,0,0,0,,,
"Mar 11, 2023 1:00 AM",5,0,5,1,1,0,0,0,0,0,0,0,0,0,0,0,2,0,2,3,2,1,0,2,0,0,0,3,0,0,,,0,0,0,,,
"Mar 11, 2023 2:00 AM",2,1,1,0,0,0,3,3,0,1,1,0,0,0,0,0,0,0,0,1,1,0,0,6,0,0,0,1,0,0,,,0,0,0,,,
"Mar 11, 2023 3:00 AM",3,1,2,0,0,0,0,0,0,1,0,1,0,0,0,0,0,0,0,0,0,0,1,3,0,0,0,0,0,0,,,0,0,0,,,
"Mar 11, 2023 4:00 AM",4,0,4,0,0,0,0,0,0,0,0,0,0,0,0,0,0,0,0,0,0,0,0,1,0,0,0,3,0,0,,,0,0,0,,,
"Mar 11, 2023 5:00 AM",3,3,0,0,0,0,0,0,0,1,0,1,0,0,0,2,0,0,0,1,1,0,0,1,1,0,1,2,0,0,,,0,0,0,,,
"Mar 11, 2023 6:00 AM",9,7,2,1,1,0,3,3,0,2,2,0,0,0,0,1,4,4,0,3,3,0,4,3,0,0,0,0,0,0,,,1,1,0,,,
"Mar 11, 2023 7:00 AM",11,4,7,9,6,3,13,9,4,11,9,2,0,0,0,1,5,5,0,4,3,1,5,7,3,0,3,15,2,1,,,2,1,1,,,
"Mar 11, 2023 8:00 AM",21,12,9,17,10,7,15,10,5,19,14,5,0,0,0,4,6,6,0,4,3,1,6,9,7,7,0,10,4,0,,,3,2,1,,,
"Mar 11, 2023 9:00 AM",22,13,9,23,4,19,21,11,10,15,9,6,0,0,0,6,6,6,0,4,4,0,5,5,13,4,9,11,1,2,,,2,0,2,,,
"Mar 11, 2023 10:00 AM",25,12,13,19,10,9,16,11,5,19,14,5,0,0,0,6,9,9,0,8,7,1,7,8,11,8,3,13,1,1,,,2,1,1,,,
"Mar 11, 2023 11:00 AM",23,11,12,31,16,15,22,9,13,20,9,11,0,0,0,8,8,8,0,1,1,0,8,7,17,7,10,9,0,0,,,2,2,0,,,
"Mar 11, 2023 12:00 PM",16,9,7,8,3,5,8,2,6,8,2,6,0,0,0,4,5,4,1,4,1,3,2,10,8,4,4,10,0,1,,,0,0,0,,,
"Mar 11, 2023 1:00 PM",21,13,8,12,7,5,10,7,3,8,5,3,0,0,0,6,5,4,1,1,1,0,3,3,2,2,0,1,0,2,,,3,0,3,,,
"Mar 11, 2023 2:00 PM",30,17,13,7,3,4,8,5,3,8,4,4,0,,0,6,7,6,1,3,3,0,6,5,1,1,0,4,0,1,,,1,1,0,,,
"Mar 11, 2023 3:00 PM",19,8,11,4,1,3,5,2,3,3,1,2,0,,0,10,5,4,1,5,4,1,3,6,2,2,0,3,1,1,,,1,1,0,,,
"Mar 11, 2023 4:00 PM",19,3,16,5,3,2,11,5,6,12,6,6,0,,0,9,5,4,1,5,3,2,4,7,8,4,4,6,3,1,,,4,4,0,,,
"Mar 11, 2023 5:00 PM",29,10,19,9,5,4,11,3,8,9,3,6,0,,0,8,10,6,4,6,5,1,4,4,3,2,1,8,2,0,,,0,0,0,,,
"Mar 11, 2023 6:00 PM",27,12,15,12,9,3,5,3,2,5,2,3,0,,0,3,3,3,0,5,4,1,3,7,5,2,3,7,0,1,,,3,3,0,,,
"Mar 11, 2023 7:00 PM",32,19,13,2,1,1,7,2,5,7,4,3,0,,0,7,4,4,0,3,3,0,2,4,3,2,1,3,0,0,,,3,1,2,,,
"Mar 11, 2023 8:00 PM",22,15,7,4,3,1,7,4,3,4,2,2,0,,0,1,5,5,0,4,3,1,7,4,1,1,0,6,1,0,,,3,2,1,,,
"Mar 11, 2023 9:00 PM",11,5,6,3,2,1,3,2,1,3,2,1,0,,0,1,4,3,1,2,2,0,3,4,2,1,1,4,1,0,,,0,0,0,,,
"Mar 11, 2023 10:00 PM",6,5,1,2,2,0,1,1,0,2,0,2,0,0,0,0,2,2,0,1,1,0,1,2,0,0,0,3,0,0,,,2,2,0,,,
"Mar 11, 2023 11:00 PM",11,4,7,1,1,0,3,2,1,4,2,2,0,0,0,2,4,3,1,1,1,0,3,1,0,0,0,3,0,1,,,2,0,2,,,
"Mar 12, 2023 12:00 AM",5,0,5,0,0,0,1,1,0,2,2,0,,,,0,3,3,0,3,3,0,3,3,1,0,1,1,1,1,,,1,1,0,,,
"Mar 12, 2023 1:00 AM",3,1,2,0,0,0,0,0,0,0,0,0,0,,0,0,1,1,0,0,0,0,2,1,3,2,1,1,0,0,,,0,0,0,,,
"Mar 12, 2023 2:00 AM",6,1,5,0,0,0,2,2,0,0,0,0,0,,0,0,0,0,0,1,1,0,0,0,0,0,0,2,0,0,,,0,0,0,,,
"Mar 12, 2023 3:00 AM",1,0,1,0,0,0,1,0,1,0,0,0,,,,0,0,0,0,0,0,0,0,1,0,0,0,1,0,0,,,1,1,0,,,
"Mar 12, 2023 4:00 AM",2,0,2,0,0,0,2,2,0,2,2,0,,,,1,0,0,0,0,0,0,0,2,0,0,0,1,0,0,,,0,0,0,,,
"Mar 12, 2023 5:00 AM",3,2,1,0,0,0,1,0,1,0,0,0,,,,2,1,1,0,1,1,0,1,2,0,0,0,3,0,0,,,0,0,0,,,
"Mar 12, 2023 6:00 AM",6,2,4,3,3,0,3,3,0,3,3,0,,,,4,2,2,0,0,0,0,2,0,2,2,0,5,0,0,,,0,0,0,,,
"Mar 12, 2023 7:00 AM",23,14,9,14,5,9,16,9,7,20,12,8,,,,0,5,5,0,2,1,1,7,8,4,2,2,9,2,2,,,1,1,0,,,
"Mar 12, 2023 8:00 AM",31,15,16,67,44,23,57,43,14,55,42,13,,,,2,12,12,0,8,7,1,12,28,20,15,5,25,1,2,,,1,1,0,,,
"Mar 12, 2023 9:00 AM",27,13,14,129,83,46,96,68,28,105,81,24,,,,7,13,13,0,12,11,1,14,19,20,11,9,44,4,9,,,4,3,1,,,
"Mar 12, 2023 10:00 AM",51,39,12,120,74,46,113,82,31,100,78,22,0,,0,11,23,21,2,6,6,0,18,35,48,32,16,36,2,8,,,4,4,0,,,
"Mar 12, 2023 11:00 AM",58,28,30,143,69,74,145,78,67,137,72,65,0,,0,19,19,19,0,6,6,0,18,33,50,30,20,36,14,5,,,16,14,2,,,
"Mar 12, 2023 12:00 PM",52,31,21,206,84,122,174,80,94,149,65,84,0,,0,19,22,21,1,15,14,1,23,44,71,36,35,55,5,5,,,12,10,2,,,
"Mar 12, 2023 1:00 PM",76,40,36,104,58,46,112,56,56,106,51,55,0,0,0,20,26,25,1,17,15,2,26,29,53,27,26,38,3,7,,,7,1,6,,,
"Mar 12, 2023 2:00 PM",52,30,22,87,38,49,76,26,50,80,31,49,0,,0,9,18,17,1,14,12,2,12,17,43,19,24,30,6,2,,,5,4,1,,,
"Mar 12, 2023 3:00 PM",34,18,16,65,25,40,63,24,39,55,28,27,0,,0,19,8,8,0,12,12,0,6,10,36,14,22,20,4,0,,,4,4,0,,,
"Mar 12, 2023 4:00 PM",35,12,23,48,26,22,45,17,28,55,20,35,0,,0,6,13,12,1,4,3,1,11,11,20,6,14,16,2,1,,,8,5,3,,,
"Mar 12, 2023 5:00 PM",36,14,22,35,18,17,36,8,28,28,7,21,0,,0,9,11,10,1,7,6,1,9,18,22,14,8,16,1,0,,,2,2,0,,,
"Mar 12, 2023 6:00 PM",52,25,27,20,15,5,20,9,11,18,7,11,0,0,0,4,5,5,0,10,9,1,4,6,8,3,5,7,0,0,,,2,0,2,,,
"Mar 12, 2023 7:00 PM",38,17,21,12,5,7,5,2,3,7,3,4,0,0,0,6,7,6,1,3,3,0,5,6,5,2,3,5,0,0,,,2,1,1,,,
"Mar 12, 2023 8:00 PM",24,6,18,3,3,0,4,2,2,4,3,1,,,,4,5,3,2,7,7,0,4,6,1,1,0,7,2,1,,,2,1,1,,,
"Mar 12, 2023 9:00 PM",14,9,5,11,5,6,4,0,4,6,2,4,,,,0,6,5,1,3,2,1,6,2,1,0,1,4,0,0,,,0,0,0,,,
"Mar 12, 2023 10:00 PM",8,3,5,0,0,0,2,1,1,2,0,2,,,,3,1,1,0,4,3,1,3,3,1,1,0,6,0,0,,,0,0,0,,,
"Mar 12, 2023 11:00 PM",9,4,5,2,2,0,2,1,1,2,1,1,0,0,0,1,0,0,0,0,0,0,0,3,0,0,0,2,2,0,,,1,1,0,,,
"Mar 13, 2023 12:00 AM",9,3,6,0,0,0,0,0,0,0,0,0,,,,1,2,1,1,1,1,0,1,0,0,0,0,1,0,0,,,0,0,0,,,
"Mar 13, 2023 1:00 AM",0,0,0,0,0,0,0,0,0,0,0,0,,,,0,0,0,0,0,0,0,0,0,0,0,0,0,0,0,,,0,0,0,,,
"Mar 13, 2023 2:00 AM",1,0,1,0,0,0,0,0,0,0,0,0,0,0,0,0,0,0,0,1,1,0,0,0,0,0,0,0,0,0,,,0,0,0,,,
"Mar 13, 2023 3:00 AM",0,0,0,1,0,1,0,0,0,1,0,1,0,0,0,0,0,0,0,1,1,0,0,0,0,0,0,0,0,0,,,0,0,0,,,
"Mar 13, 2023 4:00 AM",2,0,2,0,0,0,1,0,1,0,0,0,0,0,0,0,2,2,0,0,0,0,2,0,1,0,1,1,0,0,,,0,0,0,,,
"Mar 13, 2023 5:00 AM",8,7,1,0,0,0,2,1,1,2,1,1,0,0,0,1,0,0,0,2,1,1,0,3,0,0,0,0,0,0,,,0,0,0,,,
"Mar 13, 2023 6:00 AM",36,24,12,4,1,3,11,4,7,4,2,2,0,0,0,4,12,12,0,3,3,0,11,9,2,0,2,25,1,2,,,2,1,1,,,
"Mar 13, 2023 7:00 AM",110,78,32,41,9,32,57,14,43,50,15,35,,,,13,64,63,1,13,9,4,58,22,18,6,12,87,2,2,,,8,7,1,,,
"Mar 13, 2023 8:00 AM",209,159,50,64,18,46,102,29,73,79,31,48,,,,32,127,123,4,30,24,6,114,38,48,13,35,159,4,5,,,20,15,5,,,
"Mar 13, 2023 9:00 AM",95,85,10,48,18,30,69,36,33,67,36,31,,,,11,52,51,1,13,8,5,47,14,25,10,15,66,3,1,,,8,5,3,,,
"Mar 13, 2023 10:00 AM",46,33,13,39,14,25,33,17,16,29,16,13,0,0,0,10,14,13,1,5,2,3,9,15,11,7,4,20,1,1,,,0,0,0,,,
"Mar 13, 2023 11:00 AM",32,25,7,27,17,10,21,10,11,22,13,9,0,0,0,4,11,10,1,11,7,4,5,11,13,4,9,16,2,5,,,4,2,2,,,
"Mar 13, 2023 12:00 PM",36,18,18,25,15,10,52,29,23,23,12,11,0,,0,6,22,21,1,12,9,3,14,13,16,11,5,13,3,2,,,6,4,2,,,
"Mar 13, 2023 1:00 PM",60,21,39,36,21,15,48,24,24,54,17,37,,,,13,10,8,2,10,8,2,8,10,29,20,9,22,3,0,,,2,1,1,,,
"Mar 13, 2023 2:00 PM",35,19,16,69,33,36,23,13,10,47,35,12,0,0,0,6,5,5,0,12,10,2,5,12,11,7,4,17,3,0,,,3,2,1,,,
"Mar 13, 2023 3:00 PM",35,11,24,10,7,3,16,9,7,14,9,5,0,0,0,10,13,12,1,12,10,2,10,18,11,9,2,9,2,0,,,6,3,3,,,
"Mar 13, 2023 4:00 PM",95,34,61,26,18,8,36,27,9,37,24,13,0,0,0,12,11,8,3,27,26,1,7,47,20,15,5,19,3,3,,,2,2,0,,,
"Mar 13, 2023 5:00 PM",171,45,126,33,25,8,72,51,21,47,36,11,0,0,0,18,40,36,4,73,72,1,31,86,41,34,7,34,2,3,,,6,3,3,,,
"Mar 13, 2023 6:00 PM",129,27,102,37,27,10,55,33,22,50,27,23,0,0,0,19,25,22,3,73,71,2,19,80,29,24,5,30,2,0,,,4,3,1,,,
"Mar 13, 2023 7:00 PM",79,24,55,15,9,6,22,15,7,16,11,5,0,0,0,10,15,12,3,32,29,3,9,34,15,12,3,13,1,3,,,6,3,3,,,
"Mar 13, 2023 8:00 PM",57,12,45,21,15,6,14,9,5,20,11,9,0,0,0,7,10,7,3,24,24,0,6,19,9,8,1,8,6,1,,,5,3,2,,,
"Mar 13, 2023 9:00 PM",34,10,24,9,7,2,8,6,2,10,4,6,0,0,0,3,6,4,2,10,10,0,5,14,2,2,0,12,4,0,,,5,4,1,,,
"Mar 13, 2023 10:00 PM",16,3,13,0,0,0,6,6,0,2,2,0,0,0,0,2,2,0,2,6,6,0,0,3,2,2,0,4,1,0,,,2,1,1,,,
"Mar 13, 2023 11:00 PM",4,2,2,2,2,0,2,2,0,1,1,0,0,0,0,0,0,0,0,4,4,0,0,5,1,1,0,2,1,0,,,1,1,0,,,
"Mar 14, 2023 12:00 AM",4,3,1,0,0,0,1,1,0,0,0,0,0,0,0,0,0,0,0,2,2,0,0,5,2,2,0,2,0,0,,,0,0,0,,,
"Mar 14, 2023 1:00 AM",0,0,0,1,1,0,4,4,0,2,2,0,0,0,0,0,0,0,0,1,1,0,0,5,1,1,0,0,0,0,,,0,0,0,,,
"Mar 14, 2023 2:00 AM",1,1,0,0,0,0,1,0,1,1,1,0,0,0,0,0,0,0,0,0,0,0,0,1,0,0,0,1,0,0,,,0,0,0,,,
"Mar 14, 2023 3:00 AM",0,0,0,1,0,1,0,0,0,1,0,1,0,0,0,0,0,0,0,0,0,0,1,0,0,0,0,0,0,0,,,0,0,0,,,
"Mar 14, 2023 4:00 AM",3,1,2,0,0,0,1,0,1,0,0,0,0,0,0,0,1,1,0,1,1,0,1,0,1,0,1,2,0,0,,,0,0,0,,,
"Mar 14, 2023 5:00 AM",8,7,1,3,0,3,1,0,1,2,0,2,0,0,0,2,3,3,0,3,3,0,3,1,2,1,1,3,0,0,,,0,0,0,,,
"Mar 14, 2023 6:00 AM",50,33,17,15,5,10,19,6,13,14,5,9,0,0,0,5,16,16,0,3,2,1,12,7,8,3,5,31,1,4,,,1,1,0,,,
"Mar 14, 2023 7:00 AM",144,104,40,32,5,27,46,5,41,38,11,27,0,0,0,18,89,87,2,17,15,2,84,34,27,10,17,111,1,3,,,8,6,2,,,
"Mar 14, 2023 8:00 AM",260,205,55,78,20,58,121,36,85,91,34,57,0,0,0,40,166,164,2,30,22,8,156,50,60,17,43,228,9,9,,,19,18,1,,,
"Mar 14, 2023 9:00 AM",107,83,24,46,11,35,76,31,45,64,30,34,0,0,0,17,68,68,0,15,11,4,50,14,34,11,23,75,3,1,,,3,2,1,,,
"Mar 14, 2023 10:00 AM",49,32,17,31,13,18,32,18,14,30,21,9,0,0,0,15,22,21,1,12,7,5,16,11,23,15,8,23,3,2,,,4,1,3,,,
"Mar 14, 2023 11:00 AM",34,22,12,57,25,32,50,29,21,36,19,17,0,0,0,9,19,17,2,8,5,3,16,12,16,11,5,25,2,3,,,5,5,0,,,
"Mar 14, 2023 12:00 PM",51,25,26,23,13,10,46,20,26,23,10,13,0,0,0,9,18,17,1,11,9,2,15,17,27,9,18,20,0,3,,,2,1,1,,,
"Mar 14, 2023 1:00 PM",47,19,28,21,12,9,35,21,14,22,13,9,0,0,0,11,14,13,1,14,13,1,15,24,12,6,6,16,7,2,,,2,2,0,,,
"Mar 14, 2023 2:00 PM",45,22,23,25,17,8,40,21,19,27,19,8,0,0,0,9,11,11,0,17,15,2,10,19,26,17,9,20,5,5,,,6,3,3,,,
"Mar 14, 2023 3:00 PM",53,19,34,20,13,7,33,16,17,19,12,7,0,0,0,8,13,12,1,14,9,5,10,22,16,9,7,16,0,2,,,5,2,3,,,
"Mar 14, 2023 4:00 PM",108,34,74,47,28,19,67,47,20,44,28,16,0,0,0,21,26,21,5,36,33,3,18,50,36,29,7,26,3,3,,,4,2,2,,,
"Mar 14, 2023 5:00 PM",211,56,155,51,35,16,106,61,45,66,39,27,0,0,0,23,34,27,7,91,89,2,30,105,49,35,14,41,6,3,,,6,4,2,,,
"Mar 14, 2023 6:00 PM",172,39,133,64,49,15,108,75,33,77,54,23,0,0,0,16,29,27,2,105,100,5,25,122,55,43,12,42,5,1,,,7,5,2,,,
"Mar 14, 2023 7:00 PM",99,20,79,19,15,4,41,29,12,27,19,8,0,0,0,9,10,9,1,42,41,1,9,52,19,15,4,23,5,0,,,5,4,1,,,
"Mar 14, 2023 8:00 PM",65,22,43,15,12,3,29,20,9,25,17,8,0,0,0,11,9,8,1,32,31,1,7,26,12,9,3,14,2,2,,,5,2,3,,,
"Mar 14, 2023 9:00 PM",40,10,30,7,6,1,13,7,6,6,5,1,0,0,0,8,10,7,3,20,19,1,9,18,6,4,2,6,4,0,,,1,1,0,,,
"Mar 14, 2023 10:00 PM",34,7,27,6,5,1,5,5,0,5,3,2,0,0,0,4,3,2,1,15,14,1,2,4,1,0,1,9,1,0,,,2,0,2,,,
"Mar 14, 2023 11:00 PM",10,2,8,1,1,0,7,6,1,5,3,2,0,0,0,1,2,0,2,4,4,0,0,7,2,1,1,2,1,0,,,2,2,0,,,
"Mar 15, 2023 12:00 AM",6,0,6,0,0,0,2,1,1,2,1,1,0,0,0,0,2,1,1,9,9,0,1,0,2,1,1,1,0,0,,,0,0,0,,,
"Mar 15, 2023 1:00 AM",4,2,2,0,0,0,0,0,0,0,0,0,0,0,0,0,0,0,0,0,0,0,0,0,0,0,0,0,0,0,,,0,0,0,,,
"Mar 15, 2023 2:00 AM",7,5,2,0,0,0,0,0,0,0,0,0,0,0,0,0,0,0,0,0,0,0,0,1,0,0,0,0,0,0,,,0,0,0,,,
"Mar 15, 2023 3:00 AM",2,1,1,1,0,1,2,0,2,1,0,1,0,0,0,0,0,0,0,0,0,0,0,1,0,0,0,2,0,0,,,0,0,0,,,
"Mar 15, 2023 4:00 AM",3,1,2,1,0,1,0,0,0,1,0,1,0,0,0,0,2,2,0,0,0,0,2,0,1,0,1,2,0,0,,,0,0,0,,,
"Mar 15, 2023 5:00 AM",4,3,1,2,0,2,1,0,1,1,0,1,0,0,0,0,2,2,0,3,2,1,2,2,3,1,2,5,0,0,,,0,0,0,,,
"Mar 15, 2023 6:00 AM",43,28,15,13,5,8,18,8,10,12,6,6,0,0,0,5,17,17,0,4,4,0,15,13,8,3,5,19,1,2,,,2,1,1,,,
"Mar 15, 2023 7:00 AM",113,90,23,31,7,24,45,10,35,36,10,26,0,0,0,13,72,72,0,18,16,2,72,23,18,4,14,91,3,2,,,5,4,1,,,
"Mar 15, 2023 8:00 AM",221,177,44,58,15,43,101,29,72,73,26,47,0,0,0,36,137,134,3,28,21,7,118,43,53,15,38,160,4,3,,,19,14,5,,,
"Mar 15, 2023 9:00 AM",102,86,16,25,6,19,47,19,28,37,19,18,0,0,0,15,42,42,0,13,11,2,35,12,22,7,15,55,2,6,,,6,4,2,,,
"Mar 15, 2023 10:00 AM",32,21,11,15,5,10,17,8,9,9,3,6,0,0,0,7,16,15,1,1,0,1,11,4,5,3,2,15,2,0,,,2,2,0,,,
"Mar 15, 2023 11:00 AM",26,15,11,9,4,5,9,0,9,3,0,3,0,0,0,5,5,4,1,5,3,2,1,6,4,3,1,10,2,1,,,1,0,1,,,
"Mar 15, 2023 12:00 PM",39,22,17,8,3,5,14,10,4,5,3,2,0,0,0,5,9,8,1,15,13,2,8,8,9,8,1,16,2,0,,,4,3,1,,,
"Mar 15, 2023 1:00 PM",53,20,33,18,14,4,26,19,7,24,16,8,0,0,0,7,10,9,1,10,8,2,7,16,11,8,3,10,1,3,,,4,2,2,,,
"Mar 15, 2023 2:00 PM",48,20,28,15,7,8,11,5,6,13,7,6,0,0,0,6,10,9,1,0,0,0,6,13,11,7,4,15,1,0,,,1,0,1,,,
"Mar 15, 2023 3:00 PM",53,17,36,14,7,7,17,11,6,10,6,4,0,0,0,16,12,10,2,0,0,0,6,17,10,2,8,9,3,0,,,3,2,1,,,
"Mar 15, 2023 4:00 PM",96,36,60,14,9,5,29,16,13,22,10,12,0,0,0,12,20,13,7,0,0,0,13,40,21,15,6,30,3,1,,,7,5,2,,,
"Mar 15, 2023 5:00 PM",165,37,128,31,22,9,43,28,15,45,31,14,0,0,0,14,18,15,3,0,0,0,19,92,26,20,6,50,4,2,,,9,5,4,,,
"Mar 15, 2023 6:00 PM",148,23,125,33,28,5,61,38,23,47,32,15,0,0,0,13,29,24,5,0,0,0,19,81,42,34,8,16,2,3,,,7,5,2,,,
"Mar 15, 2023 7:00 PM",68,24,44,14,13,1,30,26,4,21,17,4,0,0,0,7,10,10,0,0,0,0,9,34,18,15,3,14,0,2,,,4,2,2,,,
"Mar 15, 2023 8:00 PM",48,10,38,11,9,2,9,5,4,6,5,1,0,0,0,2,9,9,0,0,0,0,8,23,10,8,2,9,3,2,,,6,3,3,,,
"Mar 15, 2023 9:00 PM",36,5,31,2,2,0,13,9,4,7,4,3,0,0,0,4,7,5,2,0,0,0,3,16,4,3,1,6,4,0,,,0,0,0,,,
"Mar 15, 2023 10:00 PM",25,8,17,3,3,0,5,5,0,3,3,0,0,0,0,2,8,7,1,0,0,0,7,5,1,1,0,4,1,0,,,2,0,2,,,
"Mar 15, 2023 11:00 PM",8,2,6,4,2,2,1,1,0,2,1,1,0,0,0,1,3,2,1,0,0,0,2,3,0,0,0,0,1,0,,,3,3,0,,,
"Mar 16, 2023 12:00 AM",3,0,3,0,0,0,0,0,0,0,0,0,0,0,0,0,1,1,0,0,0,0,2,0,1,1,0,1,0,0,,,0,0,0,,,
"Mar 16, 2023 1:00 AM",1,1,0,0,0,0,0,0,0,0,0,0,0,0,0,0,0,0,0,0,0,0,0,1,3,3,0,0,0,0,,,0,0,0,,,
"Mar 16, 2023 2:00 AM",5,2,3,0,0,0,2,0,2,0,0,0,0,0,0,0,0,0,0,0,0,0,0,0,0,0,0,0,0,0,,,0,0,0,,,
"Mar 16, 2023 3:00 AM",0,0,0,1,0,1,1,0,1,1,0,1,0,0,0,0,0,0,0,0,0,0,0,1,1,1,0,3,0,0,,,0,0,0,,,
"Mar 16, 2023 4:00 AM",3,0,3,0,0,0,1,1,0,0,0,0,0,0,0,0,1,1,0,0,0,0,1,0,1,0,1,1,0,0,,,0,0,0,,,
"Mar 16, 2023 5:00 AM",8,7,1,0,0,0,0,0,0,1,1,0,0,0,0,0,3,3,0,0,0,0,2,2,0,0,0,4,1,0,,,0,0,0,,,
"Mar 16, 2023 6:00 AM",32,23,9,15,7,8,12,6,6,13,7,6,0,0,0,4,13,13,0,0,0,0,14,10,0,0,0,25,1,3,,,1,1,0,,,
"Mar 16, 2023 7:00 AM",93,66,27,34,9,25,45,13,32,37,15,22,0,0,0,5,56,56,0,0,0,0,49,21,21,4,17,89,2,4,,,7,2,5,,,
"Mar 16, 2023 8:00 AM",189,145,44,70,24,46,80,19,61,66,23,43,0,0,0,20,108,104,4,0,0,0,92,37,55,14,41,164,2,2,,,16,12,4,,,
"Mar 16, 2023 9:00 AM",83,69,14,43,17,26,66,27,39,57,29,28,0,0,0,15,44,44,0,0,0,0,33,27,41,14,27,70,3,2,,,3,3,0,,,
"Mar 16, 2023 10:00 AM",49,33,16,50,20,30,43,24,19,41,24,17,0,0,0,5,23,23,0,0,0,0,22,13,20,14,6,22,2,5,,,3,2,1,,,
"Mar 16, 2023 11:00 AM",46,27,19,49,24,25,45,20,25,42,23,19,0,0,0,11,26,24,2,0,0,0,15,11,20,7,13,33,4,2,,,5,5,0,,,
"Mar 16, 2023 12:00 PM",53,31,22,61,27,34,47,20,27,39,19,20,0,0,0,8,13,11,2,0,0,0,8,19,21,11,10,18,0,6,,,4,2,2,,,
"Mar 16, 2023 1:00 PM",58,29,29,55,32,23,65,35,30,61,36,25,0,0,0,17,19,16,3,0,0,0,15,28,26,13,13,13,9,1,,,10,7,3,,,
"Mar 16, 2023 2:00 PM",68,29,39,48,30,18,60,33,27,42,23,19,0,0,0,13,19,19,0,0,0,0,12,27,23,11,12,29,2,2,,,5,1,4,,,
"Mar 16, 2023 3:00 PM",66,30,36,66,34,32,75,46,29,65,40,25,0,0,0,9,17,15,2,0,0,0,14,40,37,18,19,34,1,3,,,5,2,3,,,
"Mar 16, 2023 4:00 PM",112,40,72,55,37,18,79,49,30,55,37,18,0,0,0,18,34,27,7,0,0,0,23,54,50,34,16,27,9,5,,,11,8,3,,,
"Mar 16, 2023 5:00 PM",152,44,108,73,44,29,119,68,51,92,50,42,0,0,0,20,34,27,7,0,0,0,24,93,69,44,25,48,6,3,,,15,12,3,,,
"Mar 16, 2023 6:00 PM",131,33,98,79,48,31,104,67,37,72,48,24,0,0,0,24,23,17,6,0,0,0,17,79,71,43,28,30,3,4,,,15,11,4,,,
"Mar 16, 2023 7:00 PM",84,16,68,33,23,10,54,28,26,48,27,21,0,0,0,12,17,16,1,0,0,0,12,37,36,25,11,25,1,3,,,8,4,4,,,
"Mar 16, 2023 8:00 PM",74,23,51,14,10,4,16,10,6,14,8,6,0,0,0,12,5,4,1,0,0,0,7,22,4,3,1,15,4,1,,,6,3,3,,,
"Mar 16, 2023 9:00 PM",40,10,30,12,9,3,20,11,9,7,5,2,0,0,0,4,11,8,3,0,0,0,9,10,7,4,3,13,0,2,,,2,0,2,,,
"Mar 16, 2023 10:00 PM",28,5,23,3,2,1,9,6,3,6,2,4,0,0,0,9,5,2,3,0,0,0,3,5,4,3,1,2,1,1,,,0,0,0,,,
"Mar 16, 2023 11:00 PM",21,7,14,4,4,0,7,4,3,5,3,2,0,0,0,5,3,2,1,0,0,0,3,4,1,0,1,3,1,0,,,2,2,0,,,
"Mar 17, 2023 12:00 AM",15,6,9,0,0,0,4,1,3,7,2,5,0,0,0,3,4,3,1,0,0,0,2,5,1,1,0,3,0,0,,,0,0,0,,,
"Mar 17, 2023 1:00 AM",6,2,4,1,1,0,3,2,1,3,1,2,0,0,0,0,0,0,0,0,0,0,0,6,2,1,1,1,0,0,,,1,0,1,,,
"Mar 17, 2023 2:00 AM",7,3,4,1,0,1,1,0,1,1,0,1,0,0,0,0,0,0,0,0,0,0,0,1,0,0,0,1,0,0,,,0,0,0,,,
"Mar 17, 2023 3:00 AM",1,0,1,0,0,0,1,1,0,1,1,0,0,0,0,0,0,0,0,0,0,0,0,3,0,0,0,1,0,0,,,0,0,0,,,
"Mar 17, 2023 4:00 AM",7,2,5,1,0,1,5,3,2,3,2,1,0,0,0,1,0,0,0,0,0,0,0,2,1,0,1,2,0,0,,,0,0,0,,,
"Mar 17, 2023 5:00 AM",3,1,2,1,0,1,1,0,1,1,0,1,0,0,0,1,0,0,0,0,0,0,0,0,0,0,0,4,0,0,,,0,0,0,,,
"Mar 17, 2023 6:00 AM",20,8,12,7,4,3,9,6,3,8,5,3,0,0,0,2,3,2,1,0,0,0,3,5,2,2,0,9,0,0,,,2,2,0,,,
"Mar 17, 2023 7:00 AM",26,19,7,27,17,10,29,18,11,26,17,9,0,0,0,7,11,11,0,0,0,0,11,12,11,8,3,13,0,4,,,0,0,0,,,
"Mar 17, 2023 8:00 AM",28,12,16,63,27,36,78,40,38,56,30,26,0,0,0,5,7,7,0,0,0,0,6,19,38,22,16,24,4,4,,,1,1,0,,,
"Mar 17, 2023 9:00 AM",42,18,24,77,33,44,93,49,44,69,42,27,0,0,0,12,17,17,0,0,0,0,16,15,44,22,22,29,4,6,,,8,5,3,,,
"Mar 17, 2023 10:00 AM",34,16,18,89,46,43,106,47,59,94,44,50,0,0,0,12,19,19,0,0,0,0,16,20,38,22,16,36,2,2,,,4,4,0,,,
"Mar 17, 2023 11:00 AM",35,21,14,61,28,33,79,30,49,67,28,39,0,0,0,7,19,18,1,0,0,0,20,14,43,18,25,30,4,3,,,6,1,5,,,
"Mar 17, 2023 12:00 PM",43,20,23,59,25,34,55,20,35,50,17,33,0,,0,13,19,18,1,0,0,0,19,16,27,13,14,24,5,1,,,6,5,1,,,
"Mar 17, 2023 1:00 PM",34,20,14,47,28,19,36,21,15,32,20,12,0,,0,4,12,11,1,0,0,0,12,16,18,6,12,19,1,5,,,2,2,0,,,
"Mar 17, 2023 2:00 PM",52,31,21,39,25,14,42,28,14,32,24,8,0,,0,17,8,8,0,0,0,0,7,12,28,17,11,7,3,1,,,5,2,3,,,
"Mar 17, 2023 3:00 PM",51,26,25,53,26,27,64,34,30,67,34,33,0,,0,11,10,10,0,0,0,0,8,20,32,10,22,15,3,1,,,4,2,2,,,
"Mar 17, 2023 4:00 PM",34,21,13,51,21,30,59,24,35,57,23,34,0,0,0,17,11,10,1,0,0,0,14,17,20,15,5,13,1,0,,,7,7,0,,,
"Mar 17, 2023 5:00 PM",47,12,35,46,26,20,25,15,10,31,19,12,0,,0,13,11,10,1,0,0,0,11,9,21,13,8,15,3,0,,,3,2,1,,,
"Mar 17, 2023 6:00 PM",27,11,16,47,14,33,28,12,16,26,12,14,,,,3,14,13,1,0,0,0,12,13,15,4,11,14,2,1,,,3,2,1,,,
"Mar 17, 2023 7:00 PM",34,18,16,8,4,4,11,6,5,6,3,3,,,,7,3,3,0,0,0,0,3,11,8,5,3,11,1,0,,,0,0,0,,,
"Mar 17, 2023 8:00 PM",27,16,11,6,3,3,9,5,4,7,6,1,0,0,0,2,7,7,0,0,0,0,8,9,4,2,2,7,0,0,,,5,2,3,,,
"Mar 17, 2023 9:00 PM",13,4,9,3,1,2,4,2,2,1,0,1,0,0,0,3,6,6,0,0,0,0,6,5,1,1,0,3,0,2,,,0,0,0,,,
"Mar 17, 2023 10:00 PM",12,3,9,1,1,0,2,0,2,4,0,4,,,,6,5,5,0,0,0,0,5,4,1,0,1,6,0,0,,,3,2,1,,,
"Mar 17, 2023 11:00 PM",10,2,8,2,2,0,10,4,6,4,1,3,,,,1,3,3,0,0,0,0,3,5,3,0,3,5,2,0,,,1,1,0,,,
"Mar 18, 2023 12:00 AM",6,2,4,1,1,0,0,0,0,2,1,1,,,,0,1,0,1,0,0,0,0,0,2,1,1,0,0,0,,,0,0,0,,,
"Mar 18, 2023 1:00 AM",4,0,4,1,1,0,2,2,0,3,3,0,,,,0,2,1,1,0,0,0,1,6,4,4,0,2,0,0,,,0,0,0,,,
"Mar 18, 2023 2:00 AM",7,4,3,0,0,0,4,2,2,1,1,0,,,,0,1,1,0,0,0,0,1,3,0,0,0,1,0,0,,,0,0,0,,,
"Mar 18, 2023 3:00 AM",3,1,2,0,0,0,0,0,0,0,0,0,,,,0,0,0,0,0,0,0,0,3,0,0,0,1,0,0,,,0,0,0,,,
"Mar 18, 2023 4:00 AM",5,2,3,0,0,0,1,1,0,2,2,0,,,,1,1,1,0,0,0,0,1,2,1,1,0,0,0,0,,,2,1,1,,,
"Mar 18, 2023 5:00 AM",4,3,1,0,0,0,1,1,0,0,0,0,,,,0,1,1,0,0,0,0,1,3,1,0,1,2,0,0,,,0,0,0,,,
"Mar 18, 2023 6:00 AM",11,5,6,11,6,5,13,8,5,9,6,3,,,,1,2,2,0,0,0,0,2,3,3,2,1,6,0,0,,,1,1,0,,,
"Mar 18, 2023 7:00 AM",17,8,9,20,11,9,20,12,8,17,12,5,,,,7,0,0,0,0,0,0,0,4,8,4,4,12,0,0,,,0,0,0,,,
"Mar 18, 2023 8:00 AM",35,13,22,38,24,14,38,23,15,28,21,7,,,,3,15,14,1,0,0,0,10,18,14,10,4,17,5,3,,,3,1,2,,,
"Mar 18, 2023 9:00 AM",41,25,16,86,43,43,89,54,35,63,35,28,,,,10,15,14,1,0,0,0,13,12,28,19,9,31,2,11,,,2,0,2,,,
"Mar 18, 2023 10:00 AM",39,21,18,118,49,69,111,64,47,86,46,40,,,,9,16,14,2,0,0,0,12,21,39,23,16,20,3,4,,,5,3,2,,,
"Mar 18, 2023 11:00 AM",37,21,16,111,46,65,103,49,54,102,56,46,,,,12,26,26,0,0,0,0,22,31,53,27,26,23,5,4,,,5,3,2,,,
"Mar 18, 2023 12:00 PM",31,13,18,72,33,39,68,26,42,63,24,39,,,,8,10,10,0,0,0,0,8,10,34,15,19,23,5,2,,,4,3,1,,,
"Mar 18, 2023 1:00 PM",32,20,12,18,7,11,37,9,28,30,8,22,,,,10,13,13,0,0,0,0,14,11,17,7,10,12,0,2,,,2,2,0,,,
"Mar 18, 2023 2:00 PM",34,19,15,25,14,11,30,13,17,21,9,12,,,,6,11,9,2,0,0,0,12,6,16,7,9,14,0,6,,,6,4,2,,,
"Mar 18, 2023 3:00 PM",39,23,16,36,18,18,26,12,14,26,16,10,0,,0,10,16,15,1,0,0,0,16,15,18,11,7,13,1,2,,,5,3,2,,,
"Mar 18, 2023 4:00 PM",41,26,15,40,20,20,37,23,14,37,23,14,0,0,0,23,9,9,0,0,0,0,8,15,25,12,13,13,3,4,,,9,6,3,,,
"Mar 18, 2023 5:00 PM",27,13,14,27,13,14,19,6,13,20,9,11,0,0,0,10,5,4,1,0,0,0,6,5,8,5,3,5,1,0,,,1,1,0,,,
"Mar 18, 2023 6:00 PM",41,22,19,17,11,6,11,4,7,15,10,5,0,0,0,8,4,3,1,0,0,0,3,6,5,1,4,4,3,2,,,9,5,4,,,
"Mar 18, 2023 7:00 PM",26,13,13,9,5,4,12,6,6,7,2,5,0,0,0,10,4,3,1,0,0,0,3,15,8,3,5,11,0,0,,,4,1,3,,,
"Mar 18, 2023 8:00 PM",38,12,26,16,10,6,9,2,7,7,2,5,0,0,0,3,8,8,0,0,0,0,9,10,6,5,1,5,1,2,,,2,1,1,,,
"Mar 18, 2023 9:00 PM",18,3,15,8,6,2,10,5,5,7,4,3,0,0,0,5,5,5,0,0,0,0,5,4,6,2,4,14,1,0,,,2,1,1,,,
"Mar 18, 2023 10:00 PM",21,9,12,1,1,0,2,1,1,0,0,0,0,0,0,1,7,6,1,0,0,0,8,5,1,1,0,4,0,0,,,0,0,0,,,
"Mar 18, 2023 11:00 PM",10,0,10,6,2,4,7,4,3,3,2,1,0,,0,0,0,0,0,0,0,0,0,4,2,1,1,2,2,0,,,3,2,1,,,
"Mar 19, 2023 12:00 AM",14,4,10,1,1,0,5,3,2,5,3,2,,,,1,3,2,1,0,0,0,2,6,4,4,0,5,4,4,,,1,1,0,,,
"Mar 19, 2023 1:00 AM",3,0,3,1,1,0,3,1,2,1,0,1,,,,1,2,2,0,0,0,0,1,3,0,0,0,4,0,0,,,1,1,0,,,
"Mar 19, 2023 2:00 AM",3,1,2,0,0,0,1,1,0,0,0,0,,,,2,1,1,0,0,0,0,2,3,1,1,0,2,0,0,,,0,0,0,,,
"Mar 19, 2023 3:00 AM",2,0,2,0,0,0,0,0,0,0,0,0,,,,0,0,0,0,0,0,0,0,1,0,0,0,2,0,0,,,0,0,0,,,
"Mar 19, 2023 4:00 AM",6,0,6,0,0,0,0,0,0,0,0,0,,,,0,0,0,0,0,0,0,0,2,0,0,0,1,0,0,,,0,0,0,,,
"Mar 19, 2023 5:00 AM",2,1,1,0,0,0,0,0,0,0,0,0,,,,0,1,1,0,0,0,0,1,2,0,0,0,3,1,1,,,0,0,0,,,
"Mar 19, 2023 6:00 AM",9,3,6,4,1,3,3,2,1,2,0,2,,,,1,1,1,0,0,0,0,2,1,1,1,0,1,0,0,,,1,1,0,,,
"Mar 19, 2023 7:00 AM",15,10,5,7,2,5,11,7,4,10,6,4,,,,2,8,8,0,0,0,0,7,11,2,1,1,12,0,0,,,1,1,0,,,
"Mar 19, 2023 8:00 AM",31,16,15,25,15,10,41,24,17,34,22,12,,,,9,7,7,0,0,0,0,6,16,10,6,4,29,1,2,,,3,3,0,,,
"Mar 19, 2023 9:00 AM",30,18,12,90,56,34,111,74,37,91,67,24,,,,13,13,11,2,0,0,0,9,18,42,32,10,28,4,19,,,5,4,1,,,
"Mar 19, 2023 10:00 AM",54,28,26,176,90,86,179,89,90,132,72,60,,,,5,11,9,2,0,0,0,7,38,64,37,27,38,2,7,,,8,6,2,,,
"Mar 19, 2023 11:00 AM",58,33,25,155,89,66,147,82,65,130,78,52,,,,10,27,26,1,0,0,0,22,39,71,38,33,42,8,4,,,12,6,6,,,
"Mar 19, 2023 12:00 PM",60,21,39,162,66,96,158,78,80,141,80,61,,,,28,14,13,1,0,0,0,12,32,66,32,34,40,7,6,,,3,3,0,,,
"Mar 19, 2023 1:00 PM",51,20,31,96,46,50,100,43,57,75,33,42,,,,17,14,8,6,0,0,0,9,16,53,31,22,30,6,1,,,10,5,5,,,
"Mar 19, 2023 2:00 PM",45,28,17,68,30,38,61,27,34,69,30,39,,,,16,13,13,0,0,0,0,12,13,38,13,25,28,5,1,,,3,1,2,,,
"Mar 19, 2023 3:00 PM",29,17,12,29,13,16,42,9,33,38,10,28,,,,5,14,13,1,0,0,0,13,10,22,6,16,24,0,0,,,5,3,2,,,
"Mar 19, 2023 4:00 PM",23,12,11,25,12,13,18,5,13,17,3,14,,,,3,8,6,2,0,0,0,4,7,14,8,6,10,1,2,,,5,3,2,,,
"Mar 19, 2023 5:00 PM",25,13,12,21,15,6,16,9,7,11,7,4,,,,13,7,7,0,0,0,0,7,7,24,7,17,7,1,0,,,1,1,0,,,
"Mar 19, 2023 6:00 PM",28,9,19,8,4,4,11,9,2,12,6,6,,,,6,6,6,0,0,0,0,7,5,3,3,0,9,0,1,,,1,0,1,,,
"Mar 19, 2023 7:00 PM",29,18,11,3,1,2,8,2,6,5,2,3,,,,10,2,2,0,0,0,0,3,6,0,0,0,7,0,0,,,3,1,2,,,
"Mar 19, 2023 8:00 PM",16,7,9,1,1,0,4,2,2,2,2,0,,,,7,1,1,0,0,0,0,2,4,1,0,1,3,1,1,,,3,0,3,,,
"Mar 19, 2023 9:00 PM",9,5,4,3,2,1,5,3,2,5,2,3,,,,3,2,2,0,0,0,0,2,6,4,2,2,4,1,1,,,2,1,1,,,
"Mar 19, 2023 10:00 PM",4,2,2,2,1,1,5,2,3,4,2,2,,,,1,2,2,0,0,0,0,2,1,0,0,0,2,0,0,,,1,1,0,,,
"Mar 19, 2023 11:00 PM",8,1,7,0,0,0,1,0,1,1,0,1,,,,3,0,0,0,0,0,0,1,0,0,0,0,4,1,0,,,1,1,0,,,
"Mar 20, 2023 12:00 AM",5,2,3,0,0,0,1,0,1,0,0,0,,,,0,1,1,0,0,0,0,1,2,0,0,0,0,0,0,,,0,0,0,,,
"Mar 20, 2023 1:00 AM",1,0,1,0,0,0,0,0,0,0,0,0,,,,0,3,1,2,0,0,0,1,0,0,0,0,1,0,1,,,3,2,1,,,
"Mar 20, 2023 2:00 AM",3,1,2,0,0,0,1,1,0,0,0,0,,,,0,2,1,1,0,0,0,1,0,0,0,0,1,0,0,,,0,0,0,,,
"Mar 20, 2023 3:00 AM",0,0,0,0,0,0,0,0,0,0,0,0,,,,0,0,0,0,0,0,0,0,0,1,1,0,0,0,0,,,0,0,0,,,
"Mar 20, 2023 4:00 AM",4,0,4,0,0,0,0,0,0,0,0,0,,,,1,4,4,0,0,0,0,5,0,0,0,0,4,0,0,,,0,0,0,,,
"Mar 20, 2023 5:00 AM",14,10,4,1,0,1,3,1,2,2,1,1,,,,2,3,3,0,0,0,0,3,4,3,1,2,2,0,0,,,0,0,0,,,
"Mar 20, 2023 6:00 AM",38,24,14,10,3,7,15,4,11,7,2,5,,,,6,17,17,0,0,0,0,16,10,3,0,3,23,2,3,,,2,1,1,,,
"Mar 20, 2023 7:00 AM",114,88,26,35,9,26,57,13,44,36,8,28,,,,14,77,77,0,0,0,0,80,22,23,4,19,92,4,5,,,11,7,4,,,
"Mar 20, 2023 8:00 AM",206,174,32,60,16,44,119,35,84,76,33,43,,,,29,136,132,4,0,0,0,127,48,47,7,40,178,9,2,,,17,16,1,,,
"Mar 20, 2023 9:00 AM",97,81,16,37,11,26,59,32,27,49,27,22,,,,14,53,53,0,0,0,0,42,25,40,16,24,48,2,4,,,5,4,1,,,
"Mar 20, 2023 10:00 AM",45,28,17,39,22,17,53,36,17,37,24,13,,,,12,29,29,0,0,0,0,21,18,23,12,11,25,7,4,,,5,3,2,,,
"Mar 20, 2023 11:00 AM",35,24,11,35,16,19,52,23,29,47,28,19,,,,9,22,22,0,0,0,0,16,15,22,14,8,23,3,1,,,4,2,2,,,
"Mar 20, 2023 12:00 PM",53,29,24,29,19,10,53,23,30,36,19,17,,,,15,13,13,0,0,0,0,10,17,28,14,14,22,5,2,,,3,3,0,,,
"Mar 20, 2023 1:00 PM",58,28,30,44,26,18,57,32,25,38,18,20,,,,13,16,15,1,0,0,0,10,13,30,17,13,27,7,1,,,5,4,1,,,
"Mar 20, 2023 2:00 PM",52,28,24,37,17,20,55,32,23,45,23,22,,,,18,21,17,4,0,0,0,12,21,22,10,12,22,1,5,,,5,1,4,,,
"Mar 20, 2023 3:00 PM",88,40,48,27,19,8,42,18,24,37,27,10,,,,12,25,21,4,0,0,0,16,24,18,11,7,20,4,2,,,4,3,1,,,
"Mar 20, 2023 4:00 PM",128,36,92,35,29,6,64,45,19,50,33,17,,,,18,24,21,3,0,0,0,17,53,37,22,15,31,4,3,,,1,1,0,,,
"Mar 20, 2023 5:00 PM",183,45,138,47,28,19,89,59,30,66,37,29,,,,18,33,29,4,0,0,0,23,94,53,36,17,52,6,5,,,12,7,5,,,
"Mar 20, 2023 6:00 PM",128,30,98,51,38,13,86,57,29,68,42,26,,,,24,28,22,6,0,0,0,21,99,51,41,10,24,5,6,,,10,4,6,,,
"Mar 20, 2023 7:00 PM",99,29,70,25,17,8,39,28,11,25,19,6,,,,14,16,10,6,0,0,0,12,29,20,13,7,15,6,1,,,5,2,3,,,
"Mar 20, 2023 8:00 PM",52,12,40,16,9,7,22,12,10,20,8,12,,,,2,8,5,3,0,0,0,6,18,14,11,3,15,3,2,,,5,4,1,,,
"Mar 20, 2023 9:00 PM",35,5,30,2,1,1,11,5,6,4,2,2,,,,5,8,6,2,0,0,0,4,18,5,4,1,6,2,1,,,2,2,0,,,
"Mar 20, 2023 10:00 PM",22,7,15,0,0,0,5,3,2,2,1,1,,,,1,5,4,1,0,0,0,5,1,0,0,0,4,0,0,,,0,0,0,,,
"Mar 20, 2023 11:00 PM",9,0,9,1,1,0,0,0,0,0,0,0,,,,2,3,3,0,0,0,0,2,1,1,0,1,1,2,0,,,2,2,0,,,
"Mar 21, 2023 12:00 AM",4,1,3,0,0,0,0,0,0,1,1,0,,,,1,1,1,0,0,0,0,1,5,1,1,0,0,0,0,,,0,0,0,,,
"Mar 21, 2023 1:00 AM",4,0,4,0,0,0,1,1,0,0,0,0,,,,1,1,0,1,0,0,0,0,0,1,1,0,0,0,0,,,0,0,0,,,
"Mar 21, 2023 2:00 AM",3,3,0,0,0,0,0,0,0,0,0,0,,,,0,0,0,0,0,0,0,0,0,0,0,0,1,0,0,,,0,0,0,,,
"Mar 21, 2023 3:00 AM",0,0,0,0,0,0,0,0,0,0,0,0,,,,0,0,0,0,0,0,0,0,1,0,0,0,0,0,0,,,0,0,0,,,
"Mar 21, 2023 4:00 AM",4,1,3,0,0,0,0,0,0,0,0,0,,,,0,3,3,0,0,0,0,3,0,0,0,0,6,0,0,,,0,0,0,,,
"Mar 21, 2023 5:00 AM",9,7,2,3,1,2,2,0,2,1,0,1,,,,1,6,6,0,0,0,0,5,2,2,1,1,6,0,0,,,0,0,0,,,
"Mar 21, 2023 6:00 AM",55,31,24,16,4,12,27,9,18,12,6,6,,,,7,18,18,0,0,0,0,17,15,2,0,2,35,1,5,,,4,3,1,,,
"Mar 21, 2023 7:00 AM",153,120,33,49,12,37,68,14,54,46,13,33,,,,15,87,86,1,0,0,0,80,37,30,5,25,143,4,7,,,6,5,1,,,
"Mar 21, 2023 8:00 AM",260,201,59,83,20,63,129,34,95,105,40,65,,,,48,174,171,3,0,0,0,159,53,67,16,51,221,10,8,,,21,17,4,,,
"Mar 21, 2023 9:00 AM",113,96,17,46,14,32,70,28,42,48,26,22,0,,0,12,72,72,0,0,0,0,66,21,43,14,29,77,0,6,,,4,3,1,,,
"Mar 21, 2023 10:00 AM",56,40,16,40,20,20,56,35,21,36,25,11,0,0,0,12,36,35,1,0,0,0,30,16,20,11,9,25,3,3,,,3,2,1,,,
"Mar 21, 2023 11:00 AM",40,23,17,43,24,19,65,39,26,45,25,20,0,0,0,7,24,23,1,0,0,0,16,18,27,17,10,29,4,1,,,3,3,0,,,
"Mar 21, 2023 12:00 PM",38,16,22,35,12,23,53,28,25,37,23,14,0,,0,11,23,19,4,0,0,0,16,13,20,6,14,24,7,2,,,5,4,1,,,
"Mar 21, 2023 1:00 PM",59,23,36,42,27,15,61,33,28,45,23,22,0,,0,13,14,12,2,0,0,0,11,24,29,15,14,20,2,5,,,1,1,0,,,
"Mar 21, 2023 2:00 PM",59,32,27,30,14,16,47,24,23,23,13,10,,,,14,22,20,2,0,0,0,19,17,30,18,12,27,2,3,,,7,3,4,,,
"Mar 21, 2023 3:00 PM",71,22,49,26,17,9,44,27,17,29,17,12,,,,18,15,15,0,0,0,0,8,32,21,12,9,21,4,3,,,6,3,3,,,
"Mar 21, 2023 4:00 PM",116,25,91,25,18,7,40,27,13,31,17,14,,,,13,24,18,6,0,0,0,19,75,36,26,10,34,4,4,,,4,3,1,,,
"Mar 21, 2023 5:00 PM",193,43,150,28,20,8,74,48,26,47,26,21,0,0,0,25,41,31,10,0,0,0,30,113,50,37,13,53,6,2,,,5,3,2,,,
"Mar 21, 2023 6:00 PM",166,30,136,41,36,5,88,66,22,59,40,19,0,0,0,15,19,14,5,0,0,0,14,113,58,49,9,32,4,3,,,10,5,5,,,
"Mar 21, 2023 7:00 PM",103,22,81,21,15,6,29,24,5,22,19,3,0,0,0,6,23,19,4,0,0,0,15,47,21,17,4,11,3,1,,,3,2,1,,,
"Mar 21, 2023 8:00 PM",67,23,44,14,12,2,16,14,2,14,12,2,0,0,0,2,8,6,2,0,0,0,7,25,8,6,2,10,3,2,,,2,0,2,,,
"Mar 21, 2023 9:00 PM",40,7,33,6,5,1,10,8,2,11,10,1,0,0,0,6,11,10,1,0,0,0,10,17,6,4,2,4,2,3,,,2,2,0,,,
"Mar 21, 2023 10:00 PM",30,9,21,1,1,0,3,2,1,2,1,1,0,0,0,4,6,6,0,0,0,0,4,9,2,1,1,3,2,0,,,0,0,0,,,
"Mar 21, 2023 11:00 PM",8,0,8,3,2,1,5,2,3,4,0,4,0,0,0,1,1,1,0,0,0,0,1,4,0,0,0,5,0,0,,,1,0,1,,,
"Mar 22, 2023 12:00 AM",3,1,2,0,0,0,0,0,0,2,0,2,,,,0,0,0,0,0,0,0,0,1,0,0,0,1,0,0,,,0,0,0,,,
"Mar 22, 2023 1:00 AM",1,0,1,0,0,0,0,0,0,0,0,0,,,,0,1,0,1,0,0,0,0,0,0,0,0,1,0,0,,,0,0,0,,,
"Mar 22, 2023 2:00 AM",4,4,0,0,0,0,1,1,0,1,1,0,,,,0,0,0,0,0,0,0,0,1,0,0,0,0,0,0,,,0,0,0,,,
"Mar 22, 2023 3:00 AM",0,0,0,0,0,0,0,0,0,0,0,0,,,,0,0,0,0,0,0,0,0,0,0,0,0,1,0,0,,,0,0,0,,,
"Mar 22, 2023 4:00 AM",4,1,3,0,0,0,0,0,0,0,0,0,,,,0,2,2,0,0,0,0,2,0,0,0,0,1,0,0,,,1,1,0,,,
"Mar 22, 2023 5:00 AM",14,10,4,1,1,0,2,2,0,3,3,0,,,,0,6,6,0,0,0,0,4,3,1,0,1,8,0,0,,,0,0,0,,,
"Mar 22, 2023 6:00 AM",47,26,21,16,4,12,18,3,15,12,3,9,,,,5,16,16,0,0,0,0,15,12,4,1,3,31,2,3,,,6,4,2,,,
"Mar 22, 2023 7:00 AM",122,85,37,45,16,29,66,15,51,51,16,35,,,,13,86,86,0,0,0,0,82,20,29,9,20,110,2,4,,,4,3,1,,,
"Mar 22, 2023 8:00 AM",266,215,51,80,24,56,128,45,83,97,39,58,,,,35,170,160,10,0,0,0,148,51,66,16,50,224,4,7,,,18,16,2,,,
"Mar 22, 2023 9:00 AM",111,94,17,59,25,34,79,32,47,69,36,33,,,,14,65,65,0,0,0,0,54,15,35,15,20,63,2,3,,,2,1,1,,,
"Mar 22, 2023 10:00 AM",51,35,16,35,16,19,52,28,24,40,22,18,,,,12,25,25,0,0,0,0,20,15,26,15,11,32,2,5,,,5,3,2,,,
"Mar 22, 2023 11:00 AM",44,27,17,34,16,18,32,22,10,22,15,7,,,,4,18,17,1,0,0,0,9,11,27,18,9,23,3,5,,,6,5,1,,,
"Mar 22, 2023 12:00 PM",46,18,28,41,22,19,63,36,27,42,24,18,,,,6,18,16,2,0,0,0,1,18,13,9,4,15,1,3,,,8,6,2,,,
"Mar 22, 2023 1:00 PM",66,25,41,62,38,24,71,36,35,55,33,22,,,,10,33,32,1,0,0,0,5,31,36,21,15,31,5,4,,,4,4,0,,,
"Mar 22, 2023 2:00 PM",46,28,18,44,19,25,49,25,24,38,19,19,,,,15,19,17,2,0,0,0,13,27,25,11,14,28,6,0,,,9,7,2,,,
"Mar 22, 2023 3:00 PM",62,20,42,12,6,6,36,21,15,18,10,8,,,,14,20,17,3,0,0,0,11,19,28,15,13,18,4,0,,,5,3,2,,,
"Mar 22, 2023 4:00 PM",116,35,81,48,35,13,58,37,21,48,25,23,,,,15,36,29,7,0,0,0,27,54,24,15,9,27,2,3,,,3,3,0,,,
"Mar 22, 2023 5:00 PM",230,61,169,53,33,20,91,58,33,69,42,27,,,,26,39,35,4,0,0,0,37,111,62,45,17,67,9,4,,,10,6,4,,,
"Mar 22, 2023 6:00 PM",180,47,133,58,46,12,93,66,27,62,44,18,,,,18,38,32,6,0,0,0,32,125,59,47,12,36,4,2,,,13,9,4,,,
"Mar 22, 2023 7:00 PM",81,28,53,23,16,7,47,35,12,27,19,8,,,,9,14,14,0,0,0,0,15,40,23,14,9,24,3,3,,,9,5,4,,,
"Mar 22, 2023 8:00 PM",54,17,37,10,7,3,18,10,8,15,8,7,,,,8,11,8,3,0,0,0,8,28,15,8,7,9,5,2,,,6,5,1,,,
"Mar 22, 2023 9:00 PM",60,18,42,7,6,1,12,10,2,7,4,3,,,,5,5,4,1,0,0,0,4,20,7,5,2,10,3,0,,,3,2,1,,,
"Mar 22, 2023 10:00 PM",41,5,36,8,8,0,15,9,6,8,5,3,,,,8,9,2,7,0,0,0,3,13,5,4,1,10,0,2,,,0,0,0,,,
"Mar 22, 2023 11:00 PM",14,2,12,2,1,1,3,3,0,3,2,1,,,,1,2,2,0,0,0,0,3,5,2,2,0,4,0,0,,,0,0,0,,,
"Mar 23, 2023 12:00 AM",8,0,8,0,0,0,0,0,0,2,1,1,,,,1,1,0,1,0,0,0,0,3,2,2,0,0,0,0,,,0,0,0,,,
"Mar 23, 2023 1:00 AM",2,1,1,0,0,0,1,1,0,0,0,0,,,,0,1,1,0,0,0,0,1,1,1,1,0,0,0,0,,,0,0,0,,,
"Mar 23, 2023 2:00 AM",2,2,0,0,0,0,0,0,0,0,0,0,,,,1,0,0,0,0,0,0,0,0,0,0,0,1,0,0,,,0,0,0,,,
"Mar 23, 2023 3:00 AM",1,0,1,0,0,0,0,0,0,0,0,0,,,,0,0,0,0,0,0,0,0,0,0,0,0,0,0,0,,,0,0,0,,,
"Mar 23, 2023 4:00 AM",3,1,2,0,0,0,1,0,1,1,0,1,,,,0,1,1,0,0,0,0,1,0,1,0,1,2,0,0,,,0,0,0,,,
"Mar 23, 2023 5:00 AM",10,6,4,0,0,0,3,1,2,3,1,2,,,,1,5,5,0,0,0,0,4,1,0,0,0,6,1,0,,,0,0,0,,,
"Mar 23, 2023 6:00 AM",40,24,16,21,11,10,23,12,11,15,10,5,,,,5,21,21,0,0,0,0,15,20,5,3,2,26,0,3,,,3,2,1,,,
"Mar 23, 2023 7:00 AM",131,89,42,40,13,27,69,22,47,50,19,31,,,,16,73,71,2,0,0,0,72,27,28,6,22,111,7,3,,,5,4,1,,,
"Mar 23, 2023 8:00 AM",253,199,54,82,16,66,119,35,84,87,26,61,,,,34,153,151,2,0,0,0,137,51,56,12,44,208,7,5,,,17,14,3,,,
"Mar 23, 2023 9:00 AM",103,92,11,59,27,32,86,45,41,73,39,34,,,,14,76,73,3,0,0,0,58,29,48,17,31,95,0,4,,,2,1,1,,,
"Mar 23, 2023 10:00 AM",49,30,19,52,18,34,70,36,34,45,24,21,,,,8,24,23,1,0,0,0,21,15,21,13,8,20,0,4,,,3,0,3,,,
"Mar 23, 2023 11:00 AM",37,23,14,41,20,21,65,33,32,42,26,16,,,,8,25,23,2,0,0,0,17,14,30,19,11,25,0,0,,,6,6,0,,,
"Mar 23, 2023 12:00 PM",51,26,25,31,16,15,55,25,30,37,13,24,,,,6,15,14,1,0,0,0,12,21,25,11,14,15,4,2,,,2,1,1,,,
"Mar 23, 2023 1:00 PM",52,30,22,59,32,27,76,37,39,54,28,26,,,,15,15,13,2,0,0,0,13,23,19,11,8,26,2,3,,,6,5,1,,,
"Mar 23, 2023 2:00 PM",58,19,39,42,23,19,56,28,28,37,21,16,,,,15,17,16,1,0,0,0,12,30,32,17,15,30,2,4,,,11,5,6,,,
"Mar 23, 2023 3:00 PM",79,38,41,32,18,14,46,23,23,35,22,13,,,,18,18,15,3,0,0,0,11,40,27,18,9,24,3,1,,,4,3,1,,,
"Mar 23, 2023 4:00 PM",115,39,76,36,24,12,76,49,27,54,33,21,,,,28,25,23,2,0,0,0,26,57,29,19,10,37,1,3,,,5,1,4,,,
"Mar 23, 2023 5:00 PM",163,42,121,60,45,15,99,66,33,76,50,26,,,,18,33,28,5,0,0,0,32,112,72,52,20,55,5,5,,,9,6,3,,,
"Mar 23, 2023 6:00 PM",173,40,133,66,45,21,100,70,30,73,48,25,,,,29,33,29,4,0,0,0,29,100,71,49,22,47,4,2,,,8,2,6,,,
"Mar 23, 2023 7:00 PM",106,27,79,37,23,14,46,33,13,45,32,13,,,,9,18,15,3,0,0,0,12,50,27,17,10,20,9,4,,,13,10,3,,,
"Mar 23, 2023 8:00 PM",64,16,48,20,18,2,24,21,3,19,15,4,,,,6,8,6,2,0,0,0,5,30,10,6,4,17,3,0,,,1,1,0,,,
"Mar 23, 2023 9:00 PM",56,14,42,13,11,2,9,2,7,9,5,4,,,,9,12,10,2,0,0,0,9,19,4,2,2,9,1,2,,,2,0,2,,,
"Mar 23, 2023 10:00 PM",26,3,23,4,2,2,7,3,4,8,2,6,,,,4,5,4,1,0,0,0,4,10,4,3,1,6,1,1,,,3,2,1,,,
"Mar 23, 2023 11:00 PM",14,3,11,3,2,1,9,7,2,7,4,3,,,,3,4,2,2,0,0,0,2,10,5,4,1,3,1,0,,,1,1,0,,,
"Mar 24, 2023 12:00 AM",6,0,6,0,0,0,0,0,0,2,0,2,,,,0,2,2,0,0,0,0,2,3,1,0,1,6,0,0,,,0,0,0,,,
"Mar 24, 2023 1:00 AM",2,0,2,0,0,0,0,0,0,0,0,0,,,,0,2,1,1,0,0,0,1,0,0,0,0,1,0,0,,,0,0,0,,,
"Mar 24, 2023 2:00 AM",5,5,0,0,0,0,0,0,0,0,0,0,,,,0,0,0,0,0,0,0,0,2,0,0,0,0,0,0,,,0,0,0,,,
"Mar 24, 2023 3:00 AM",1,0,1,0,0,0,1,1,0,1,1,0,,,,0,1,1,0,0,0,0,0,1,1,0,1,1,0,0,,,0,0,0,,,
"Mar 24, 2023 4:00 AM",5,1,4,0,0,0,0,0,0,1,0,1,,,,0,2,2,0,0,0,0,3,1,0,0,0,1,0,0,,,0,0,0,,,
"Mar 24, 2023 5:00 AM",10,6,4,1,1,0,3,1,2,1,1,0,,,,1,4,4,0,0,0,0,5,3,0,0,0,8,0,0,,,0,0,0,,,
"Mar 24, 2023 6:00 AM",39,21,18,18,11,7,20,11,9,16,10,6,,,,5,14,14,0,0,0,0,13,13,4,3,1,20,0,2,,,2,1,1,,,
"Mar 24, 2023 7:00 AM",106,71,35,57,26,31,60,19,41,42,24,18,,,,11,54,54,0,0,0,0,48,22,20,7,13,76,4,2,,,4,2,2,,,
"Mar 24, 2023 8:00 AM",163,128,35,73,23,50,105,30,75,74,31,43,,,,27,112,108,4,0,0,0,90,38,52,17,35,116,6,2,,,24,20,4,,,
"Mar 24, 2023 9:00 AM",91,67,24,53,21,32,74,37,37,60,32,28,,,,8,46,46,0,0,0,0,35,33,34,11,23,52,4,5,,,2,2,0,,,
"Mar 24, 2023 10:00 AM",45,25,20,36,17,19,53,30,23,28,15,13,,,,6,29,28,1,0,0,0,25,11,21,13,8,26,1,5,,,3,3,0,,,
"Mar 24, 2023 11:00 AM",47,30,17,56,28,28,54,31,23,48,28,20,,,,9,20,19,1,0,0,0,14,7,13,10,3,14,1,3,,,3,2,1,,,
"Mar 24, 2023 12:00 PM",46,27,19,45,20,25,58,31,27,37,20,17,,,,5,15,14,1,0,0,0,11,16,26,13,13,29,1,1,,,2,1,1,,,
"Mar 24, 2023 1:00 PM",66,25,41,54,26,28,65,34,31,52,28,24,,,,3,18,18,0,0,0,0,14,17,28,21,7,30,3,2,,,4,2,2,,,
"Mar 24, 2023 2:00 PM",50,25,25,35,21,14,33,17,16,23,13,10,,,,11,15,10,5,0,0,0,13,24,12,6,6,14,1,1,,,3,0,3,,,
"Mar 24, 2023 3:00 PM",57,22,35,29,20,9,34,20,14,24,19,5,,,,11,14,11,3,0,0,0,8,30,11,5,6,16,2,3,,,0,0,0,,,
"Mar 24, 2023 4:00 PM",91,30,61,36,28,8,41,29,12,35,25,10,,,,5,30,24,6,0,0,0,15,37,23,14,9,27,2,2,,,4,3,1,,,
"Mar 24, 2023 5:00 PM",117,35,82,33,20,13,54,34,20,40,20,20,,,,15,25,21,4,0,0,0,24,60,28,16,12,35,1,4,,,6,4,2,,,
"Mar 24, 2023 6:00 PM",115,34,81,39,24,15,48,33,15,35,22,13,,,,18,21,18,3,0,0,0,14,39,31,23,8,28,2,1,,,2,0,2,,,
"Mar 24, 2023 7:00 PM",66,26,40,20,16,4,26,18,8,17,10,7,,,,6,16,8,8,0,0,0,12,20,14,11,3,19,3,1,,,2,1,1,,,
"Mar 24, 2023 8:00 PM",38,8,30,12,5,7,15,12,3,12,11,1,,,,3,8,6,2,0,0,0,8,21,7,3,4,5,1,0,,,3,3,0,,,
"Mar 24, 2023 9:00 PM",29,7,22,13,12,1,12,10,2,6,6,0,,,,1,3,2,1,0,0,0,2,10,4,2,2,9,2,1,,,1,1,0,,,
"Mar 24, 2023 10:00 PM",29,9,20,8,7,1,5,3,2,5,2,3,,,,2,9,7,2,0,0,0,7,8,1,1,0,8,0,0,,,3,2,1,,,
"Mar 24, 2023 11:00 PM",13,2,11,4,4,0,5,3,2,3,2,1,,,,5,6,6,0,0,0,0,6,8,2,1,1,1,1,0,,,2,1,1,,,
"Mar 25, 2023 12:00 AM",11,0,11,0,0,0,1,1,0,1,1,0,,,,0,3,3,0,0,0,0,1,6,0,0,0,1,1,0,,,0,0,0,,,
"Mar 25, 2023 1:00 AM",7,0,7,1,1,0,1,0,1,0,0,0,,,,0,0,0,0,0,0,0,0,2,1,0,1,2,0,0,,,0,0,0,,,
"Mar 25, 2023 2:00 AM",6,5,1,0,0,0,0,0,0,0,0,0,,,,0,1,1,0,0,0,0,1,1,0,0,0,1,0,0,,,0,0,0,,,
"Mar 25, 2023 3:00 AM",3,1,2,0,0,0,0,0,0,0,0,0,,,,1,0,0,0,0,0,0,1,1,0,0,0,1,0,0,,,0,0,0,,,
"Mar 25, 2023 4:00 AM",5,1,4,1,0,1,2,2,0,1,0,1,,,,2,1,0,1,0,0,0,0,2,0,0,0,0,0,0,,,0,0,0,,,
"Mar 25, 2023 5:00 AM",4,2,2,0,0,0,1,0,1,1,0,1,,,,1,2,2,0,0,0,0,2,3,0,0,0,3,0,0,,,0,0,0,,,
"Mar 25, 2023 6:00 AM",12,5,7,5,3,2,8,5,3,5,3,2,,,,1,3,3,0,0,0,0,2,7,1,1,0,5,0,0,,,0,0,0,,,
"Mar 25, 2023 7:00 AM",14,6,8,29,15,14,32,20,12,27,18,9,,,,9,4,4,0,0,0,0,5,11,8,5,3,15,1,0,,,2,2,0,,,
"Mar 25, 2023 8:00 AM",39,18,21,56,31,25,50,27,23,47,27,20,,,,15,17,16,1,0,0,0,15,17,13,11,2,25,5,6,,,6,2,4,,,
"Mar 25, 2023 9:00 AM",60,39,21,86,43,43,79,51,28,70,50,20,,,,17,21,21,0,0,0,0,19,24,36,23,13,30,2,11,,,6,5,1,,,
"Mar 25, 2023 10:00 AM",62,42,20,97,40,57,107,54,53,91,53,38,,,,13,23,23,0,0,0,0,17,33,51,21,30,31,8,10,,,4,4,0,,,
"Mar 25, 2023 11:00 AM",51,30,21,115,61,54,129,80,49,104,62,42,,,,5,22,18,4,0,0,0,17,33,36,19,17,21,2,2,,,8,5,3,,,
"Mar 25, 2023 12:00 PM",51,23,28,122,62,60,133,66,67,123,70,53,,,,18,11,11,0,0,0,0,8,26,56,23,33,31,3,3,,,10,5,5,,,
"Mar 25, 2023 1:00 PM",57,34,23,111,42,69,108,50,58,84,37,47,,,,11,17,16,1,0,0,0,14,26,33,16,17,32,3,7,,,4,1,3,,,
"Mar 25, 2023 2:00 PM",48,30,18,66,40,26,80,47,33,58,36,22,,,,12,14,13,1,0,0,0,11,21,39,20,19,26,4,5,,,5,2,3,,,
"Mar 25, 2023 3:00 PM",43,26,17,54,28,26,72,33,39,50,32,18,,,,10,16,16,0,0,0,0,17,10,30,18,12,33,3,7,,,7,6,1,,,
"Mar 25, 2023 4:00 PM",47,20,27,85,46,39,61,20,41,61,18,43,,,,22,16,16,0,0,0,0,16,13,39,18,21,19,8,4,,,7,6,1,,,
"Mar 25, 2023 5:00 PM",54,23,31,56,25,31,68,27,41,48,17,31,,,,13,20,18,2,0,0,0,15,12,31,19,12,29,7,6,,,7,5,2,,,
"Mar 25, 2023 6:00 PM",51,15,36,27,13,14,51,26,25,42,19,23,,,,16,12,9,3,0,0,0,12,15,38,21,17,26,1,0,,,9,5,4,,,
"Mar 25, 2023 7:00 PM",42,20,22,17,12,5,25,8,17,12,8,4,,,,15,13,12,1,0,0,0,13,13,8,7,1,18,3,0,,,6,5,1,,,
"Mar 25, 2023 8:00 PM",38,15,23,15,12,3,13,8,5,9,7,2,,,,6,9,7,2,0,0,0,7,10,2,2,0,10,2,0,,,6,2,4,,,
"Mar 25, 2023 9:00 PM",16,6,10,13,8,5,10,8,2,8,5,3,,,,3,5,5,0,0,0,0,6,4,4,2,2,10,1,0,,,2,1,1,,,
"Mar 25, 2023 10:00 PM",15,6,9,4,3,1,8,4,4,6,2,4,,,,5,4,4,0,0,0,0,3,2,2,1,1,7,0,0,,,0,0,0,,,
"Mar 25, 2023 11:00 PM",8,4,4,3,1,2,6,2,4,5,2,3,,,,6,2,2,0,0,0,0,3,6,3,1,2,3,1,0,,,1,1,0,,,
"Mar 26, 2023 12:00 AM",15,5,10,0,0,0,1,0,1,3,1,2,,,,1,2,2,0,0,0,0,1,1,1,0,1,2,0,0,,,0,0,0,,,
"Mar 26, 2023 2:00 AM",,,,,,,,,,,,,,,,,,,,,,,,,,,,,,,,,,,,,,
"Mar 26, 2023 2:00 AM",9,0,9,0,0,0,1,1,0,0,0,0,,,,2,0,0,0,0,0,0,0,3,2,2,0,5,0,0,,,0,0,0,,,
"Mar 26, 2023 3:00 AM",3,2,1,0,0,0,3,2,1,2,1,1,,,,0,1,1,0,0,0,0,1,1,1,1,0,1,0,0,,,0,0,0,,,
"Mar 26, 2023 4:00 AM",5,1,4,0,0,0,1,0,1,1,0,1,,,,0,0,0,0,0,0,0,1,0,2,2,0,0,0,0,,,0,0,0,,,
"Mar 26, 2023 5:00 AM",5,1,4,0,0,0,3,2,1,1,1,0,,,,0,0,0,0,0,0,0,0,4,2,2,0,2,0,0,,,0,0,0,,,
"Mar 26, 2023 6:00 AM",6,3,3,2,1,1,1,0,1,1,0,1,,,,3,2,2,0,0,0,0,2,5,1,1,0,4,0,0,,,1,1,0,,,
"Mar 26, 2023 7:00 AM",17,3,14,15,8,7,14,9,5,16,12,4,,,,2,4,4,0,0,0,0,4,11,3,2,1,11,0,2,,,0,0,0,,,
"Mar 26, 2023 8:00 AM",24,18,6,63,48,15,56,43,13,61,48,13,,,,5,5,5,0,0,0,0,5,14,8,7,1,13,2,4,,,3,1,2,,,
"Mar 26, 2023 9:00 AM",31,16,15,65,43,22,65,39,26,55,38,17,,,,8,11,10,1,0,0,0,5,16,11,8,3,21,0,7,,,1,0,1,,,
"Mar 26, 2023 10:00 AM",53,28,25,53,32,21,61,37,24,56,35,21,,,,9,20,18,2,0,0,0,18,21,21,10,11,38,2,2,,,3,2,1,,,
"Mar 26, 2023 11:00 AM",37,23,14,65,27,38,79,45,34,64,32,32,,,,5,13,9,4,0,0,0,5,17,33,20,13,19,6,6,,,7,4,3,,,
"Mar 26, 2023 12:00 PM",36,20,16,96,23,73,99,31,68,91,36,55,,,,6,14,12,2,0,0,0,10,4,22,11,11,42,4,3,,,3,3,0,,,
"Mar 26, 2023 1:00 PM",41,18,23,47,24,23,61,30,31,38,20,18,,,,7,18,18,0,0,0,0,16,16,39,22,17,16,6,2,,,5,2,3,,,
"Mar 26, 2023 2:00 PM",41,25,16,70,31,39,76,47,29,65,38,27,,,,7,15,14,1,0,0,0,11,11,28,13,15,22,3,0,,,4,2,2,,,
"Mar 26, 2023 3:00 PM",35,19,16,57,31,26,61,30,31,68,36,32,,,,7,15,15,0,0,0,0,13,16,39,22,17,17,5,0,,,5,4,1,,,
"Mar 26, 2023 4:00 PM",29,14,15,68,30,38,79,27,52,71,25,46,,,,18,12,11,1,0,0,0,9,15,45,14,31,24,2,4,,,1,0,1,,,
"Mar 26, 2023 5:00 PM",48,19,29,67,32,35,70,33,37,56,26,30,,,,13,14,13,1,0,0,0,10,8,32,13,19,24,3,1,,,2,1,1,,,
"Mar 26, 2023 6:00 PM",35,11,24,58,36,22,41,21,20,41,19,22,,,,13,11,10,1,0,0,0,13,11,16,6,10,20,2,0,,,5,3,2,,,
"Mar 26, 2023 7:00 PM",39,23,16,19,7,12,17,5,12,16,5,11,,,,7,12,11,1,0,0,0,11,8,7,3,4,10,1,0,,,5,3,2,,,
"Mar 26, 2023 8:00 PM",31,11,20,11,6,5,14,5,9,14,7,7,,,,9,6,4,2,0,0,0,5,5,3,1,2,12,0,0,,,2,1,1,,,
"Mar 26, 2023 9:00 PM",25,9,16,7,4,3,17,6,11,9,3,6,,,,0,3,2,1,0,0,0,2,4,4,1,3,9,0,0,,,1,0,1,,,
"Mar 26, 2023 10:00 PM",13,5,8,1,1,0,1,1,0,3,2,1,,,,3,7,7,0,0,0,0,7,3,0,0,0,3,0,1,,,2,1,1,,,
"Mar 26, 2023 11:00 PM",13,7,6,4,2,2,2,1,1,6,3,3,,,,3,2,2,0,0,0,0,3,3,1,1,0,1,1,0,,,2,0,2,,,
"Mar 27, 2023 12:00 AM",6,3,3,0,0,0,2,1,1,0,0,0,,,,0,2,1,1,0,0,0,0,1,0,0,0,2,0,0,,,1,1,0,,,
"Mar 27, 2023 1:00 AM",2,0,2,0,0,0,0,0,0,0,0,0,,,,0,0,0,0,0,0,0,0,4,1,1,0,0,0,0,,,0,0,0,,,
"Mar 27, 2023 2:00 AM",5,5,0,0,0,0,0,0,0,0,0,0,,,,0,0,0,0,0,0,0,0,0,1,1,0,0,0,0,,,0,0,0,,,
"Mar 27, 2023 3:00 AM",1,0,1,0,0,0,0,0,0,0,0,0,,,,0,0,0,0,0,0,0,0,0,0,0,0,0,0,0,,,0,0,0,,,
"Mar 27, 2023 4:00 AM",4,0,4,0,0,0,0,0,0,0,0,0,,,,0,2,2,0,0,0,0,2,0,0,0,0,4,0,0,,,0,0,0,,,
"Mar 27, 2023 5:00 AM",8,5,3,0,0,0,3,1,2,2,1,1,,,,4,8,8,0,0,0,0,7,3,1,0,1,4,0,0,,,0,0,0,,,
"Mar 27, 2023 6:00 AM",51,29,22,9,3,6,16,6,10,8,2,6,,,,5,15,15,0,0,0,0,12,5,4,2,2,33,2,3,,,2,2,0,,,
"Mar 27, 2023 7:00 AM",108,82,26,44,7,37,62,11,51,36,7,29,,,,12,72,71,1,0,0,0,66,24,26,6,20,102,3,1,,,6,6,0,,,
"Mar 27, 2023 8:00 AM",249,202,47,60,18,42,110,34,76,83,29,54,,,,42,167,164,3,0,0,0,150,51,57,20,37,205,5,1,,,13,8,5,,,
"Mar 27, 2023 9:00 AM",144,122,22,66,24,42,63,30,33,62,32,30,,,,18,86,86,0,0,0,0,60,28,38,16,22,81,3,1,,,5,4,1,,,
"Mar 27, 2023 10:00 AM",57,44,13,45,23,22,48,28,20,35,20,15,,,,12,47,42,5,0,0,0,27,6,19,10,9,27,2,2,,,0,0,0,,,
"Mar 27, 2023 11:00 AM",53,35,18,51,36,15,40,19,21,32,17,15,,,,5,25,24,1,0,0,0,19,23,14,8,6,26,2,4,,,1,0,1,,,
"Mar 27, 2023 12:00 PM",64,36,28,47,24,23,42,22,20,41,24,17,,,,4,33,31,2,0,0,0,25,15,21,11,10,18,2,7,,,4,2,2,,,
"Mar 27, 2023 1:00 PM",76,33,43,59,26,33,59,35,24,52,22,30,,,,8,29,26,3,0,0,0,17,29,23,11,12,20,2,3,,,8,5,3,,,
"Mar 27, 2023 2:00 PM",73,27,46,26,14,12,47,31,16,29,17,12,,,,21,29,25,4,0,0,0,19,22,34,23,11,25,3,4,,,9,4,5,,,
"Mar 27, 2023 3:00 PM",96,40,56,36,21,15,51,30,21,26,18,8,,,,21,20,16,4,0,0,0,10,23,33,21,12,28,2,2,,,8,5,3,,,
"Mar 27, 2023 4:00 PM",124,40,84,45,27,18,85,53,32,63,43,20,,,,18,36,30,6,0,0,0,24,63,46,37,9,42,2,5,,,13,7,6,,,
"Mar 27, 2023 5:00 PM",212,61,151,74,49,25,99,64,35,91,53,38,,,,27,50,37,13,0,0,0,34,100,80,55,25,45,8,4,,,15,7,8,,,
"Mar 27, 2023 6:00 PM",192,61,131,60,38,22,101,70,31,62,40,22,,,,23,46,31,15,0,0,0,31,115,73,46,27,42,3,5,,,9,6,3,,,
"Mar 27, 2023 7:00 PM",102,25,77,35,27,8,55,36,19,42,31,11,,,,11,20,17,3,0,0,0,15,46,13,10,3,26,4,2,,,4,4,0,,,
"Mar 27, 2023 8:00 PM",82,17,65,16,15,1,15,10,5,13,9,4,,,,3,13,10,3,0,0,0,10,21,16,8,8,17,4,2,,,7,4,3,,,
"Mar 27, 2023 9:00 PM",43,6,37,7,3,4,14,6,8,7,2,5,,,,5,7,3,4,0,0,0,2,19,7,4,3,14,3,2,,,5,4,1,,,
"Mar 27, 2023 10:00 PM",41,8,33,4,4,0,8,5,3,8,6,2,,,,3,13,7,6,0,0,0,7,13,2,2,0,8,2,0,,,1,0,1,,,
"Mar 27, 2023 11:00 PM",13,3,10,2,2,0,2,1,1,2,1,1,,,,2,2,1,1,0,0,0,2,10,1,1,0,1,1,1,,,2,1,1,,,
"Mar 28, 2023 12:00 AM",5,3,2,0,0,0,0,0,0,1,1,0,,,,0,0,0,0,0,0,0,0,3,1,1,0,3,1,0,,,0,0,0,,,
"Mar 28, 2023 1:00 AM",1,0,1,1,1,0,1,0,1,1,1,0,,,,0,0,0,0,0,0,0,0,0,1,1,0,0,0,0,,,0,0,0,,,
"Mar 28, 2023 2:00 AM",5,3,2,0,0,0,0,0,0,0,0,0,,,,0,0,0,0,0,0,0,0,1,0,0,0,0,0,0,,,0,0,0,,,
"Mar 28, 2023 3:00 AM",0,0,0,0,0,0,0,0,0,0,0,0,,,,0,0,0,0,0,0,0,0,0,0,0,0,0,0,0,,,0,0,0,,,
"Mar 28, 2023 4:00 AM",3,1,2,0,0,0,1,0,1,0,0,0,,,,0,1,1,0,0,0,0,1,0,1,0,1,4,0,0,,,0,0,0,,,
"Mar 28, 2023 5:00 AM",9,7,2,1,1,0,1,0,1,1,1,0,,,,1,6,6,0,0,0,0,6,2,1,0,1,3,0,0,,,0,0,0,,,
"Mar 28, 2023 6:00 AM",46,30,16,8,1,7,10,2,8,5,1,4,,,,7,8,8,0,0,0,0,10,9,3,1,2,22,1,3,,,1,1,0,,,
"Mar 28, 2023 7:00 AM",110,78,32,21,5,16,42,8,34,27,7,20,,,,22,46,44,2,0,0,0,41,20,18,3,15,105,3,2,,,7,7,0,,,
"Mar 28, 2023 8:00 AM",223,185,38,41,6,35,76,18,58,56,14,42,,,,26,142,141,1,0,0,0,142,41,39,13,26,166,3,5,,,14,11,3,,,
"Mar 28, 2023 9:00 AM",125,106,19,26,11,15,43,18,25,37,22,15,,,,15,82,78,4,0,0,0,57,16,16,4,12,59,0,2,,,4,3,1,,,
"Mar 28, 2023 10:00 AM",65,50,15,19,8,11,20,9,11,16,11,5,,,,17,43,39,4,0,0,0,26,10,6,2,4,18,2,0,,,3,3,0,,,
"Mar 28, 2023 11:00 AM",45,36,9,25,8,17,32,19,13,31,16,15,,,,3,20,19,1,0,0,0,10,15,12,8,4,20,0,0,,,1,1,0,,,
"Mar 28, 2023 12:00 PM",59,39,20,27,15,12,37,17,20,27,13,14,,,,4,23,19,4,0,0,0,14,12,12,5,7,21,0,0,,,1,1,0,,,
"Mar 28, 2023 1:00 PM",84,34,50,34,14,20,32,16,16,23,9,14,,,,9,30,25,5,0,0,0,23,12,14,6,8,23,3,2,,,3,1,2,,,
"Mar 28, 2023 2:00 PM",55,27,28,33,20,13,36,19,17,31,18,13,,,,20,30,24,6,0,0,0,18,21,18,9,9,24,2,2,,,6,2,4,,,
"Mar 28, 2023 3:00 PM",87,38,49,29,13,16,45,24,21,37,25,12,,,,16,19,16,3,0,0,0,15,17,19,12,7,14,1,2,,,5,4,1,,,
"Mar 28, 2023 4:00 PM",117,30,87,52,32,20,73,47,26,55,33,22,,,,18,39,33,6,0,0,0,27,63,36,20,16,14,7,4,,,9,5,4,,,
"Mar 28, 2023 5:00 PM",207,56,151,34,24,10,95,55,40,71,41,30,,,,31,37,27,10,0,0,0,28,96,44,29,15,56,5,6,,,5,3,2,,,
"Mar 28, 2023 6:00 PM",204,51,153,66,46,20,113,76,37,84,53,31,,,,19,33,30,3,0,0,0,28,107,72,48,24,30,6,2,,,5,4,1,,,
"Mar 28, 2023 7:00 PM",132,40,92,60,29,31,72,40,32,60,27,33,,,,14,26,21,5,0,0,0,19,51,43,29,14,26,7,1,,,6,4,2,,,
"Mar 28, 2023 8:00 PM",76,27,49,33,19,14,31,20,11,25,16,9,,,,11,11,9,2,0,0,0,11,29,19,10,9,21,5,1,,,10,5,5,,,
"Mar 28, 2023 9:00 PM",51,5,46,8,4,4,22,13,9,15,8,7,,,,5,7,6,1,0,0,0,5,16,8,7,1,15,2,0,,,2,2,0,,,
"Mar 28, 2023 10:00 PM",40,7,33,4,4,0,2,1,1,2,1,1,,,,4,10,5,5,0,0,0,5,7,1,1,0,7,2,0,,,1,1,0,,,
"Mar 28, 2023 11:00 PM",13,3,10,0,0,0,3,3,0,3,2,1,,,,2,3,2,1,0,0,0,1,5,0,0,0,0,1,0,,,2,1,1,,,
"Mar 29, 2023 12:00 AM",9,1,8,0,0,0,0,0,0,0,0,0,,,,0,0,0,0,0,0,0,0,4,0,0,0,3,0,0,,,2,1,1,,,
"Mar 29, 2023 1:00 AM",3,0,3,0,0,0,0,0,0,0,0,0,,,,0,0,0,0,0,0,0,0,1,1,1,0,0,0,0,,,0,0,0,,,
"Mar 29, 2023 2:00 AM",3,2,1,0,0,0,0,0,0,0,0,0,,,,0,3,2,1,0,0,0,1,1,0,0,0,1,0,0,,,0,0,0,,,
"Mar 29, 2023 3:00 AM",2,1,1,0,0,0,0,0,0,0,0,0,,,,0,0,0,0,0,0,0,0,1,0,0,0,0,0,0,,,0,0,0,,,
"Mar 29, 2023 4:00 AM",4,2,2,0,0,0,0,0,0,0,0,0,,,,0,3,3,0,0,0,0,3,0,1,1,0,1,0,0,,,0,0,0,,,
"Mar 29, 2023 5:00 AM",8,6,2,1,1,0,2,1,1,0,0,0,,,,1,5,5,0,0,0,0,6,1,1,0,1,4,1,0,,,1,1,0,,,
"Mar 29, 2023 6:00 AM",48,32,16,22,10,12,30,12,18,20,10,10,,,,8,9,9,0,0,0,0,7,16,6,1,5,33,0,2,,,0,0,0,,,
"Mar 29, 2023 7:00 AM",115,85,30,40,8,32,78,15,63,50,12,38,,,,15,83,83,0,0,0,0,72,25,28,7,21,127,3,5,,,6,5,1,,,
"Mar 29, 2023 8:00 AM",279,221,58,54,20,34,113,38,75,77,35,42,,,,41,206,200,6,0,0,0,183,53,69,16,53,214,3,12,,,17,13,4,,,
"Mar 29, 2023 9:00 AM",141,116,25,35,10,25,57,24,33,53,29,24,,,,12,78,78,0,0,0,0,57,19,42,12,30,59,5,6,,,4,3,1,,,
"Mar 29, 2023 10:00 AM",66,52,14,31,11,20,35,14,21,19,10,9,,,,13,39,37,2,0,0,0,21,9,15,5,10,24,1,1,,,1,0,1,,,
"Mar 29, 2023 11:00 AM",47,26,21,13,6,7,15,12,3,9,6,3,,,,3,22,17,5,0,0,0,16,12,12,9,3,12,4,0,,,4,4,0,,,
"Mar 29, 2023 12:00 PM",50,26,24,10,5,5,25,14,11,16,7,9,,,,3,20,20,0,0,0,0,16,22,12,11,1,23,3,0,,,4,3,1,,,
"Mar 29, 2023 1:00 PM",60,33,27,50,28,22,47,27,20,39,25,14,,,,6,32,28,4,0,0,0,23,34,27,16,11,26,0,6,,,3,2,1,,,
"Mar 29, 2023 2:00 PM",51,18,33,23,12,11,38,22,16,21,13,8,,,,15,21,18,3,0,0,0,15,25,32,19,13,33,1,2,,,9,3,6,,,
"Mar 29, 2023 3:00 PM",87,32,55,34,22,12,49,35,14,37,28,9,,,,19,25,18,7,0,0,0,13,28,24,17,7,21,2,4,,,5,3,2,,,
"Mar 29, 2023 4:00 PM",117,32,85,35,16,19,53,22,31,43,22,21,,,,27,40,30,10,0,0,0,25,54,31,22,9,29,7,1,,,7,4,3,,,
"Mar 29, 2023 5:00 PM",243,57,186,87,54,33,122,84,38,80,55,25,,,,24,51,41,10,0,0,0,38,111,77,60,17,58,7,7,,,10,6,4,,,
"Mar 29, 2023 6:00 PM",190,43,147,89,53,36,140,99,41,91,57,34,,,,15,36,27,9,0,0,0,24,119,79,56,23,30,9,4,,,9,3,6,,,
"Mar 29, 2023 7:00 PM",114,30,84,57,36,21,96,57,39,69,37,32,,,,24,34,26,8,0,0,0,21,62,45,30,15,35,1,5,,,5,3,2,,,
"Mar 29, 2023 8:00 PM",82,18,64,33,16,17,49,24,25,36,18,18,,,,11,19,16,3,0,0,0,15,35,24,13,11,16,5,1,,,4,2,2,,,
"Mar 29, 2023 9:00 PM",74,17,57,9,7,2,15,6,9,13,5,8,,,,8,14,11,3,0,0,0,11,21,7,4,3,15,5,2,,,2,2,0,,,
"Mar 29, 2023 10:00 PM",44,12,32,7,3,4,10,8,2,6,3,3,,,,2,6,4,2,0,0,0,6,21,4,2,2,5,1,0,,,4,0,4,,,
"Mar 29, 2023 11:00 PM",23,3,20,1,1,0,2,2,0,3,3,0,,,,2,4,4,0,0,0,0,4,4,2,2,0,4,1,0,,,2,2,0,,,
"Mar 30, 2023 12:00 AM",6,0,6,0,0,0,2,2,0,5,2,3,,,,0,1,1,0,0,0,0,1,4,1,1,0,0,0,1,,,0,0,0,,,
"Mar 30, 2023 1:00 AM",1,1,0,1,1,0,0,0,0,0,0,0,,,,0,1,1,0,0,0,0,1,1,0,0,0,2,0,0,,,0,0,0,,,
"Mar 30, 2023 2:00 AM",2,1,1,0,0,0,2,1,1,0,0,0,,,,0,0,0,0,0,0,0,0,0,0,0,0,1,0,0,,,0,0,0,,,
"Mar 30, 2023 3:00 AM",0,0,0,0,0,0,1,0,1,0,0,0,,,,0,0,0,0,0,0,0,0,2,0,0,0,0,0,0,,,0,0,0,,,
"Mar 30, 2023 4:00 AM",3,1,2,0,0,0,0,0,0,0,0,0,,,,0,4,3,1,0,0,0,3,0,1,0,1,1,0,0,,,1,1,0,,,
"Mar 30, 2023 5:00 AM",7,6,1,1,0,1,1,0,1,0,0,0,,,,1,6,6,0,0,0,0,7,1,0,0,0,5,2,0,,,1,1,0,,,
"Mar 30, 2023 6:00 AM",49,32,17,16,7,9,23,12,11,15,10,5,0,0,0,7,19,19,0,0,0,0,16,21,1,0,1,25,0,5,,,0,0,0,,,
"Mar 30, 2023 7:00 AM",114,77,37,39,8,31,77,23,54,47,16,31,0,0,0,19,68,67,1,0,0,0,64,36,38,12,26,105,4,4,,,7,5,2,,,
"Mar 30, 2023 8:00 AM",278,220,58,91,26,65,158,44,114,92,28,64,0,0,0,37,187,186,1,0,0,0,145,43,81,13,68,220,10,8,,,16,15,1,,,
"Mar 30, 2023 9:00 AM",129,106,23,57,19,38,84,30,54,60,31,29,0,0,0,14,89,86,3,0,0,0,63,25,46,10,36,78,2,3,,,3,3,0,,,
"Mar 30, 2023 10:00 AM",69,57,12,49,25,24,60,33,27,45,27,18,8,7,1,14,45,41,4,0,0,0,29,23,27,13,14,37,4,3,,,3,2,1,,,
"Mar 30, 2023 11:00 AM",49,40,9,69,41,28,51,29,22,76,42,34,19,11,8,7,28,26,2,0,0,0,17,13,18,6,12,25,0,2,,,2,2,0,,,
"Mar 30, 2023 12:00 PM",62,34,28,41,22,19,48,22,26,43,21,22,13,9,4,13,30,28,2,0,0,0,15,26,23,11,12,27,2,5,,,1,0,1,,,
"Mar 30, 2023 1:00 PM",63,35,28,71,23,48,47,21,26,40,17,23,4,2,2,10,36,25,11,0,0,0,15,32,35,19,16,23,7,3,,,5,5,0,,,
"Mar 30, 2023 2:00 PM",64,34,30,42,23,19,48,28,20,48,27,21,0,0,0,11,29,21,8,0,0,0,18,24,19,12,7,19,3,7,,,7,6,1,,,
"Mar 30, 2023 3:00 PM",79,32,47,46,27,19,57,34,23,43,28,15,2,2,0,15,25,17,8,0,0,0,17,30,33,20,13,29,5,0,,,3,1,2,,,
"Mar 30, 2023 4:00 PM",139,38,101,57,23,34,88,48,40,75,29,46,4,2,2,15,25,17,8,0,0,0,16,60,48,21,27,42,5,6,,,8,5,3,,,
"Mar 30, 2023 5:00 PM",210,51,159,84,58,26,123,81,42,78,54,24,0,0,0,41,44,32,12,0,0,0,28,120,70,48,22,49,3,5,,,10,7,3,,,
"Mar 30, 2023 6:00 PM",207,58,149,92,59,33,127,87,40,109,64,45,0,0,0,18,42,33,9,0,0,0,34,110,91,62,29,45,5,9,,,7,5,2,,,
"Mar 30, 2023 7:00 PM",134,37,97,56,30,26,72,36,36,57,29,28,0,0,0,15,16,14,2,0,0,0,13,58,38,14,24,28,6,3,,,11,10,1,,,
"Mar 30, 2023 8:00 PM",95,33,62,24,17,7,31,19,12,26,17,9,0,0,0,12,25,21,4,0,0,0,14,31,18,11,7,23,7,2,,,4,4,0,,,
"Mar 30, 2023 9:00 PM",59,10,49,5,4,1,13,6,7,10,6,4,4,3,1,3,8,5,3,0,0,0,6,22,12,6,6,11,1,0,,,1,0,1,,,
"Mar 30, 2023 10:00 PM",55,10,45,8,7,1,12,9,3,8,5,3,0,0,0,5,6,3,3,0,0,0,3,8,4,3,1,6,0,1,,,2,1,1,,,
"Mar 30, 2023 11:00 PM",22,6,16,4,3,1,2,2,0,2,1,1,0,0,0,2,3,2,1,0,0,0,3,8,1,1,0,2,0,1,,,1,0,1,,,
"Mar 31, 2023 12:00 AM",12,1,11,0,0,0,0,0,0,2,2,0,,,,1,5,5,0,0,0,0,4,5,3,3,0,3,0,1,,,0,0,0,,,
"Mar 31, 2023 1:00 AM",3,0,3,0,0,0,1,1,0,1,1,0,,,,0,3,2,1,0,0,0,1,3,0,0,0,1,0,0,,,1,1,0,,,
"Mar 31, 2023 2:00 AM",6,4,2,0,0,0,0,0,0,0,0,0,,,,0,1,1,0,0,0,0,1,0,0,0,0,0,0,0,,,0,0,0,,,
"Mar 31, 2023 3:00 AM",0,0,0,0,0,0,1,1,0,0,0,0,,,,0,0,0,0,0,0,0,0,1,0,0,0,0,0,0,,,0,0,0,,,
"Mar 31, 2023 4:00 AM",4,1,3,0,0,0,0,0,0,0,0,0,,,,0,3,2,1,0,0,0,2,0,0,0,0,2,0,0,,,0,0,0,,,
"Mar 31, 2023 5:00 AM",6,3,3,2,1,1,2,1,1,2,1,1,,,,1,7,7,0,0,0,0,7,1,1,0,1,6,0,0,,,0,0,0,,,
"Mar 31, 2023 6:00 AM",30,18,12,13,7,6,15,10,5,8,6,2,,,,5,7,7,0,0,0,0,5,13,3,3,0,21,0,1,,,0,0,0,,,
"Mar 31, 2023 7:00 AM",77,42,35,37,16,21,46,14,32,30,14,16,,,,13,42,42,0,0,0,0,38,21,16,5,11,67,5,2,,,7,4,3,,,
"Mar 31, 2023 8:00 AM",134,103,31,53,17,36,82,27,55,50,22,28,,,,29,90,86,4,0,0,0,69,35,45,12,33,103,3,1,,,10,8,2,,,
"Mar 31, 2023 9:00 AM",95,74,21,30,13,17,42,21,21,37,23,14,,,,7,55,55,0,0,0,0,46,22,21,6,15,35,2,2,,,3,3,0,,,
"Mar 31, 2023 10:00 AM",58,43,15,33,9,24,38,15,23,27,10,17,,,,7,23,22,1,0,0,0,13,16,12,6,6,15,0,1,,,4,2,2,,,
"Mar 31, 2023 11:00 AM",48,23,25,23,12,11,28,17,11,22,13,9,,,,10,22,20,2,0,0,0,15,12,6,4,2,19,4,2,,,3,3,0,,,
"Mar 31, 2023 12:00 PM",58,24,34,22,10,12,29,12,17,15,9,6,,,,10,13,13,0,0,0,0,8,9,19,10,9,29,2,1,,,8,2,6,,,
"Mar 31, 2023 1:00 PM",65,34,31,20,15,5,28,20,8,22,13,9,,,,11,24,21,3,0,0,0,15,22,15,8,7,18,0,4,,,8,2,6,,,
"Mar 31, 2023 2:00 PM",67,37,30,24,7,17,28,15,13,21,12,9,,,,5,18,16,2,0,0,0,12,15,10,4,6,13,2,0,,,4,4,0,,,
"Mar 31, 2023 3:00 PM",55,19,36,11,6,5,22,12,10,10,6,4,,,,7,16,10,6,0,0,0,9,26,5,2,3,15,2,2,,,5,2,3,,,
"Mar 31, 2023 4:00 PM",77,20,57,18,13,5,30,18,12,21,14,7,,,,12,19,14,5,0,0,0,12,38,12,11,1,18,1,2,,,2,2,0,,,
"Mar 31, 2023 5:00 PM",102,28,74,18,16,2,32,19,13,26,17,9,,,,12,15,9,6,0,0,0,8,43,16,11,5,27,2,2,,,3,2,1,,,
"Mar 31, 2023 6:00 PM",87,24,63,12,9,3,25,18,7,21,13,8,,,,15,13,8,5,0,0,0,6,28,18,14,4,15,0,0,,,2,1,1,,,
"Mar 31, 2023 7:00 PM",67,24,43,12,12,0,21,18,3,10,10,0,,,,7,5,4,1,0,0,0,2,24,11,7,4,6,0,2,,,2,2,0,,,
"Mar 31, 2023 8:00 PM",39,9,30,5,3,2,12,8,4,6,5,1,,,,4,5,3,2,0,0,0,2,14,3,3,0,13,0,1,,,2,0,2,,,
"Mar 31, 2023 9:00 PM",31,9,22,1,1,0,9,6,3,3,2,1,,,,3,7,6,1,0,0,0,5,14,6,5,1,6,1,0,,,1,1,0,,,
"Mar 31, 2023 10:00 PM",18,9,9,3,2,1,5,4,1,4,3,1,,,,4,3,3,0,0,0,0,4,3,5,5,0,8,0,0,,,1,0,1,,,
"Mar 31, 2023 11:00 PM",22,9,13,2,2,0,5,3,2,2,1,1,,,,3,5,4,1,0,0,0,4,3,1,1,0,3,0,0,,,1,0,1,,,
"Apr 1, 2023 12:00 AM",4,0,4,0,0,0,1,1,0,6,3,3,,,,1,3,3,0,0,0,0,3,2,1,0,1,0,0,0,,,1,1,0,,,
"Apr 1, 2023 1:00 AM",9,1,8,3,2,1,3,1,2,2,0,2,,,,1,0,0,0,0,0,0,0,4,2,2,0,4,0,0,,,0,0,0,,,
"Apr 1, 2023 2:00 AM",6,4,2,0,0,0,1,1,0,0,0,0,,,,0,0,0,0,0,0,0,0,0,0,0,0,1,0,0,,,0,0,0,,,
"Apr 1, 2023 3:00 AM",2,1,1,0,0,0,0,0,0,0,0,0,,,,0,0,0,0,0,0,0,0,3,0,0,0,1,0,0,,,0,0,0,,,
"Apr 1, 2023 4:00 AM",2,0,2,0,0,0,0,0,0,0,0,0,,,,0,0,0,0,0,0,0,0,1,0,0,0,2,0,0,,,0,0,0,,,
"Apr 1, 2023 5:00 AM",1,0,1,0,0,0,0,0,0,1,0,1,,,,1,0,0,0,0,0,0,0,1,0,0,0,1,0,0,,,0,0,0,,,
"Apr 1, 2023 6:00 AM",3,1,2,1,1,0,1,0,1,1,0,1,,,,1,3,3,0,0,0,0,3,1,0,0,0,4,2,0,,,3,2,1,,,
"Apr 1, 2023 7:00 AM",12,4,8,7,4,3,9,7,2,11,8,3,,,,1,4,4,0,0,0,0,5,3,3,2,1,6,1,1,,,0,0,0,,,
"Apr 1, 2023 8:00 AM",17,8,9,16,7,9,15,11,4,12,9,3,,,,6,5,4,1,0,0,0,4,5,3,2,1,6,1,0,,,4,1,3,,,
"Apr 1, 2023 9:00 AM",25,17,8,20,8,12,32,20,12,24,15,9,,,,2,6,6,0,0,0,0,5,8,7,3,4,9,1,4,,,6,4,2,,,
"Apr 1, 2023 10:00 AM",19,10,9,14,7,7,14,6,8,19,13,6,,,,7,6,6,0,0,0,0,6,6,7,4,3,10,2,2,,,1,1,0,,,
"Apr 1, 2023 11:00 AM",23,11,12,14,5,9,27,15,12,10,4,6,,,,5,10,10,0,0,0,0,6,9,5,5,0,9,0,4,,,11,6,5,,,
"Apr 1, 2023 12:00 PM",38,22,16,20,6,14,15,5,10,12,7,5,,,,9,9,8,1,0,0,0,7,5,13,10,3,16,1,3,,,5,1,4,,,
"Apr 1, 2023 1:00 PM",32,15,17,39,21,18,28,10,18,20,10,10,,,,7,15,14,1,0,0,0,9,15,20,12,8,11,1,1,,,8,5,3,,,
"Apr 1, 2023 2:00 PM",36,20,16,57,34,23,56,35,21,35,26,9,,,,11,14,12,2,0,0,0,13,13,24,14,10,17,4,5,,,11,9,2,,,
"Apr 1, 2023 3:00 PM",37,18,19,47,23,24,52,22,30,51,24,27,,,,17,22,20,2,0,0,0,14,8,25,12,13,17,8,2,,,7,3,4,,,
"Apr 1, 2023 4:00 PM",45,23,22,51,26,25,49,28,21,37,23,14,,,,7,10,10,0,0,0,0,10,8,16,7,9,21,3,4,,,4,2,2,,,
"Apr 1, 2023 5:00 PM",29,11,18,17,8,9,16,4,12,12,3,9,,,,6,8,7,1,0,0,0,8,7,7,4,3,11,4,2,,,5,2,3,,,
"Apr 1, 2023 6:00 PM",18,8,10,4,4,0,9,5,4,5,1,4,,,,10,7,4,3,0,0,0,4,5,2,2,0,10,0,3,,,2,2,0,,,
"Apr 1, 2023 7:00 PM",25,9,16,7,5,2,6,4,2,5,3,2,,,,3,7,5,2,0,0,0,4,5,6,4,2,6,1,0,,,2,0,2,,,
"Apr 1, 2023 8:00 PM",24,11,13,2,2,0,9,7,2,4,3,1,,,,0,2,1,1,0,0,0,1,9,3,2,1,5,0,1,,,2,1,1,,,
"Apr 1, 2023 9:00 PM",16,6,10,5,4,1,8,5,3,5,4,1,,,,1,5,4,1,0,0,0,4,1,2,2,0,5,1,0,,,1,0,1,,,
"Apr 1, 2023 10:00 PM",11,7,4,0,0,0,8,7,1,2,2,0,,,,3,5,4,1,0,0,0,4,4,4,4,0,5,0,1,,,1,0,1,,,
"Apr 1, 2023 11:00 PM",14,10,4,1,1,0,6,3,3,5,4,1,,,,4,2,2,0,0,0,0,2,4,3,3,0,0,1,0,,,2,1,1,,,
"Apr 2, 2023 12:00 AM",2,1,1,0,0,0,1,1,0,3,0,3,,,,0,2,1,1,0,0,0,1,3,1,1,0,3,0,0,,,3,2,1,,,
"Apr 2, 2023 1:00 AM",8,4,4,1,1,0,5,3,2,3,3,0,,,,0,0,0,0,0,0,0,0,7,0,0,0,6,0,0,,,0,0,0,,,
"Apr 2, 2023 2:00 AM",6,4,2,1,1,0,2,2,0,0,0,0,,,,0,1,1,0,0,0,0,1,1,1,1,0,1,0,0,,,0,0,0,,,
"Apr 2, 2023 3:00 AM",1,0,1,1,0,1,1,0,1,1,0,1,,,,0,0,0,0,0,0,0,2,1,0,0,0,1,0,0,,,0,0,0,,,
"Apr 2, 2023 4:00 AM",1,1,0,0,0,0,2,2,0,0,0,0,,,,0,1,0,1,0,0,0,0,2,0,0,0,0,0,0,,,0,0,0,,,
"Apr 2, 2023 5:00 AM",7,2,5,1,1,0,1,0,1,1,1,0,,,,1,0,0,0,0,0,0,0,2,0,0,0,1,0,0,,,0,0,0,,,
"Apr 2, 2023 6:00 AM",6,3,3,5,1,4,6,3,3,5,2,3,,,,3,1,1,0,0,0,0,1,5,1,1,0,7,0,0,,,0,0,0,,,
"Apr 2, 2023 7:00 AM",14,9,5,19,6,13,19,10,9,20,11,9,,,,2,4,4,0,0,0,0,4,14,6,3,3,14,0,2,,,2,1,1,,,
"Apr 2, 2023 8:00 AM",50,18,32,37,21,16,50,26,24,41,22,19,,,,7,10,10,0,0,0,0,9,16,20,7,13,21,2,8,,,3,1,2,,,
"Apr 2, 2023 9:00 AM",47,22,25,109,75,34,102,75,27,102,77,25,,,,6,14,14,0,0,0,0,14,29,33,19,14,30,3,16,,,6,3,3,,,
"Apr 2, 2023 10:00 AM",49,29,20,143,62,81,136,85,51,122,59,63,,,,11,26,21,5,0,0,0,18,32,62,36,26,39,4,8,,,3,1,2,,,
"Apr 2, 2023 11:00 AM",42,27,15,130,68,62,156,78,78,113,64,49,,,,9,21,21,0,0,0,0,20,29,54,36,18,34,7,3,,,8,6,2,,,
"Apr 2, 2023 12:00 PM",64,35,29,182,77,105,165,89,76,147,77,70,0,0,0,12,30,28,2,0,0,0,24,35,59,35,24,48,9,3,,,12,9,3,,,
"Apr 2, 2023 1:00 PM",66,27,39,138,68,70,157,71,86,124,67,57,,,,27,17,16,1,0,0,0,14,33,65,39,26,49,18,5,,,12,9,3,,,
"Apr 2, 2023 2:00 PM",66,41,25,152,84,68,134,76,58,115,61,54,,,,20,28,23,5,0,0,0,20,38,60,40,20,32,5,5,,,7,6,1,,,
"Apr 2, 2023 3:00 PM",56,21,35,185,81,104,167,82,85,161,84,77,,,,20,15,15,0,0,0,0,14,32,73,37,36,35,7,4,,,7,5,2,,,
"Apr 2, 2023 4:00 PM",60,27,33,132,65,67,146,67,79,120,58,62,,,,15,20,18,2,0,0,0,13,31,69,37,32,35,2,2,,,6,2,4,,,
"Apr 2, 2023 5:00 PM",56,26,30,83,39,44,106,32,74,85,31,54,,,,15,17,17,0,0,0,0,12,25,52,33,19,47,4,1,,,9,8,1,,,
"Apr 2, 2023 6:00 PM",48,14,34,65,30,35,83,39,44,58,25,33,,,,14,13,9,4,0,0,0,7,19,27,17,10,34,6,4,,,8,3,5,,,
"Apr 2, 2023 7:00 PM",44,23,21,39,20,19,37,18,19,27,12,15,,,,13,10,9,1,0,0,0,8,14,20,7,13,16,4,1,,,4,1,3,,,
"Apr 2, 2023 8:00 PM",31,10,21,19,12,7,28,12,16,13,6,7,,,,6,10,8,2,0,0,0,6,7,5,2,3,17,1,0,,,6,4,2,,,
"Apr 2, 2023 9:00 PM",22,12,10,5,2,3,14,3,11,4,1,3,,,,7,7,7,0,0,0,0,8,4,4,4,0,4,1,0,,,0,0,0,,,
"Apr 2, 2023 10:00 PM",15,7,8,3,2,1,3,2,1,3,1,2,0,0,0,4,5,5,0,0,0,0,6,5,2,2,0,6,0,1,,,1,0,1,,,
"Apr 2, 2023 11:00 PM",12,5,7,2,2,0,6,0,6,5,1,4,,,,2,0,0,0,0,0,0,0,4,0,0,0,4,3,0,,,1,1,0,,,
"Apr 3, 2023 12:00 AM",3,2,1,0,0,0,0,0,0,0,0,0,,,,0,2,1,1,0,0,0,1,0,1,1,0,0,0,0,,,0,0,0,,,
"Apr 3, 2023 1:00 AM",2,1,1,0,0,0,2,0,2,0,0,0,,,,0,0,0,0,0,0,0,0,1,0,0,0,0,0,0,,,0,0,0,,,
"Apr 3, 2023 2:00 AM",3,2,1,0,0,0,1,1,0,0,0,0,,,,1,0,0,0,0,0,0,0,1,1,1,0,0,0,0,,,0,0,0,,,
"Apr 3, 2023 3:00 AM",0,0,0,0,0,0,0,0,0,0,0,0,,,,0,0,0,0,0,0,0,0,0,0,0,0,0,0,0,,,0,0,0,,,
"Apr 3, 2023 4:00 AM",3,0,3,0,0,0,0,0,0,0,0,0,,,,0,2,2,0,0,0,0,2,0,0,0,0,1,0,0,,,1,1,0,,,
"Apr 3, 2023 5:00 AM",6,5,1,3,1,2,2,0,2,1,1,0,,,,2,5,5,0,0,0,0,4,1,1,0,1,3,0,0,,,0,0,0,,,
"Apr 3, 2023 6:00 AM",36,27,9,13,4,9,15,3,12,8,2,6,,,,6,17,16,1,0,0,0,17,11,2,1,1,21,2,4,,,2,2,0,,,
"Apr 3, 2023 7:00 AM",95,63,32,55,17,38,67,23,44,54,18,36,,,,15,88,88,0,0,0,0,84,29,29,9,20,114,3,4,,,3,1,2,,,
"Apr 3, 2023 8:00 AM",238,191,47,62,14,48,92,27,65,69,28,41,,,,14,150,150,0,0,0,0,136,41,44,10,34,166,3,4,,,4,2,2,,,
"Apr 3, 2023 9:00 AM",143,114,29,37,10,27,76,33,43,62,33,29,,,,12,76,75,1,0,0,0,50,15,41,11,30,67,0,2,,,4,2,2,,,
"Apr 3, 2023 10:00 AM",63,54,9,31,13,18,53,30,23,45,28,17,,,,8,44,42,2,0,0,0,21,13,30,16,14,32,1,2,,,2,1,1,,,
"Apr 3, 2023 11:00 AM",51,39,12,38,17,21,50,23,27,33,14,19,,,,9,32,30,2,0,0,0,26,18,16,10,6,17,1,4,,,7,6,1,,,
"Apr 3, 2023 12:00 PM",54,30,24,33,19,14,39,24,15,26,17,9,,,,12,26,24,2,0,0,0,14,17,10,4,6,27,1,7,,,1,1,0,,,
"Apr 3, 2023 1:00 PM",81,45,36,61,26,35,47,20,27,41,20,21,,,,6,15,11,4,0,0,0,8,20,23,10,13,18,3,3,,,1,1,0,,,
"Apr 3, 2023 2:00 PM",68,27,41,47,20,27,31,14,17,34,18,16,,,,16,25,19,6,0,0,0,13,11,12,6,6,20,4,2,,,5,4,1,,,
"Apr 3, 2023 3:00 PM",69,26,43,36,16,20,47,24,23,39,20,19,,,,13,20,15,5,0,0,0,8,29,14,9,5,24,3,2,,,2,2,0,,,
"Apr 3, 2023 4:00 PM",111,28,83,50,38,12,71,48,23,77,44,33,,,,22,27,19,8,0,0,0,20,48,48,28,20,31,8,5,,,7,7,0,,,
"Apr 3, 2023 5:00 PM",206,62,144,81,54,27,113,77,36,92,55,37,,,,26,38,24,14,0,0,0,22,94,57,39,18,43,7,5,,,9,6,3,,,
"Apr 3, 2023 6:00 PM",186,36,150,81,46,35,124,85,39,89,52,37,,,,29,33,25,8,0,0,0,21,120,68,50,18,27,4,5,,,7,5,2,,,
"Apr 3, 2023 7:00 PM",123,29,94,48,32,16,86,52,34,58,38,20,,,,13,25,16,9,0,0,0,15,35,50,35,15,29,6,5,,,8,5,3,,,
"Apr 3, 2023 8:00 PM",84,12,72,19,12,7,37,20,17,29,11,18,0,,0,10,20,19,1,0,0,0,17,26,14,7,7,6,7,5,,,5,4,1,,,
"Apr 3, 2023 9:00 PM",52,9,43,10,7,3,20,9,11,10,3,7,,,,7,14,12,2,0,0,0,13,13,10,4,6,8,3,0,,,3,2,1,,,
"Apr 3, 2023 10:00 PM",35,6,29,2,1,1,10,6,4,5,2,3,,,,4,1,0,1,0,0,0,3,5,7,5,2,7,0,0,,,1,0,1,,,
"Apr 3, 2023 11:00 PM",10,3,7,1,1,0,0,0,0,0,0,0,,,,3,1,0,1,0,0,0,0,4,0,0,0,3,0,0,,,1,1,0,,,
"Apr 4, 2023 12:00 AM",7,1,6,0,0,0,0,0,0,0,0,0,,,,0,3,2,1,0,0,0,1,2,0,0,0,3,0,0,,,0,0,0,,,
"Apr 4, 2023 1:00 AM",1,1,0,0,0,0,2,0,2,2,0,2,,,,0,0,0,0,0,0,0,0,1,0,0,0,1,0,0,,,0,0,0,,,
"Apr 4, 2023 2:00 AM",3,3,0,0,0,0,0,0,0,0,0,0,,,,0,0,0,0,0,0,0,0,1,1,1,0,1,0,0,,,0,0,0,,,
"Apr 4, 2023 3:00 AM",0,0,0,1,0,1,1,0,1,1,0,1,,,,0,0,0,0,0,0,0,0,0,0,0,0,0,0,0,,,0,0,0,,,
"Apr 4, 2023 4:00 AM",3,1,2,0,0,0,0,0,0,0,0,0,,,,0,2,2,0,0,0,0,2,0,1,0,1,2,0,0,,,1,1,0,,,
"Apr 4, 2023 5:00 AM",12,10,2,1,0,1,2,0,2,2,0,2,,,,1,5,5,0,0,0,0,7,1,2,0,2,5,0,0,,,0,0,0,,,
"Apr 4, 2023 6:00 AM",49,30,19,13,6,7,18,6,12,17,7,10,,,,7,23,23,0,0,0,0,20,15,3,1,2,28,2,4,,,2,2,0,,,
"Apr 4, 2023 7:00 AM",132,99,33,33,8,25,57,13,44,43,16,27,,,,11,85,85,0,0,0,0,85,30,26,7,19,119,4,1,,,6,4,2,,,
"Apr 4, 2023 8:00 AM",260,201,59,70,16,54,107,35,72,86,38,48,,,,22,159,156,3,0,0,0,140,41,66,17,49,192,6,11,,,4,2,2,,,
"Apr 4, 2023 9:00 AM",132,106,26,37,7,30,56,24,32,50,22,28,,,,12,71,70,1,0,0,0,59,22,39,10,29,66,3,2,,,3,2,1,,,
"Apr 4, 2023 10:00 AM",62,52,10,35,15,20,52,33,19,35,20,15,,,,19,45,43,2,0,0,0,34,14,22,8,14,39,0,1,,,4,3,1,,,
"Apr 4, 2023 11:00 AM",73,49,24,49,16,33,57,24,33,48,20,28,,,,10,37,35,2,0,0,0,19,7,26,14,12,22,2,4,,,2,1,1,,,
"Apr 4, 2023 12:00 PM",62,26,36,40,21,19,47,15,32,31,14,17,,,,18,25,23,2,0,0,0,15,14,16,9,7,27,3,2,,,7,5,2,,,
"Apr 4, 2023 1:00 PM",77,36,41,48,32,16,43,25,18,28,17,11,0,0,0,23,33,30,3,0,0,0,19,23,27,13,14,17,7,3,,,5,5,0,,,
"Apr 4, 2023 2:00 PM",61,30,31,38,22,16,47,33,14,37,23,14,,,,14,16,11,5,0,0,0,9,20,24,14,10,15,5,4,,,3,3,0,,,
"Apr 4, 2023 3:00 PM",88,33,55,61,28,33,50,24,26,46,20,26,,,,19,27,17,10,0,0,0,16,22,27,18,9,24,1,1,,,2,2,0,,,
"Apr 4, 2023 4:00 PM",140,42,98,55,35,20,77,47,30,59,32,27,,,,23,30,20,10,0,0,0,15,67,40,26,14,44,5,3,,,8,6,2,,,
"Apr 4, 2023 5:00 PM",220,44,176,88,58,30,130,73,57,106,62,44,,,,27,49,37,12,0,0,0,40,103,63,41,22,64,5,4,,,10,5,5,,,
"Apr 4, 2023 6:00 PM",186,55,131,101,60,41,139,94,45,105,64,41,,,,31,44,36,8,0,0,0,33,111,79,60,19,52,13,7,,,13,9,4,,,
"Apr 4, 2023 7:00 PM",112,35,77,85,53,32,106,73,33,88,55,33,,,,19,19,16,3,0,0,0,17,64,53,36,17,32,6,4,,,8,6,2,,,
"Apr 4, 2023 8:00 PM",71,15,56,23,14,9,28,18,10,24,16,8,,,,2,20,16,4,0,0,0,14,29,30,21,9,16,5,1,,,2,1,1,,,
"Apr 4, 2023 9:00 PM",39,7,32,6,5,1,9,4,5,6,3,3,,,,3,13,8,5,0,0,0,8,14,3,3,0,8,0,0,,,1,0,1,,,
"Apr 4, 2023 10:00 PM",29,9,20,1,0,1,4,2,2,4,1,3,,,,3,10,7,3,0,0,0,7,4,2,1,1,7,0,1,,,0,0,0,,,
"Apr 4, 2023 11:00 PM",9,1,8,2,1,1,3,1,2,2,0,2,,,,1,1,1,0,0,0,0,1,5,0,0,0,2,1,0,,,1,1,0,,,
"Apr 5, 2023 12:00 AM",4,0,4,0,0,0,0,0,0,1,0,1,,,,0,1,1,0,0,0,0,1,3,3,3,0,1,0,0,,,0,0,0,,,
"Apr 5, 2023 1:00 AM",1,0,1,0,0,0,0,0,0,0,0,0,,,,0,0,0,0,0,0,0,0,0,0,0,0,0,1,0,,,1,1,0,,,
"Apr 5, 2023 2:00 AM",6,4,2,0,0,0,0,0,0,0,0,0,,,,0,1,0,1,0,0,0,0,0,0,0,0,1,0,0,,,0,0,0,,,
"Apr 5, 2023 3:00 AM",0,0,0,1,0,1,1,0,1,2,1,1,,,,0,0,0,0,0,0,0,0,1,0,0,0,0,0,0,,,0,0,0,,,
"Apr 5, 2023 4:00 AM",3,1,2,0,0,0,0,0,0,0,0,0,,,,0,1,1,0,0,0,0,1,0,1,0,1,2,0,0,,,0,0,0,,,
"Apr 5, 2023 5:00 AM",12,6,6,0,0,0,2,0,2,1,0,1,,,,2,5,5,0,0,0,0,4,0,1,0,1,5,0,1,,,0,0,0,,,
"Apr 5, 2023 6:00 AM",44,26,18,13,3,10,18,3,15,8,2,6,,,,5,18,18,0,0,0,0,13,21,3,0,3,21,1,3,,,5,5,0,,,
"Apr 5, 2023 7:00 AM",102,69,33,44,14,30,64,18,46,49,20,29,,,,10,73,73,0,0,0,0,70,29,27,8,19,93,3,3,,,6,2,4,,,
"Apr 5, 2023 8:00 AM",245,197,48,65,20,45,92,29,63,74,32,42,,,,16,140,139,1,0,0,0,124,39,48,11,37,152,2,10,,,3,1,2,,,
"Apr 5, 2023 9:00 AM",142,114,28,40,12,28,62,29,33,57,35,22,,,,17,66,66,0,0,0,0,49,19,32,7,25,68,3,6,,,6,4,2,,,
"Apr 5, 2023 10:00 AM",53,39,14,34,16,18,38,24,14,28,17,11,,,,14,31,29,2,0,0,0,22,10,19,10,9,27,4,3,,,10,7,3,,,
"Apr 5, 2023 11:00 AM",52,27,25,30,18,12,38,24,14,23,15,8,,,,6,25,23,2,0,0,0,16,12,15,11,4,9,2,2,,,4,0,4,,,
"Apr 5, 2023 12:00 PM",64,34,30,33,15,18,51,24,27,30,15,15,,,,10,33,24,9,0,0,0,20,14,24,15,9,19,2,0,,,4,2,2,,,
"Apr 5, 2023 1:00 PM",74,37,37,44,19,25,62,36,26,34,20,14,,,,13,23,21,2,0,0,0,16,17,22,13,9,27,1,4,,,3,1,2,,,
"Apr 5, 2023 2:00 PM",67,31,36,38,21,17,36,20,16,28,15,13,,,,12,19,14,5,0,0,0,11,8,20,11,9,17,4,3,,,4,2,2,,,
"Apr 5, 2023 3:00 PM",56,18,38,35,22,13,51,27,24,41,31,10,,,,27,17,12,5,0,0,0,9,19,16,9,7,22,4,3,,,6,4,2,,,
"Apr 5, 2023 4:00 PM",108,36,72,29,19,10,49,29,20,39,24,15,,,,19,21,11,10,0,0,0,9,41,30,21,9,26,4,1,,,3,0,3,,,
"Apr 5, 2023 5:00 PM",176,42,134,44,31,13,79,52,27,63,36,27,,,,28,41,37,4,0,0,0,38,80,37,27,10,62,9,2,,,7,4,3,,,
"Apr 5, 2023 6:00 PM",182,44,138,62,46,16,98,77,21,68,49,19,,,,21,30,24,6,0,0,0,22,103,66,56,10,33,1,4,,,8,5,3,,,
"Apr 5, 2023 7:00 PM",99,30,69,52,33,19,61,43,18,50,36,14,,,,16,24,19,5,0,0,0,20,56,37,27,10,27,5,1,,,9,8,1,,,
"Apr 5, 2023 8:00 PM",66,22,44,23,16,7,34,14,20,28,16,12,,,,8,18,12,6,0,0,0,12,22,31,20,11,25,2,2,,,2,1,1,,,
"Apr 5, 2023 9:00 PM",51,9,42,11,8,3,18,11,7,10,5,5,,,,8,20,10,10,0,0,0,11,12,10,8,2,6,2,0,,,1,1,0,,,
"Apr 5, 2023 10:00 PM",51,13,38,4,1,3,9,4,5,12,4,8,,,,2,7,7,0,0,0,0,7,7,10,5,5,8,1,1,,,2,2,0,,,
"Apr 5, 2023 11:00 PM",11,2,9,5,3,2,9,2,7,5,1,4,,,,0,5,3,2,0,0,0,5,8,3,0,3,6,1,0,,,1,1,0,,,
"Apr 6, 2023 12:00 AM",11,7,4,1,1,0,7,4,3,4,3,1,,,,1,3,2,1,0,0,0,2,4,7,6,1,1,0,0,,,0,0,0,,,
"Apr 6, 2023 1:00 AM",1,0,1,0,0,0,5,1,4,0,0,0,,,,1,2,2,0,0,0,0,2,2,1,1,0,6,0,0,,,0,0,0,,,
"Apr 6, 2023 2:00 AM",7,6,1,2,2,0,1,1,0,0,0,0,,,,1,0,0,0,0,0,0,0,0,0,0,0,0,0,0,,,0,0,0,,,
"Apr 6, 2023 3:00 AM",1,0,1,0,0,0,0,0,0,0,0,0,,,,0,0,0,0,0,0,0,0,0,0,0,0,0,0,0,,,0,0,0,,,
"Apr 6, 2023 4:00 AM",2,1,1,0,0,0,0,0,0,0,0,0,,,,0,1,1,0,0,0,0,1,0,1,0,1,1,0,1,,,0,0,0,,,
"Apr 6, 2023 5:00 AM",8,5,3,1,0,1,2,1,1,1,1,0,,,,2,6,6,0,0,0,0,7,2,2,0,2,6,1,0,,,0,0,0,,,
"Apr 6, 2023 6:00 AM",36,22,14,11,4,7,11,4,7,11,4,7,,,,8,13,13,0,0,0,0,15,15,2,1,1,20,3,3,,,2,2,0,,,
"Apr 6, 2023 7:00 AM",97,68,29,38,10,28,46,11,35,36,14,22,,,,12,55,55,0,0,0,0,51,26,17,3,14,84,2,2,,,7,5,2,,,
"Apr 6, 2023 8:00 AM",191,154,37,57,19,38,87,31,56,59,28,31,,,,14,126,126,0,0,0,0,101,31,38,8,30,148,3,7,,,7,5,2,,,
"Apr 6, 2023 9:00 AM",122,102,20,48,15,33,54,23,31,51,32,19,,,,8,73,71,2,0,0,0,53,11,27,11,16,63,2,5,,,1,0,1,,,
"Apr 6, 2023 10:00 AM",50,34,16,39,19,20,51,32,19,39,23,16,,,,10,40,39,1,0,0,0,32,15,37,22,15,28,2,3,,,3,2,1,,,
"Apr 6, 2023 11:00 AM",46,27,19,30,19,11,39,21,18,30,22,8,,,,10,24,21,3,0,0,0,15,9,12,5,7,20,0,2,,,3,3,0,,,
"Apr 6, 2023 12:00 PM",52,25,27,49,32,17,49,23,26,35,19,16,,,,17,26,26,0,0,0,0,17,14,24,11,13,21,3,3,,,8,5,3,,,
"Apr 6, 2023 1:00 PM",67,36,31,44,25,19,55,26,29,36,17,19,,,,8,28,23,5,0,0,0,19,10,30,16,14,22,4,2,,,5,3,2,,,
"Apr 6, 2023 2:00 PM",66,34,32,53,21,32,57,34,23,41,25,16,,,,8,29,23,6,0,0,0,15,26,32,22,10,16,2,2,,,8,3,5,,,
"Apr 6, 2023 3:00 PM",65,23,42,52,37,15,71,40,31,57,35,22,,,,18,17,12,5,0,0,0,9,31,26,12,14,22,8,2,,,5,4,1,,,
"Apr 6, 2023 4:00 PM",104,29,75,61,38,23,72,47,25,67,44,23,,,,18,28,23,5,0,0,0,23,44,41,21,20,38,5,4,,,2,2,0,,,
"Apr 6, 2023 5:00 PM",179,40,139,81,52,29,100,61,39,81,54,27,,,,26,33,27,6,0,0,0,28,90,54,35,19,58,6,3,,,11,4,7,,,
"Apr 6, 2023 6:00 PM",162,45,117,69,49,20,106,69,37,83,52,31,,,,22,33,26,7,0,0,0,23,82,51,36,15,43,8,8,,,7,4,3,,,
"Apr 6, 2023 7:00 PM",87,32,55,52,37,15,65,41,24,44,32,12,0,0,0,12,19,13,6,0,0,0,12,37,40,23,17,23,3,4,,,11,8,3,,,
"Apr 6, 2023 8:00 PM",70,21,49,31,16,15,44,21,23,30,14,16,,,,9,7,7,0,0,0,0,9,26,18,9,9,21,10,1,,,5,2,3,,,
"Apr 6, 2023 9:00 PM",54,17,37,14,7,7,13,8,5,11,5,6,,,,7,12,8,4,0,0,0,6,9,9,6,3,5,2,1,,,1,1,0,,,
"Apr 6, 2023 10:00 PM",35,6,29,9,5,4,11,6,5,7,3,4,,,,1,12,9,3,0,0,0,8,13,6,3,3,12,1,2,,,2,1,1,,,
"Apr 6, 2023 11:00 PM",21,6,15,5,4,1,13,7,6,7,1,6,,,,1,4,3,1,0,0,0,2,10,0,0,0,3,1,0,,,1,1,0,,,
"Apr 7, 2023 12:00 AM",10,2,8,0,0,0,4,2,2,9,3,6,,,,0,1,1,0,0,0,0,1,7,2,2,0,5,0,2,,,0,0,0,,,
"Apr 7, 2023 1:00 AM",8,3,5,4,4,0,8,4,4,2,2,0,,,,0,2,2,0,0,0,0,0,3,4,2,2,3,0,0,,,0,0,0,,,
"Apr 7, 2023 2:00 AM",6,4,2,0,0,0,0,0,0,0,0,0,,,,0,3,2,1,0,0,0,2,1,0,0,0,2,0,0,,,0,0,0,,,
"Apr 7, 2023 3:00 AM",1,0,1,1,0,1,2,0,2,2,0,2,,,,0,0,0,0,0,0,0,0,3,0,0,0,0,0,0,,,1,1,0,,,
"Apr 7, 2023 4:00 AM",4,3,1,2,2,0,5,4,1,2,2,0,,,,1,0,0,0,0,0,0,0,2,1,0,1,0,0,0,,,0,0,0,,,
"Apr 7, 2023 5:00 AM",7,4,3,1,1,0,1,1,0,1,1,0,,,,2,3,3,0,0,0,0,3,1,2,1,1,3,0,0,,,0,0,0,,,
"Apr 7, 2023 6:00 AM",30,13,17,7,3,4,12,4,8,8,4,4,,,,5,4,4,0,0,0,0,6,7,1,0,1,11,1,2,,,2,2,0,,,
"Apr 7, 2023 7:00 AM",47,25,22,41,17,24,27,14,13,25,11,14,,,,4,16,16,0,0,0,0,17,21,12,9,3,28,4,4,,,5,4,1,,,
"Apr 7, 2023 8:00 AM",61,32,29,70,37,33,70,34,36,59,42,17,,,,6,26,26,0,0,0,0,26,30,23,14,9,31,4,6,,,2,1,1,,,
"Apr 7, 2023 9:00 AM",54,31,23,87,40,47,83,45,38,68,39,29,0,0,0,11,24,23,1,0,0,0,24,17,39,31,8,42,2,15,,,2,1,1,,,
"Apr 7, 2023 10:00 AM",59,31,28,97,53,44,111,71,40,82,53,29,0,0,0,22,28,27,1,0,0,0,24,31,37,21,16,28,2,6,,,6,4,2,,,
"Apr 7, 2023 11:00 AM",53,30,23,129,74,55,125,68,57,113,72,41,0,0,0,13,17,17,0,0,0,0,15,26,65,36,29,35,5,9,,,6,6,0,,,
"Apr 7, 2023 12:00 PM",54,28,26,155,79,76,141,75,66,147,86,61,,,,13,18,16,2,0,0,0,13,37,42,24,18,33,3,6,,,9,7,2,,,
"Apr 7, 2023 1:00 PM",49,27,22,116,64,52,122,65,57,113,59,54,,,,23,21,20,1,0,0,0,20,41,63,43,20,28,12,3,,,3,3,0,,,
"Apr 7, 2023 2:00 PM",66,49,17,132,75,57,142,75,67,129,68,61,,,,18,23,22,1,0,0,0,22,28,68,30,38,35,5,3,,,10,6,4,,,
"Apr 7, 2023 3:00 PM",48,28,20,130,43,87,125,41,84,111,31,80,,,,8,16,14,2,0,0,0,11,19,51,23,28,31,6,5,,,9,5,4,,,
"Apr 7, 2023 4:00 PM",68,24,44,71,35,36,92,46,46,71,40,31,,,,18,26,23,3,0,0,0,23,28,63,40,23,24,4,5,,,7,5,2,,,
"Apr 7, 2023 5:00 PM",78,34,44,96,49,47,85,40,45,77,37,40,,,,16,31,28,3,0,0,0,24,23,44,21,23,35,7,1,,,8,5,3,,,
"Apr 7, 2023 6:00 PM",70,31,39,51,29,22,70,27,43,56,26,30,,,,20,25,19,6,0,0,0,18,17,44,22,22,24,5,1,,,2,0,2,,,
"Apr 7, 2023 7:00 PM",44,20,24,32,19,13,40,22,18,35,22,13,,,,13,15,15,0,0,0,0,13,16,14,9,5,30,2,0,,,4,3,1,,,
"Apr 7, 2023 8:00 PM",46,20,26,16,8,8,26,12,14,26,14,12,,,,12,11,11,0,0,0,0,10,8,8,1,7,9,1,1,,,3,3,0,,,
"Apr 7, 2023 9:00 PM",25,6,19,11,6,5,11,6,5,12,7,5,,,,5,6,4,2,0,0,0,4,8,5,5,0,6,0,0,,,2,2,0,,,
"Apr 7, 2023 10:00 PM",35,9,26,5,2,3,10,6,4,5,2,3,,,,9,6,5,1,0,0,0,5,6,8,6,2,7,4,0,,,2,1,1,,,
"Apr 7, 2023 11:00 PM",26,10,16,1,1,0,9,3,6,4,1,3,,,,5,4,4,0,0,0,0,4,9,6,3,3,7,3,0,,,2,2,0,,,
"Apr 8, 2023 12:00 AM",10,6,4,0,0,0,0,0,0,2,2,0,,,,0,0,0,0,0,0,0,0,1,2,1,1,1,0,0,,,0,0,0,,,
"Apr 8, 2023 1:00 AM",6,2,4,1,1,0,3,3,0,3,2,1,,,,0,2,2,0,0,0,0,2,7,1,1,0,3,1,0,,,0,0,0,,,
"Apr 8, 2023 2:00 AM",8,5,3,1,1,0,2,1,1,1,1,0,,,,0,2,2,0,0,0,0,1,0,3,3,0,0,0,0,,,0,0,0,,,
"Apr 8, 2023 3:00 AM",1,1,0,0,0,0,1,1,0,0,0,0,,,,0,0,0,0,0,0,0,0,2,1,1,0,0,0,0,,,0,0,0,,,
"Apr 8, 2023 4:00 AM",4,0,4,1,0,1,2,1,1,0,0,0,,,,1,0,0,0,0,0,0,1,2,0,0,0,2,0,0,,,0,0,0,,,
"Apr 8, 2023 5:00 AM",4,2,2,1,1,0,0,0,0,0,0,0,,,,2,1,1,0,0,0,0,1,2,0,0,0,2,0,0,,,0,0,0,,,
"Apr 8, 2023 6:00 AM",9,5,4,3,1,2,5,2,3,3,2,1,,,,1,0,0,0,0,0,0,1,2,1,1,0,12,2,2,,,0,0,0,,,
"Apr 8, 2023 7:00 AM",20,12,8,17,3,14,18,7,11,17,6,11,,,,8,5,5,0,0,0,0,5,14,5,2,3,14,1,1,,,0,0,0,,,
"Apr 8, 2023 8:00 AM",31,13,18,53,44,9,51,43,8,45,36,9,,,,7,10,10,0,0,0,0,10,9,16,11,5,20,4,3,,,7,4,3,,,
"Apr 8, 2023 9:00 AM",34,24,10,70,43,27,64,43,21,63,46,17,,,,17,9,9,0,0,0,0,7,29,19,9,10,19,4,4,,,6,4,2,,,
"Apr 8, 2023 10:00 AM",42,19,23,87,44,43,109,69,40,78,52,26,0,,0,8,16,16,0,0,0,0,15,21,34,21,13,30,3,4,,,8,4,4,,,
"Apr 8, 2023 11:00 AM",45,27,18,135,69,66,123,65,58,141,75,66,0,0,0,10,21,19,2,0,0,0,18,30,57,36,21,24,4,3,,,15,10,5,,,
"Apr 8, 2023 12:00 PM",42,25,17,115,55,60,133,76,57,107,65,42,0,0,0,23,14,14,0,0,0,0,12,27,56,23,33,24,4,8,,,8,4,4,,,
"Apr 8, 2023 1:00 PM",38,16,22,90,36,54,136,61,75,84,39,45,0,0,0,20,29,23,6,0,0,0,21,26,46,21,25,25,9,6,,,7,6,1,,,
"Apr 8, 2023 2:00 PM",50,27,23,102,49,53,97,44,53,87,47,40,,,,21,15,15,0,0,0,0,12,26,60,37,23,23,3,3,,,6,4,2,,,
"Apr 8, 2023 3:00 PM",40,18,22,90,41,49,114,53,61,67,27,40,0,,0,18,23,22,1,0,0,0,24,20,35,17,18,29,4,0,,,6,3,3,,,
"Apr 8, 2023 4:00 PM",44,22,22,85,39,46,81,30,51,63,26,37,,,,17,15,14,1,0,0,0,11,21,54,23,31,21,9,4,,,6,4,2,,,
"Apr 8, 2023 5:00 PM",46,22,24,49,23,26,59,23,36,42,19,23,,,,18,9,9,0,0,0,0,8,10,31,14,17,25,3,1,,,8,4,4,,,
"Apr 8, 2023 6:00 PM",36,17,19,49,24,25,37,18,19,34,15,19,,,,12,7,7,0,0,0,0,9,11,17,11,6,12,2,2,,,4,3,1,,,
"Apr 8, 2023 7:00 PM",30,16,14,15,10,5,21,7,14,20,8,12,,,,15,15,13,2,0,0,0,14,11,11,7,4,19,1,2,,,4,1,3,,,
"Apr 8, 2023 8:00 PM",35,20,15,16,9,7,19,8,11,9,3,6,,,,3,10,10,0,0,0,0,9,12,16,8,8,10,2,1,,,2,1,1,,,
"Apr 8, 2023 9:00 PM",22,6,16,14,10,4,8,6,2,8,4,4,,,,5,6,6,0,0,0,0,6,2,3,3,0,6,1,1,,,2,1,1,,,
"Apr 8, 2023 10:00 PM",15,8,7,11,9,2,9,4,5,5,3,2,,,,1,5,4,1,0,0,0,4,7,2,2,0,5,0,1,,,1,0,1,,,
"Apr 8, 2023 11:00 PM",14,5,9,8,6,2,6,1,5,4,1,3,,,,5,2,2,0,0,0,0,2,3,0,0,0,5,0,1,,,0,0,0,,,
"Apr 9, 2023 12:00 AM",7,3,4,0,0,0,0,0,0,5,3,2,,,,2,1,1,0,0,0,0,1,2,2,1,1,3,1,0,,,1,1,0,,,
"Apr 9, 2023 1:00 AM",2,0,2,0,0,0,4,2,2,2,1,1,,,,0,0,0,0,0,0,0,0,3,1,1,0,3,0,1,,,0,0,0,,,
"Apr 9, 2023 2:00 AM",5,2,3,2,0,2,3,1,2,2,0,2,,,,0,2,2,0,0,0,0,1,1,1,1,0,3,0,0,,,0,0,0,,,
"Apr 9, 2023 3:00 AM",3,1,2,0,0,0,0,0,0,0,0,0,,,,0,0,0,0,0,0,0,0,2,0,0,0,0,0,1,,,0,0,0,,,
"Apr 9, 2023 4:00 AM",1,1,0,2,2,0,2,2,0,2,2,0,,,,0,0,0,0,0,0,0,0,0,2,2,0,1,0,0,,,0,0,0,,,
"Apr 9, 2023 5:00 AM",6,3,3,0,0,0,2,2,0,0,0,0,,,,1,2,2,0,0,0,0,3,0,0,0,0,1,0,0,,,0,0,0,,,
"Apr 9, 2023 6:00 AM",9,4,5,1,1,0,3,2,1,1,1,0,,,,4,1,0,1,0,0,0,1,2,4,4,0,4,0,0,,,0,0,0,,,
"Apr 9, 2023 7:00 AM",14,7,7,15,8,7,16,12,4,18,13,5,,,,3,4,4,0,0,0,0,4,9,1,1,0,8,0,1,,,0,0,0,,,
"Apr 9, 2023 8:00 AM",14,6,8,19,15,4,17,14,3,14,12,2,0,0,0,4,6,6,0,0,0,0,5,9,6,3,3,11,2,0,,,1,1,0,,,
"Apr 9, 2023 9:00 AM",22,7,15,45,25,20,46,28,18,46,28,18,,,,4,4,3,1,0,0,0,3,13,6,5,1,18,0,12,,,2,1,1,,,
"Apr 9, 2023 10:00 AM",28,15,13,76,40,36,68,38,30,78,50,28,,,,9,16,13,3,0,0,0,12,20,24,21,3,14,3,3,,,0,0,0,,,
"Apr 9, 2023 11:00 AM",41,20,21,81,39,42,90,48,42,71,33,38,,,,3,18,17,1,0,0,0,18,23,31,15,16,22,5,1,,,3,2,1,,,
"Apr 9, 2023 12:00 PM",35,16,19,55,24,31,72,31,41,59,26,33,,,,6,18,17,1,0,0,0,12,10,33,18,15,27,3,6,,,5,4,1,,,
"Apr 9, 2023 1:00 PM",25,9,16,51,22,29,51,23,28,41,21,20,,,,8,11,11,0,0,0,0,10,7,31,19,12,20,2,1,,,1,1,0,,,
"Apr 9, 2023 2:00 PM",26,15,11,34,24,10,47,23,24,37,20,17,,,,7,12,11,1,0,0,0,9,15,26,15,11,17,3,1,,,1,1,0,,,
"Apr 9, 2023 3:00 PM",25,14,11,39,22,17,37,14,23,30,16,14,,,,2,9,6,3,0,0,0,6,9,13,5,8,23,1,1,,,1,1,0,,,
"Apr 9, 2023 4:00 PM",23,12,11,27,13,14,26,11,15,23,8,15,0,0,0,18,13,11,2,0,0,0,9,13,12,4,8,12,0,0,,,2,2,0,,,
"Apr 9, 2023 5:00 PM",29,9,20,23,9,14,22,11,11,23,11,12,0,0,0,12,7,7,0,0,0,0,7,11,13,6,7,10,2,0,,,3,1,2,,,
"Apr 9, 2023 6:00 PM",22,12,10,19,13,6,15,4,11,13,5,8,0,0,0,12,6,6,0,0,0,0,9,4,4,2,2,11,2,1,,,0,0,0,,,
"Apr 9, 2023 7:00 PM",21,9,12,8,4,4,5,1,4,3,1,2,0,0,0,3,5,5,0,0,0,0,5,4,5,1,4,6,1,2,,,2,0,2,,,
"Apr 9, 2023 8:00 PM",16,7,9,14,7,7,14,6,8,10,8,2,0,0,0,5,7,7,0,0,0,0,6,5,6,2,4,7,1,1,,,1,1,0,,,
"Apr 9, 2023 9:00 PM",15,5,10,3,0,3,13,2,11,8,1,7,0,0,0,1,7,7,0,0,0,0,7,3,3,2,1,5,0,0,,,0,0,0,,,
"Apr 9, 2023 10:00 PM",11,4,7,6,2,4,5,3,2,4,2,2,0,0,0,2,5,5,0,0,0,0,4,4,0,0,0,2,0,0,,,0,0,0,,,
"Apr 9, 2023 11:00 PM",15,7,8,2,2,0,2,1,1,1,0,1,0,0,0,3,1,0,1,0,0,0,0,1,0,0,0,2,0,0,,,1,1,0,,,
"Apr 10, 2023 12:00 AM",3,0,3,0,0,0,0,0,0,0,0,0,0,0,0,1,2,2,0,0,0,0,2,0,0,0,0,1,1,0,,,1,1,0,,,
"Apr 10, 2023 1:00 AM",3,1,2,1,1,0,1,1,0,1,1,0,0,0,0,1,1,1,0,0,0,0,1,0,0,0,0,2,0,0,,,0,0,0,,,
"Apr 10, 2023 2:00 AM",1,1,0,0,0,0,0,0,0,0,0,0,0,,0,1,0,0,0,0,0,0,0,1,0,0,0,1,0,0,,,0,0,0,,,
"Apr 10, 2023 3:00 AM",4,1,3,0,0,0,3,3,0,1,1,0,,,,0,0,0,0,0,0,0,0,5,0,0,0,2,0,0,,,0,0,0,,,
"Apr 10, 2023 4:00 AM",6,2,4,0,0,0,1,0,1,0,0,0,0,0,0,1,0,0,0,0,0,0,0,0,0,0,0,1,0,1,,,0,0,0,,,
"Apr 10, 2023 5:00 AM",5,1,4,0,0,0,2,2,0,1,1,0,,,,2,0,0,0,0,0,0,0,3,0,0,0,1,0,0,,,0,0,0,,,
"Apr 10, 2023 6:00 AM",16,5,11,5,0,5,4,0,4,5,1,4,,,,2,3,3,0,0,0,0,4,1,0,0,0,9,0,1,,,0,0,0,,,
"Apr 10, 2023 7:00 AM",16,8,8,7,2,5,11,6,5,12,7,5,,,,5,8,8,0,0,0,0,7,3,2,1,1,11,0,0,,,0,0,0,,,
"Apr 10, 2023 8:00 AM",9,5,4,21,10,11,19,12,7,27,15,12,,,,5,2,2,0,0,0,0,6,12,4,2,2,11,1,2,,,5,2,3,,,
"Apr 10, 2023 9:00 AM",6,2,4,15,8,7,14,6,8,12,6,6,0,0,0,4,1,1,0,0,0,0,1,6,5,1,4,5,1,1,,,3,3,0,,,
"Apr 10, 2023 10:00 AM",12,8,4,12,7,5,12,7,5,14,11,3,,,,11,4,4,0,0,0,0,7,9,4,3,1,8,1,1,,,4,1,3,,,
"Apr 10, 2023 11:00 AM",14,9,5,66,36,30,53,31,22,55,32,23,0,0,0,9,22,21,1,0,0,0,9,10,13,9,4,17,0,3,,,2,0,2,,,
"Apr 10, 2023 12:00 PM",28,13,15,72,43,29,70,46,24,45,30,15,0,0,0,20,12,10,2,0,0,0,6,14,22,14,8,19,2,1,,,7,7,0,,,
"Apr 10, 2023 1:00 PM",17,5,12,46,16,30,42,12,30,36,15,21,0,,0,23,12,11,1,0,0,0,9,2,19,6,13,11,0,3,,,3,1,2,,,
"Apr 10, 2023 2:00 PM",24,13,11,48,28,20,45,27,18,42,27,15,0,,0,14,15,15,0,0,0,0,10,17,21,10,11,14,2,0,,,4,4,0,,,
"Apr 10, 2023 3:00 PM",23,13,10,47,23,24,61,32,29,51,26,25,0,0,0,16,8,8,0,0,0,0,4,5,35,19,16,16,3,1,,,3,1,2,,,
"Apr 10, 2023 4:00 PM",31,16,15,33,14,19,42,21,21,33,17,16,0,0,0,7,10,7,3,0,0,0,7,2,22,10,12,13,2,2,,,1,1,0,,,
"Apr 10, 2023 5:00 PM",25,9,16,39,28,11,27,13,14,27,16,11,0,,0,12,16,15,1,0,0,0,16,10,12,6,6,17,2,3,,,2,2,0,,,
"Apr 10, 2023 6:00 PM",21,8,13,16,7,9,20,9,11,22,11,11,,,,8,4,3,1,0,0,0,3,7,10,4,6,11,1,2,,,5,2,3,,,
"Apr 10, 2023 7:00 PM",35,13,22,12,4,8,11,6,5,16,10,6,,,,3,7,6,1,0,0,0,5,9,9,3,6,7,2,1,,,1,1,0,,,
"Apr 10, 2023 8:00 PM",27,12,15,12,8,4,11,4,7,6,2,4,,,,6,3,2,1,0,0,0,3,6,1,0,1,6,1,0,,,6,2,4,,,
"Apr 10, 2023 9:00 PM",14,2,12,5,3,2,6,2,4,6,3,3,0,,0,5,6,6,0,0,0,0,6,2,2,1,1,12,2,1,,,0,0,0,,,
"Apr 10, 2023 10:00 PM",9,2,7,5,3,2,3,1,2,4,1,3,,,,4,3,2,1,0,0,0,2,3,1,0,1,5,1,0,,,1,0,1,,,
"Apr 10, 2023 11:00 PM",9,5,4,5,4,1,4,4,0,3,2,1,,,,0,2,2,0,0,0,0,2,1,4,4,0,3,3,1,,,0,0,0,,,
"Apr 11, 2023 12:00 AM",1,0,1,0,0,0,0,0,0,1,0,1,,,,0,0,0,0,0,0,0,0,3,0,0,0,0,0,0,,,1,1,0,,,
"Apr 11, 2023 1:00 AM",3,2,1,0,0,0,1,0,1,1,0,1,,,,0,0,0,0,0,0,0,0,1,0,0,0,1,0,0,,,0,0,0,,,
"Apr 11, 2023 2:00 AM",3,3,0,0,0,0,0,0,0,0,0,0,,,,1,0,0,0,0,0,0,0,0,0,0,0,1,0,0,,,0,0,0,,,
"Apr 11, 2023 3:00 AM",1,1,0,0,0,0,1,1,0,0,0,0,,,,0,0,0,0,0,0,0,0,1,0,0,0,0,0,0,,,0,0,0,,,
"Apr 11, 2023 4:00 AM",3,1,2,0,0,0,1,1,0,0,0,0,,,,1,1,1,0,0,0,0,1,0,0,0,0,0,0,0,,,1,1,0,,,
"Apr 11, 2023 5:00 AM",10,7,3,3,0,3,5,1,4,4,1,3,,,,1,5,5,0,0,0,0,6,3,2,0,2,4,0,0,,,1,1,0,,,
"Apr 11, 2023 6:00 AM",40,32,8,5,2,3,15,5,10,11,4,7,,,,4,10,10,0,0,0,0,8,12,6,2,4,27,0,4,,,2,2,0,,,
"Apr 11, 2023 7:00 AM",98,74,24,26,5,21,45,12,33,28,10,18,,,,7,53,53,0,0,0,0,53,23,22,7,15,81,6,4,,,5,3,2,,,
"Apr 11, 2023 8:00 AM",174,134,40,65,15,50,79,26,53,66,24,42,,,,21,118,114,4,0,0,0,104,33,45,14,31,137,4,7,,,7,5,2,,,
"Apr 11, 2023 9:00 AM",105,89,16,49,19,30,51,25,26,50,29,21,,,,11,77,77,0,0,0,0,49,13,34,16,18,51,1,2,,,0,0,0,,,
"Apr 11, 2023 10:00 AM",59,46,13,33,17,16,41,24,17,34,21,13,,,,13,37,35,2,0,0,0,20,9,15,9,6,22,1,2,,,0,0,0,,,
"Apr 11, 2023 11:00 AM",60,36,24,34,18,16,50,28,22,36,22,14,0,0,0,11,25,20,5,0,0,0,11,12,24,14,10,14,2,2,,,2,2,0,,,
"Apr 11, 2023 12:00 PM",40,21,19,29,11,18,29,11,18,15,3,12,0,0,0,10,23,16,7,0,0,0,11,4,14,8,6,19,1,2,,,3,2,1,,,
"Apr 11, 2023 1:00 PM",71,35,36,24,11,13,24,14,10,18,8,10,,,,5,17,15,2,0,0,0,8,14,12,9,3,14,0,1,,,2,1,1,,,
"Apr 11, 2023 2:00 PM",46,19,27,14,9,5,17,12,5,12,9,3,,,,8,15,12,3,0,0,0,8,14,5,4,1,11,0,0,,,6,2,4,,,
"Apr 11, 2023 3:00 PM",51,28,23,12,9,3,18,9,9,10,5,5,,,,4,16,8,8,0,0,0,5,16,8,3,5,9,0,1,,,1,1,0,,,
"Apr 11, 2023 4:00 PM",82,14,68,9,6,3,27,19,8,23,15,8,,,,12,23,15,8,0,0,0,17,42,19,12,7,21,2,3,,,4,2,2,,,
"Apr 11, 2023 5:00 PM",138,26,112,17,11,6,38,23,15,30,14,16,,,,19,34,22,12,0,0,0,18,58,25,15,10,34,4,3,,,7,7,0,,,
"Apr 11, 2023 6:00 PM",125,28,97,26,24,2,50,41,9,33,26,7,,,,11,15,12,3,0,0,0,12,52,33,29,4,11,2,1,,,5,5,0,,,
"Apr 11, 2023 7:00 PM",72,11,61,8,7,1,19,16,3,8,7,1,0,0,0,4,11,7,4,0,0,0,6,30,12,9,3,10,1,0,,,5,3,2,,,
"Apr 11, 2023 8:00 PM",47,7,40,8,7,1,22,13,9,14,12,2,,,,3,8,6,2,0,0,0,5,15,11,9,2,10,2,1,,,1,0,1,,,
"Apr 11, 2023 9:00 PM",27,4,23,1,1,0,4,2,2,5,2,3,,,,3,7,4,3,0,0,0,4,9,1,1,0,4,0,0,,,1,0,1,,,
"Apr 11, 2023 10:00 PM",27,7,20,4,4,0,3,2,1,2,2,0,,,,1,5,4,1,0,0,0,5,6,1,0,1,2,1,0,,,4,2,2,,,
"Apr 11, 2023 11:00 PM",4,2,2,2,2,0,4,3,1,2,1,1,,,,1,0,0,0,0,0,0,0,4,1,1,0,2,1,1,,,3,2,1,,,
"Apr 12, 2023 12:00 AM",5,2,3,0,0,0,2,0,2,5,4,1,,,,0,0,0,0,0,0,0,0,3,0,0,0,2,0,0,,,0,0,0,,,
"Apr 12, 2023 1:00 AM",2,0,2,0,0,0,1,1,0,0,0,0,,,,0,0,0,0,0,0,0,0,1,1,1,0,0,0,0,,,0,0,0,,,
"Apr 12, 2023 2:00 AM",4,4,0,0,0,0,0,0,0,0,0,0,,,,0,0,0,0,0,0,0,0,0,0,0,0,1,0,0,,,0,0,0,,,
"Apr 12, 2023 3:00 AM",0,0,0,0,0,0,0,0,0,0,0,0,,,,0,0,0,0,0,0,0,0,0,0,0,0,0,0,0,,,0,0,0,,,
"Apr 12, 2023 4:00 AM",2,0,2,0,0,0,3,2,1,0,0,0,,,,0,1,1,0,0,0,0,1,0,0,0,0,0,0,0,,,1,1,0,,,
"Apr 12, 2023 5:00 AM",6,5,1,0,0,0,4,2,2,4,3,1,,,,0,4,4,0,0,0,0,6,1,2,1,1,3,1,0,,,1,1,0,,,
"Apr 12, 2023 6:00 AM",35,21,14,6,2,4,11,5,6,8,2,6,,,,3,10,10,0,0,0,0,7,10,4,1,3,19,1,1,,,1,1,0,,,
"Apr 12, 2023 7:00 AM",79,56,23,20,6,14,38,7,31,22,5,17,,,,4,57,57,0,0,0,0,52,17,16,4,12,81,3,2,,,3,2,1,,,
"Apr 12, 2023 8:00 AM",146,120,26,20,4,16,34,11,23,28,11,17,,,,10,80,79,1,0,0,0,72,23,24,9,15,80,0,3,,,1,1,0,,,
"Apr 12, 2023 9:00 AM",79,62,17,14,5,9,23,10,13,22,13,9,,,,6,44,43,1,0,0,0,29,8,17,6,11,33,2,4,,,3,0,3,,,
"Apr 12, 2023 10:00 AM",47,41,6,22,11,11,26,13,13,23,14,9,,,,10,42,40,2,0,0,0,24,5,11,5,6,21,1,0,,,4,3,1,,,
"Apr 12, 2023 11:00 AM",32,19,13,19,9,10,15,6,9,14,4,10,,,,10,26,19,7,0,0,0,11,9,4,3,1,10,0,0,,,4,3,1,,,
"Apr 12, 2023 12:00 PM",28,15,13,21,11,10,18,11,7,21,9,12,,,,11,18,14,4,0,0,0,9,7,10,4,6,18,1,0,,,1,1,0,,,
"Apr 12, 2023 1:00 PM",57,30,27,19,10,9,26,10,16,18,10,8,,,,10,17,14,3,0,0,0,8,11,13,6,7,16,2,4,,,1,1,0,,,
"Apr 12, 2023 2:00 PM",40,22,18,24,12,12,24,8,16,16,8,8,,,,0,15,14,1,0,0,0,10,7,4,1,3,9,1,2,,,0,0,0,,,
"Apr 12, 2023 3:00 PM",42,7,35,6,5,1,13,9,4,13,10,3,,,,11,11,5,6,0,0,0,4,7,7,4,3,8,1,0,,,0,0,0,,,
"Apr 12, 2023 4:00 PM",58,10,48,8,7,1,18,11,7,15,11,4,,,,3,18,13,5,0,0,0,13,20,10,6,4,14,1,2,,,3,2,1,,,
"Apr 12, 2023 5:00 PM",124,30,94,21,15,6,40,30,10,27,18,9,,,,9,20,13,7,0,0,0,12,56,17,14,3,27,3,1,,,3,3,0,,,
"Apr 12, 2023 6:00 PM",106,19,87,12,11,1,33,29,4,22,17,5,,,,3,21,17,4,0,0,0,15,46,22,15,7,11,4,3,,,5,3,2,,,
"Apr 12, 2023 7:00 PM",69,17,52,7,7,0,13,9,4,8,6,2,,,,7,12,9,3,0,0,0,5,33,7,5,2,4,0,0,,,4,3,1,,,
"Apr 12, 2023 8:00 PM",42,11,31,6,5,1,12,7,5,5,3,2,,,,3,4,2,2,0,0,0,4,8,7,6,1,8,3,1,,,0,0,0,,,
"Apr 12, 2023 9:00 PM",33,7,26,3,3,0,12,10,2,6,5,1,,,,2,12,10,2,0,0,0,9,9,6,3,3,3,3,0,,,3,1,2,,,
"Apr 12, 2023 10:00 PM",35,10,25,4,3,1,3,3,0,3,2,1,,,,3,7,6,1,0,0,0,6,7,1,1,0,3,1,0,,,2,1,1,,,
"Apr 12, 2023 11:00 PM",19,5,14,0,0,0,3,2,1,3,1,2,,,,0,2,1,1,0,0,0,1,1,1,1,0,2,0,0,,,1,1,0,,,
"Apr 13, 2023 12:00 AM",9,3,6,0,0,0,0,0,0,0,0,0,,,,0,2,2,0,0,0,0,1,6,0,0,0,7,0,0,,,0,0,0,,,
"Apr 13, 2023 1:00 AM",0,0,0,0,0,0,0,0,0,0,0,0,,,,0,0,0,0,0,0,0,0,0,0,0,0,0,0,0,,,0,0,0,,,
"Apr 13, 2023 2:00 AM",4,3,1,0,0,0,1,1,0,0,0,0,,,,0,0,0,0,0,0,0,0,1,0,0,0,1,0,0,,,0,0,0,,,
"Apr 13, 2023 3:00 AM",1,1,0,0,0,0,1,1,0,0,0,0,,,,0,0,0,0,0,0,0,0,0,0,0,0,0,0,0,,,0,0,0,,,
"Apr 13, 2023 4:00 AM",4,2,2,0,0,0,1,1,0,1,1,0,,,,0,2,2,0,0,0,0,2,1,0,0,0,1,0,0,,,0,0,0,,,
"Apr 13, 2023 5:00 AM",7,5,2,3,1,2,4,2,2,3,2,1,,,,2,3,3,0,0,0,0,5,1,0,0,0,7,1,0,,,1,1,0,,,
"Apr 13, 2023 6:00 AM",29,19,10,9,3,6,16,6,10,10,5,5,,,,5,12,12,0,0,0,0,11,15,1,0,1,22,0,3,,,2,2,0,,,
"Apr 13, 2023 7:00 AM",109,72,37,30,6,24,54,13,41,26,7,19,,,,13,58,58,0,0,0,0,52,22,27,8,19,100,3,3,,,6,5,1,,,
"Apr 13, 2023 8:00 AM",190,156,34,62,13,49,73,18,55,60,22,38,,,,22,130,130,0,0,0,0,107,27,43,4,39,193,1,3,,,1,0,1,,,
"Apr 13, 2023 9:00 AM",129,110,19,44,19,25,58,28,30,43,25,18,0,0,0,13,73,72,1,0,0,0,44,9,26,13,13,58,3,4,,,6,4,2,,,
"Apr 13, 2023 10:00 AM",50,39,11,61,28,33,53,25,28,44,24,20,0,0,0,8,27,27,0,0,0,0,21,15,25,16,9,28,1,4,,,3,2,1,,,
"Apr 13, 2023 11:00 AM",43,27,16,41,20,21,47,23,24,30,16,14,0,0,0,7,20,16,4,0,0,0,17,14,17,8,9,30,4,4,,,4,3,1,,,
"Apr 13, 2023 12:00 PM",49,26,23,54,30,24,50,25,25,50,27,23,0,0,0,12,31,30,1,0,0,0,16,11,27,15,12,20,4,1,,,3,2,1,,,
"Apr 13, 2023 1:00 PM",61,31,30,46,25,21,58,29,29,58,32,26,0,0,0,23,22,21,1,0,0,0,17,14,34,17,17,22,3,1,,,5,4,1,,,
"Apr 13, 2023 2:00 PM",64,26,38,50,23,27,62,35,27,54,29,25,0,0,0,16,17,11,6,0,0,0,6,24,35,17,18,15,4,1,,,5,2,3,,,
"Apr 13, 2023 3:00 PM",73,28,45,49,31,18,51,21,30,29,13,16,0,0,0,13,28,19,9,0,0,0,16,30,34,15,19,16,4,1,,,4,2,2,,,
"Apr 13, 2023 4:00 PM",89,22,67,47,22,25,40,24,16,35,19,16,0,,0,22,26,15,11,0,0,0,15,42,19,15,4,37,3,5,,,4,3,1,,,
"Apr 13, 2023 5:00 PM",176,39,137,77,49,28,98,64,34,73,51,22,0,,0,30,30,23,7,0,0,0,22,84,55,40,15,48,10,6,,,14,7,7,,,
"Apr 13, 2023 6:00 PM",163,51,112,83,55,28,117,75,42,97,63,34,,,,31,30,26,4,0,0,0,22,92,63,38,25,30,9,3,,,8,2,6,,,
"Apr 13, 2023 7:00 PM",109,28,81,67,40,27,88,46,42,82,47,35,,,,7,20,17,3,0,0,0,15,51,37,24,13,29,6,2,,,4,4,0,,,
"Apr 13, 2023 8:00 PM",93,19,74,32,16,16,47,26,21,33,19,14,,,,11,15,10,5,0,0,0,8,20,27,13,14,16,5,0,,,3,2,1,,,
"Apr 13, 2023 9:00 PM",57,13,44,15,12,3,30,15,15,22,12,10,,,,10,13,9,4,0,0,0,6,11,8,3,5,6,5,3,,,2,2,0,,,
"Apr 13, 2023 10:00 PM",33,10,23,10,7,3,10,8,2,8,5,3,,,,2,12,9,3,0,0,0,8,7,3,0,3,11,0,1,,,2,0,2,,,
"Apr 13, 2023 11:00 PM",19,2,17,3,3,0,10,7,3,6,1,5,,,,3,3,3,0,0,0,0,4,4,1,0,1,7,1,1,,,4,3,1,,,
"Apr 14, 2023 12:00 AM",10,2,8,0,0,0,1,1,0,7,2,5,,,,3,1,1,0,0,0,0,1,4,1,0,1,4,0,0,,,3,1,2,,,
"Apr 14, 2023 1:00 AM",7,1,6,0,0,0,0,0,0,0,0,0,,,,0,4,4,0,0,0,0,2,0,2,2,0,1,0,1,,,0,0,0,,,
"Apr 14, 2023 2:00 AM",2,1,1,1,1,0,0,0,0,0,0,0,,,,0,1,0,1,0,0,0,0,1,0,0,0,0,0,0,,,0,0,0,,,
"Apr 14, 2023 3:00 AM",4,1,3,0,0,0,2,2,0,1,1,0,,,,1,0,0,0,0,0,0,1,0,0,0,0,1,0,0,,,0,0,0,,,
"Apr 14, 2023 4:00 AM",5,3,2,1,1,0,0,0,0,1,1,0,,,,1,1,1,0,0,0,0,0,0,0,0,0,1,0,0,,,0,0,0,,,
"Apr 14, 2023 5:00 AM",11,8,3,2,1,1,5,2,3,4,3,1,,,,2,4,4,0,0,0,0,5,2,1,0,1,3,0,0,,,0,0,0,,,
"Apr 14, 2023 6:00 AM",34,22,12,8,3,5,18,9,9,8,3,5,,,,3,9,9,0,0,0,0,9,13,7,6,1,19,0,3,,,1,1,0,,,
"Apr 14, 2023 7:00 AM",76,54,22,55,24,31,63,28,35,48,24,24,,,,11,45,45,0,0,0,0,35,26,22,8,14,64,5,5,,,8,7,1,,,
"Apr 14, 2023 8:00 AM",166,135,31,65,13,52,114,38,76,66,27,39,,,,16,98,97,1,0,0,0,88,37,50,15,35,107,3,4,,,5,3,2,,,
"Apr 14, 2023 9:00 AM",83,68,15,45,20,25,77,39,38,59,34,25,,,,9,53,52,1,0,0,0,32,13,41,20,21,57,4,7,,,2,2,0,,,
"Apr 14, 2023 10:00 AM",73,55,18,46,21,25,66,30,36,48,26,22,0,0,0,16,34,31,3,0,0,0,23,20,23,12,11,28,2,3,,,5,4,1,,,
"Apr 14, 2023 11:00 AM",53,37,16,72,43,29,66,32,34,65,38,27,0,0,0,11,29,28,1,0,0,0,20,11,27,19,8,27,2,6,,,6,3,3,,,
"Apr 14, 2023 12:00 PM",64,39,25,79,37,42,81,45,36,77,50,27,0,0,0,11,29,25,4,0,0,0,19,20,40,22,18,33,3,4,,,4,3,1,,,
"Apr 14, 2023 1:00 PM",78,32,46,82,32,50,69,26,43,77,29,48,0,0,0,21,29,25,4,0,0,0,14,17,29,15,14,30,6,4,,,6,6,0,,,
"Apr 14, 2023 2:00 PM",77,37,40,80,40,40,70,36,34,61,28,33,0,0,0,19,23,18,5,0,0,0,16,21,32,18,14,23,4,1,,,5,4,1,,,
"Apr 14, 2023 3:00 PM",74,33,41,46,24,22,49,24,25,32,23,9,0,0,0,15,17,14,3,0,0,0,9,25,28,15,13,18,6,0,,,4,1,3,,,
"Apr 14, 2023 4:00 PM",112,36,76,70,43,27,91,51,40,70,43,27,0,0,0,33,29,20,9,0,0,0,15,41,43,30,13,37,4,3,,,5,4,1,,,
"Apr 14, 2023 5:00 PM",147,43,104,78,48,30,107,59,48,83,47,36,0,0,0,28,29,24,5,0,0,0,23,65,71,42,29,43,5,4,,,6,4,2,,,
"Apr 14, 2023 6:00 PM",151,38,113,69,48,21,111,65,46,81,49,32,0,,0,22,28,19,9,0,0,0,17,58,47,30,17,34,3,2,,,10,4,6,,,
"Apr 14, 2023 7:00 PM",90,29,61,51,18,33,57,30,27,51,26,25,0,,0,12,17,15,2,0,0,0,14,33,25,12,13,22,5,2,,,5,5,0,,,
"Apr 14, 2023 8:00 PM",58,24,34,37,27,10,28,14,14,24,12,12,,,,5,6,5,1,0,0,0,5,13,11,5,6,13,5,1,,,1,1,0,,,
"Apr 14, 2023 9:00 PM",31,6,25,13,6,7,11,8,3,21,12,9,0,,0,4,10,7,3,0,0,0,8,12,7,6,1,6,0,1,,,3,3,0,,,
"Apr 14, 2023 10:00 PM",34,7,27,7,3,4,11,6,5,7,2,5,,,,6,10,8,2,0,0,0,9,3,7,3,4,10,1,0,,,1,0,1,,,
"Apr 14, 2023 11:00 PM",32,10,22,11,7,4,10,8,2,6,4,2,,,,4,7,5,2,0,0,0,6,9,2,1,1,4,1,0,,,1,1,0,,,
"Apr 15, 2023 12:00 AM",16,8,8,0,0,0,4,1,3,9,2,7,0,0,0,0,2,1,1,0,0,0,1,2,3,1,2,4,0,0,,,2,2,0,,,
"Apr 15, 2023 1:00 AM",8,2,6,0,0,0,4,0,4,1,0,1,,,,1,3,3,0,0,0,0,1,3,2,1,1,1,1,0,,,1,1,0,,,
"Apr 15, 2023 2:00 AM",7,4,3,1,1,0,1,1,0,0,0,0,,,,0,1,1,0,0,0,0,1,4,0,0,0,1,0,0,,,0,0,0,,,
"Apr 15, 2023 3:00 AM",3,0,3,0,0,0,4,4,0,4,4,0,,,,0,0,0,0,0,0,0,1,0,0,0,0,1,0,0,,,0,0,0,,,
"Apr 15, 2023 4:00 AM",5,1,4,0,0,0,1,1,0,0,0,0,,,,1,2,2,0,0,0,0,1,3,0,0,0,0,0,0,,,0,0,0,,,
"Apr 15, 2023 5:00 AM",4,3,1,2,1,1,2,1,1,2,1,1,,,,2,0,0,0,0,0,0,0,2,0,0,0,1,0,0,,,0,0,0,,,
"Apr 15, 2023 6:00 AM",7,4,3,13,3,10,4,2,2,5,3,2,,,,1,2,2,0,0,0,0,2,4,2,2,0,11,0,0,,,0,0,0,,,
"Apr 15, 2023 7:00 AM",25,16,9,33,21,12,20,15,5,23,19,4,,,,7,4,4,0,0,0,0,4,10,9,2,7,13,1,6,,,3,2,1,,,
"Apr 15, 2023 8:00 AM",39,16,23,45,27,18,65,41,24,46,32,14,,,,14,18,18,0,0,0,0,20,18,18,12,6,15,1,4,,,5,2,3,,,
"Apr 15, 2023 9:00 AM",55,35,20,76,37,39,96,59,37,81,56,25,0,0,0,24,27,25,2,0,0,0,22,23,38,24,14,38,3,13,,,9,4,5,,,
"Apr 15, 2023 10:00 AM",57,31,26,117,73,44,160,94,66,115,72,43,0,0,0,21,22,22,0,0,0,0,21,32,64,47,17,41,6,3,,,5,4,1,,,
"Apr 15, 2023 11:00 AM",67,42,25,154,79,75,191,100,91,142,76,66,0,0,0,15,23,20,3,0,0,0,16,34,82,48,34,57,2,7,,,7,1,6,,,
"Apr 15, 2023 12:00 PM",54,24,30,137,76,61,150,79,71,140,76,64,0,0,0,30,24,24,0,0,0,0,25,42,81,44,37,36,7,3,,,10,9,1,,,
"Apr 15, 2023 1:00 PM",71,37,34,127,48,79,155,83,72,117,56,61,0,0,0,16,20,17,3,0,0,0,18,22,72,28,44,33,11,6,,,12,11,1,,,
"Apr 15, 2023 2:00 PM",62,28,34,130,69,61,144,67,77,108,61,47,0,0,0,43,27,27,0,0,0,0,23,32,70,35,35,39,7,2,,,4,3,1,,,
"Apr 15, 2023 3:00 PM",58,27,31,110,60,50,95,55,40,97,59,38,0,0,0,13,19,17,2,0,0,0,20,18,46,30,16,28,6,1,,,8,6,2,,,
"Apr 15, 2023 4:00 PM",65,29,36,52,28,24,98,49,49,80,38,42,0,0,0,19,21,18,3,0,0,0,10,17,44,20,24,33,5,3,,,7,6,1,,,
"Apr 15, 2023 5:00 PM",46,16,30,60,32,28,62,20,42,79,34,45,,,,17,20,18,2,0,0,0,16,16,39,14,25,28,3,1,,,5,3,2,,,
"Apr 15, 2023 6:00 PM",60,18,42,47,20,27,61,30,31,35,12,23,0,0,0,16,13,10,3,0,0,0,8,12,26,10,16,18,2,2,,,3,2,1,,,
"Apr 15, 2023 7:00 PM",44,19,25,24,6,18,28,9,19,28,7,21,,,,4,10,9,1,0,0,0,12,18,13,5,8,18,0,1,,,10,5,5,,,
"Apr 15, 2023 8:00 PM",22,11,11,6,3,3,10,4,6,7,4,3,,,,4,4,4,0,0,0,0,4,9,1,0,1,1,2,0,,,1,1,0,,,
"Apr 15, 2023 9:00 PM",9,3,6,5,4,1,6,4,2,2,1,1,,,,0,3,3,0,0,0,0,2,3,2,2,0,3,1,0,,,1,0,1,,,
"Apr 15, 2023 10:00 PM",14,3,11,1,1,0,0,0,0,2,2,0,,,,2,3,3,0,0,0,0,3,2,1,0,1,4,0,1,,,0,0,0,,,
"Apr 15, 2023 11:00 PM",10,5,5,1,0,1,5,3,2,5,3,2,,,,2,3,3,0,0,0,0,3,2,1,1,0,4,1,0,,,1,1,0,,,
"Apr 16, 2023 12:00 AM",8,4,4,0,0,0,3,2,1,1,0,1,,,,1,2,2,0,0,0,0,2,2,3,3,0,3,0,0,,,1,0,1,,,
"Apr 16, 2023 1:00 AM",13,5,8,1,0,1,3,1,2,1,0,1,0,,0,0,1,1,0,0,0,0,1,2,0,0,0,2,0,0,,,0,0,0,,,
"Apr 16, 2023 2:00 AM",4,1,3,2,1,1,1,0,1,1,0,1,,,,1,1,1,0,0,0,0,0,1,1,1,0,0,0,0,,,0,0,0,,,
"Apr 16, 2023 3:00 AM",2,1,1,0,0,0,0,0,0,0,0,0,,,,0,0,0,0,0,0,0,0,0,0,0,0,0,0,0,,,0,0,0,,,
"Apr 16, 2023 4:00 AM",2,0,2,0,0,0,2,2,0,0,0,0,,,,1,0,0,0,0,0,0,0,0,2,2,0,1,0,0,,,0,0,0,,,
"Apr 16, 2023 5:00 AM",3,0,3,0,0,0,1,1,0,0,0,0,,,,0,1,1,0,0,0,0,1,1,0,0,0,1,0,0,,,0,0,0,,,
"Apr 16, 2023 6:00 AM",8,6,2,5,1,4,2,0,2,1,0,1,,,,2,2,2,0,0,0,0,2,6,0,0,0,10,0,1,,,1,1,0,,,
"Apr 16, 2023 7:00 AM",15,5,10,20,14,6,21,16,5,20,14,6,,,,3,5,5,0,0,0,0,5,10,5,2,3,8,0,2,,,2,2,0,,,
"Apr 16, 2023 8:00 AM",28,13,15,32,22,10,34,21,13,32,22,10,,,,7,3,3,0,0,0,0,4,15,8,5,3,32,2,6,,,5,4,1,,,
"Apr 16, 2023 9:00 AM",36,15,21,73,44,29,106,67,39,77,52,25,,,,8,11,11,0,0,0,0,10,21,35,26,9,29,6,9,,,5,3,2,,,
"Apr 16, 2023 10:00 AM",41,29,12,85,34,51,108,59,49,83,47,36,,,,18,25,24,1,0,0,0,19,16,39,21,18,37,5,3,,,4,3,1,,,
"Apr 16, 2023 11:00 AM",57,36,21,116,58,58,125,65,60,106,59,47,0,0,0,17,27,24,3,0,0,0,21,34,43,19,24,30,8,8,,,6,6,0,,,
"Apr 16, 2023 12:00 PM",69,39,30,141,71,70,146,83,63,129,75,54,0,0,0,11,26,23,3,0,0,0,12,35,52,37,15,50,7,4,,,4,3,1,,,
"Apr 16, 2023 1:00 PM",62,29,33,126,65,61,144,75,69,121,62,59,0,,0,19,20,18,2,0,0,0,16,27,64,47,17,43,4,3,,,6,6,0,,,
"Apr 16, 2023 2:00 PM",50,24,26,166,98,68,176,120,56,178,115,63,0,,0,29,30,27,3,0,0,0,21,35,69,44,25,27,2,4,,,3,2,1,,,
"Apr 16, 2023 3:00 PM",80,43,37,209,104,105,180,93,87,183,106,77,0,0,0,14,23,19,4,0,0,0,11,40,81,46,35,45,6,2,,,5,4,1,,,
"Apr 16, 2023 4:00 PM",66,38,28,133,66,67,132,55,77,131,59,72,0,,0,26,27,23,4,0,0,0,15,23,62,33,29,33,4,4,,,3,2,1,,,
"Apr 16, 2023 5:00 PM",69,30,39,156,68,88,168,72,96,127,48,79,0,0,0,36,14,14,0,0,0,0,13,23,56,37,19,21,7,0,,,7,7,0,,,
"Apr 16, 2023 6:00 PM",45,19,26,112,50,62,159,67,92,124,61,63,0,,0,15,14,11,3,0,0,0,6,14,71,47,24,39,6,2,,,4,2,2,,,
"Apr 16, 2023 7:00 PM",60,28,32,58,28,30,82,41,41,51,21,30,0,,0,17,9,8,1,0,0,0,9,15,41,23,18,25,0,1,,,6,2,4,,,
"Apr 16, 2023 8:00 PM",41,16,25,57,22,35,64,19,45,40,15,25,0,,0,10,9,8,1,0,0,0,7,6,29,12,17,16,1,2,,,4,1,3,,,
"Apr 16, 2023 9:00 PM",21,7,14,11,4,7,23,4,19,10,3,7,0,0,0,0,7,7,0,0,0,0,6,2,10,6,4,7,0,3,,,3,0,3,,,
"Apr 16, 2023 10:00 PM",21,7,14,2,2,0,2,1,1,4,2,2,,,,4,7,5,2,0,0,0,4,6,2,0,2,8,3,3,,,3,3,0,,,
"Apr 16, 2023 11:00 PM",13,5,8,2,2,0,5,4,1,2,2,0,,,,1,6,4,2,0,0,0,4,2,1,1,0,4,1,0,,,2,1,1,,,
"Apr 17, 2023 12:00 AM",6,4,2,0,0,0,1,1,0,4,2,2,,,,1,0,0,0,0,0,0,0,4,1,1,0,1,0,0,,,0,0,0,,,
"Apr 17, 2023 1:00 AM",6,1,5,1,0,1,1,1,0,0,0,0,,,,3,0,0,0,0,0,0,0,2,1,1,0,0,0,0,,,1,1,0,,,
"Apr 17, 2023 2:00 AM",2,1,1,0,0,0,0,0,0,0,0,0,,,,0,0,0,0,0,0,0,0,2,0,0,0,1,0,0,,,0,0,0,,,
"Apr 17, 2023 3:00 AM",2,1,1,0,0,0,2,2,0,0,0,0,,,,0,0,0,0,0,0,0,0,0,1,1,0,1,0,0,,,0,0,0,,,
"Apr 17, 2023 4:00 AM",4,0,4,0,0,0,0,0,0,0,0,0,,,,0,1,1,0,0,0,0,1,0,0,0,0,0,0,0,,,0,0,0,,,
"Apr 17, 2023 5:00 AM",8,4,4,1,0,1,3,1,2,2,1,1,0,,0,0,6,6,0,0,0,0,6,4,0,0,0,8,0,0,,,0,0,0,,,
"Apr 17, 2023 6:00 AM",48,31,17,18,5,13,27,5,22,17,4,13,,,,5,15,15,0,0,0,0,13,10,10,3,7,31,2,4,,,2,2,0,,,
"Apr 17, 2023 7:00 AM",144,107,37,48,16,32,75,22,53,53,16,37,,,,20,101,100,1,0,0,0,89,31,35,9,26,129,7,4,,,8,6,2,,,
"Apr 17, 2023 8:00 AM",254,200,54,75,17,58,139,33,106,98,38,60,,,,33,187,183,4,0,0,0,169,51,78,16,62,203,9,5,,,19,16,3,,,
"Apr 17, 2023 9:00 AM",121,96,25,60,17,43,92,44,48,60,32,28,0,0,0,16,85,84,1,0,0,0,62,20,52,23,29,64,2,10,,,5,3,2,,,
"Apr 17, 2023 10:00 AM",73,58,15,54,25,29,75,38,37,61,34,27,0,0,0,9,45,44,1,0,0,0,25,19,35,14,21,38,4,2,,,4,2,2,,,
"Apr 17, 2023 11:00 AM",66,47,19,71,41,30,79,44,35,56,32,24,0,0,0,7,18,16,2,0,0,0,10,26,47,32,15,33,5,3,,,3,2,1,,,
"Apr 17, 2023 12:00 PM",70,36,34,87,39,48,109,53,56,77,33,44,0,0,0,10,28,24,4,0,0,0,22,18,34,20,14,26,0,3,,,3,2,1,,,
"Apr 17, 2023 1:00 PM",78,37,41,58,28,30,98,48,50,56,30,26,0,0,0,12,26,21,5,0,0,0,16,21,44,24,20,22,3,3,,,10,8,2,,,
"Apr 17, 2023 2:00 PM",73,33,40,69,37,32,64,37,27,52,29,23,0,0,0,22,18,14,4,0,0,0,11,18,52,37,15,17,2,3,,,6,2,4,,,
"Apr 17, 2023 3:00 PM",96,47,49,70,34,36,73,47,26,56,33,23,0,,0,10,32,28,4,0,0,0,28,38,29,12,17,28,5,2,,,9,6,3,,,
"Apr 17, 2023 4:00 PM",129,34,95,59,34,25,106,67,39,84,54,30,0,,0,26,34,27,7,0,0,0,25,64,42,20,22,31,4,3,,,6,3,3,,,
"Apr 17, 2023 5:00 PM",230,50,180,102,61,41,137,83,54,114,66,48,0,0,0,37,44,32,12,0,0,0,29,131,79,52,27,75,5,4,,,13,7,6,,,
"Apr 17, 2023 6:00 PM",203,67,136,118,73,45,193,136,57,111,65,46,0,0,0,29,43,33,10,0,0,0,31,130,104,74,30,34,4,2,,,10,5,5,,,
"Apr 17, 2023 7:00 PM",100,28,72,80,43,37,111,64,47,78,46,32,0,0,0,32,31,22,9,0,0,0,20,46,45,33,12,36,8,4,,,8,6,2,,,
"Apr 17, 2023 8:00 PM",101,22,79,30,16,14,73,30,43,46,21,25,0,0,0,8,18,16,2,0,0,0,15,21,27,16,11,21,6,1,,,6,3,3,,,
"Apr 17, 2023 9:00 PM",52,10,42,24,15,9,25,10,15,16,8,8,,,,4,6,2,4,0,0,0,3,17,10,3,7,15,4,1,,,2,1,1,,,
"Apr 17, 2023 10:00 PM",52,11,41,4,3,1,2,0,2,5,1,4,0,,0,11,10,4,6,0,0,0,4,9,3,2,1,5,1,0,,,1,0,1,,,
"Apr 17, 2023 11:00 PM",10,0,10,1,0,1,3,2,1,2,1,1,,,,0,5,4,1,0,0,0,5,6,4,3,1,1,1,1,,,6,3,3,,,
"Apr 18, 2023 12:00 AM",9,3,6,0,0,0,2,1,1,4,0,4,,,,0,1,1,0,0,0,0,0,1,3,0,3,4,0,0,,,0,0,0,,,
"Apr 18, 2023 1:00 AM",4,3,1,1,1,0,1,0,1,1,0,1,,,,0,0,0,0,0,0,0,0,0,1,0,1,0,0,0,,,0,0,0,,,
"Apr 18, 2023 2:00 AM",5,3,2,0,0,0,0,0,0,0,0,0,,,,0,0,0,0,0,0,0,0,0,0,0,0,0,0,0,,,0,0,0,,,
"Apr 18, 2023 3:00 AM",0,0,0,0,0,0,0,0,0,0,0,0,,,,0,0,0,0,0,0,0,0,0,0,0,0,0,0,0,,,0,0,0,,,
"Apr 18, 2023 4:00 AM",3,1,2,0,0,0,2,2,0,1,1,0,,,,0,0,0,0,0,0,0,0,0,1,1,0,1,0,0,,,0,0,0,,,
"Apr 18, 2023 5:00 AM",10,8,2,2,0,2,2,0,2,2,0,2,,,,3,7,7,0,0,0,0,6,3,0,0,0,4,1,0,,,1,1,0,,,
"Apr 18, 2023 6:00 AM",69,48,21,19,8,11,31,12,19,20,9,11,0,0,0,13,26,26,0,0,0,0,21,17,9,2,7,29,0,3,,,2,2,0,,,
"Apr 18, 2023 7:00 AM",158,109,49,58,14,44,93,25,68,64,19,45,0,0,0,25,123,119,4,0,0,0,115,38,33,7,26,159,9,2,,,12,8,4,,,
"Apr 18, 2023 8:00 AM",351,283,68,87,17,70,157,45,112,117,42,75,,,,41,204,201,3,0,0,0,191,56,103,21,82,272,3,13,,,22,20,2,,,
"Apr 18, 2023 9:00 AM",169,139,30,64,22,42,108,55,53,74,44,30,0,0,0,15,102,101,1,0,0,0,75,34,46,18,28,90,3,7,,,4,2,2,,,
"Apr 18, 2023 10:00 AM",76,58,18,47,25,22,69,37,32,43,27,16,0,0,0,16,58,57,1,0,0,0,43,23,26,14,12,29,2,3,,,3,3,0,,,
"Apr 18, 2023 11:00 AM",59,41,18,67,32,35,76,35,41,66,36,30,0,0,0,6,35,34,1,0,0,0,25,22,26,12,14,32,1,0,,,1,1,0,,,
"Apr 18, 2023 12:00 PM",74,38,36,52,25,27,72,45,27,49,30,19,,,,8,36,32,4,0,0,0,23,17,26,15,11,31,9,5,,,3,3,0,,,
"Apr 18, 2023 1:00 PM",65,32,33,49,25,24,76,35,41,45,24,21,0,0,0,14,25,21,4,0,0,0,22,27,28,18,10,18,4,2,,,5,3,2,,,
"Apr 18, 2023 2:00 PM",83,38,45,60,30,30,54,27,27,49,28,21,,,,19,29,27,2,0,0,0,24,23,41,20,21,36,8,0,,,9,6,3,,,
"Apr 18, 2023 3:00 PM",103,30,73,42,25,17,49,26,23,57,32,25,,,,20,32,22,10,0,0,0,16,34,39,24,15,25,5,9,,,7,3,4,,,
"Apr 18, 2023 4:00 PM",153,37,116,60,40,20,93,67,26,63,47,16,,,,22,44,32,12,0,0,0,27,70,61,32,29,40,3,3,,,9,3,6,,,
"Apr 18, 2023 5:00 PM",271,59,212,92,55,37,144,88,56,131,75,56,0,,0,53,50,34,16,0,0,0,35,139,94,53,41,86,15,10,,,17,13,4,,,
"Apr 18, 2023 6:00 PM",267,69,198,128,86,42,180,131,49,140,99,41,,,,51,47,36,11,0,0,0,36,145,108,72,36,50,10,6,,,17,9,8,,,
"Apr 18, 2023 7:00 PM",159,54,105,130,69,61,123,69,54,109,53,56,0,0,0,36,38,33,5,0,0,0,29,70,78,53,25,36,11,5,,,10,5,5,,,
"Apr 18, 2023 8:00 PM",91,28,63,91,51,40,97,53,44,91,51,40,,,,19,22,15,7,0,0,0,13,34,51,32,19,27,4,1,,,5,2,3,,,
"Apr 18, 2023 9:00 PM",64,10,54,21,13,8,33,10,23,31,10,21,,,,5,13,12,1,0,0,0,13,18,13,9,4,33,2,0,,,8,4,4,,,
"Apr 18, 2023 10:00 PM",51,16,35,10,8,2,11,7,4,8,5,3,,,,5,10,4,6,0,0,0,5,8,9,8,1,5,3,0,,,3,2,1,,,
"Apr 18, 2023 11:00 PM",20,5,15,3,3,0,4,3,1,5,3,2,,,,3,5,3,2,0,0,0,1,4,5,4,1,1,2,0,,,1,1,0,,,
"Apr 19, 2023 12:00 AM",9,2,7,0,0,0,1,0,1,0,0,0,,,,0,2,1,1,0,0,0,2,1,2,1,1,0,0,0,,,1,1,0,,,
"Apr 19, 2023 1:00 AM",3,1,2,0,0,0,1,1,0,0,0,0,,,,0,1,1,0,0,0,0,0,0,0,0,0,1,0,0,,,0,0,0,,,
"Apr 19, 2023 2:00 AM",6,5,1,0,0,0,0,0,0,0,0,0,,,,0,0,0,0,0,0,0,0,0,0,0,0,1,0,0,,,2,1,1,,,
"Apr 19, 2023 3:00 AM",1,1,0,0,0,0,1,1,0,1,1,0,,,,0,0,0,0,0,0,0,0,0,0,0,0,0,0,0,,,0,0,0,,,
"Apr 19, 2023 4:00 AM",7,2,5,0,0,0,0,0,0,0,0,0,,,,1,1,1,0,0,0,0,2,0,0,0,0,1,0,0,,,1,1,0,,,
"Apr 19, 2023 5:00 AM",16,13,3,1,0,1,2,1,1,1,1,0,,,,2,9,9,0,0,0,0,9,1,0,0,0,8,0,0,,,0,0,0,,,
"Apr 19, 2023 6:00 AM",61,42,19,18,5,13,27,7,20,20,5,15,0,,0,4,16,16,0,0,0,0,13,20,7,2,5,31,1,2,,,3,1,2,,,
"Apr 19, 2023 7:00 AM",167,128,39,46,12,34,77,25,52,53,22,31,,,,23,122,122,0,0,0,0,112,29,31,10,21,131,2,6,,,5,5,0,,,
"Apr 19, 2023 8:00 AM",324,256,68,87,19,68,159,47,112,111,45,66,,,,39,205,200,5,0,0,0,184,55,87,24,63,249,5,9,,,16,14,2,,,
"Apr 19, 2023 9:00 AM",150,121,29,52,22,30,81,44,37,66,43,23,,,,10,77,77,0,0,0,0,63,33,38,12,26,74,5,8,,,5,2,3,,,
"Apr 19, 2023 10:00 AM",53,36,17,35,13,22,43,18,25,37,13,24,,,,11,45,44,1,0,0,0,28,8,31,16,15,27,6,2,,,6,4,2,,,
"Apr 19, 2023 11:00 AM",58,39,19,33,10,23,29,15,14,22,10,12,,,,12,25,23,2,0,0,0,17,3,12,5,7,18,4,0,,,4,4,0,,,
"Apr 19, 2023 12:00 PM",71,40,31,28,13,15,35,15,20,23,11,12,,,,6,21,19,2,0,0,0,13,14,23,10,13,25,2,4,,,2,2,0,,,
"Apr 19, 2023 1:00 PM",69,31,38,47,26,21,57,29,28,44,25,19,,,,10,30,25,5,0,0,0,18,27,21,13,8,28,3,4,,,3,1,2,,,
"Apr 19, 2023 2:00 PM",64,38,26,35,21,14,54,28,26,31,15,16,,,,12,24,17,7,0,0,0,10,20,32,19,13,21,1,1,,,5,2,3,,,
"Apr 19, 2023 3:00 PM",84,28,56,51,26,25,46,26,20,40,22,18,,,,18,32,28,4,0,0,0,16,28,20,12,8,27,5,2,,,9,2,7,,,
"Apr 19, 2023 4:00 PM",137,41,96,41,23,18,63,41,22,52,30,22,,,,23,41,29,12,0,0,0,27,69,39,29,10,36,4,3,,,9,5,4,,,
"Apr 19, 2023 5:00 PM",227,52,175,62,48,14,107,64,43,96,56,40,,,,29,58,43,15,0,0,0,42,136,64,45,19,67,8,5,,,5,5,0,,,
"Apr 19, 2023 6:00 PM",242,57,185,87,56,31,114,86,28,95,63,32,,,,29,48,34,14,0,0,0,31,129,74,55,19,43,7,5,,,8,7,1,,,
"Apr 19, 2023 7:00 PM",107,28,79,58,33,25,77,50,27,61,35,26,,,,19,30,23,7,0,0,0,19,51,35,28,7,22,5,6,,,4,2,2,,,
"Apr 19, 2023 8:00 PM",102,30,72,27,18,9,36,19,17,25,15,10,,,,12,13,11,2,0,0,0,6,38,27,17,10,20,7,3,,,3,1,2,,,
"Apr 19, 2023 9:00 PM",61,14,47,12,6,6,19,14,5,15,9,6,,,,6,8,6,2,0,0,0,6,19,13,11,2,9,6,3,,,4,2,2,,,
"Apr 19, 2023 10:00 PM",53,10,43,8,3,5,7,6,1,5,3,2,0,0,0,8,7,5,2,0,0,0,7,6,4,4,0,7,0,0,,,2,2,0,,,
"Apr 19, 2023 11:00 PM",16,5,11,2,2,0,6,4,2,4,1,3,,,,3,3,2,1,0,0,0,1,6,6,5,1,3,1,0,,,4,3,1,,,
"Apr 20, 2023 12:00 AM",13,3,10,0,0,0,4,1,3,1,1,0,,,,1,0,0,0,0,0,0,0,4,1,1,0,2,0,0,,,1,1,0,,,
"Apr 20, 2023 1:00 AM",3,1,2,0,0,0,0,0,0,0,0,0,,,,0,1,1,0,0,0,0,1,2,2,0,2,0,0,0,,,0,0,0,,,
"Apr 20, 2023 2:00 AM",10,6,4,0,0,0,1,0,1,2,1,1,,,,0,1,1,0,0,0,0,1,0,0,0,0,1,0,0,,,0,0,0,,,
"Apr 20, 2023 3:00 AM",0,0,0,0,0,0,1,0,1,0,0,0,,,,1,0,0,0,0,0,0,0,1,0,0,0,0,0,0,,,0,0,0,,,
"Apr 20, 2023 4:00 AM",2,1,1,0,0,0,2,2,0,2,2,0,,,,1,0,0,0,0,0,0,0,2,0,0,0,1,0,0,,,0,0,0,,,
"Apr 20, 2023 5:00 AM",7,4,3,1,0,1,1,0,1,0,0,0,,,,2,6,6,0,0,0,0,5,2,1,0,1,3,2,0,,,1,1,0,,,
"Apr 20, 2023 6:00 AM",52,33,19,14,5,9,24,10,14,23,11,12,,,,8,14,14,0,0,0,0,13,17,8,3,5,24,1,4,,,1,1,0,,,
"Apr 20, 2023 7:00 AM",157,108,49,69,23,46,72,21,51,55,23,32,,,,22,90,88,2,0,0,0,88,32,41,19,22,121,5,5,,,6,5,1,,,
"Apr 20, 2023 8:00 AM",302,232,70,97,25,72,157,43,114,117,34,83,,,,40,188,183,5,0,0,0,170,57,68,14,54,225,6,9,,,18,16,2,,,
"Apr 20, 2023 9:00 AM",142,116,26,53,17,36,95,42,53,79,43,36,0,0,0,11,96,94,2,0,0,0,75,28,45,16,29,96,6,3,,,1,0,1,,,
"Apr 20, 2023 10:00 AM",57,46,11,49,18,31,53,25,28,36,13,23,0,0,0,10,50,49,1,0,0,0,37,22,23,12,11,32,4,8,,,3,3,0,,,
"Apr 20, 2023 11:00 AM",45,33,12,46,24,22,62,27,35,49,29,20,0,0,0,9,23,21,2,0,0,0,15,13,24,13,11,40,5,2,,,7,5,2,,,
"Apr 20, 2023 12:00 PM",62,31,31,50,35,15,86,53,33,55,27,28,0,0,0,13,32,29,3,0,0,0,22,14,44,27,17,36,6,2,,,9,8,1,,,
"Apr 20, 2023 1:00 PM",78,35,43,49,33,16,68,32,36,50,25,25,0,0,0,14,40,34,6,0,0,0,27,30,29,14,15,24,11,3,,,9,6,3,,,
"Apr 20, 2023 2:00 PM",65,25,40,43,18,25,59,24,35,43,18,25,0,0,0,15,25,18,7,0,0,0,9,23,33,17,16,23,3,1,,,2,2,0,,,
"Apr 20, 2023 3:00 PM",82,38,44,64,28,36,72,39,33,48,23,25,0,0,0,17,23,18,5,0,0,0,11,33,27,12,15,29,8,2,,,8,6,2,,,
"Apr 20, 2023 4:00 PM",146,45,101,58,34,24,106,65,41,72,43,29,0,,0,24,38,26,12,0,0,0,28,53,48,31,17,49,3,3,,,14,9,5,,,
"Apr 20, 2023 5:00 PM",231,69,162,80,48,32,129,81,48,100,58,42,0,,0,39,48,37,11,0,0,0,32,135,80,57,23,68,5,4,,,13,7,6,,,
"Apr 20, 2023 6:00 PM",223,64,159,82,64,18,136,103,33,108,80,28,,,,33,42,34,8,0,0,0,33,126,93,63,30,42,12,5,,,14,8,6,,,
"Apr 20, 2023 7:00 PM",151,41,110,68,33,35,85,54,31,69,39,30,0,0,0,13,28,23,5,0,0,0,20,53,46,33,13,28,6,4,,,10,5,5,,,
"Apr 20, 2023 8:00 PM",95,20,75,44,19,25,65,30,35,50,31,19,,,,9,17,10,7,0,0,0,10,37,24,13,11,28,4,1,,,6,2,4,,,
"Apr 20, 2023 9:00 PM",67,16,51,20,13,7,29,14,15,27,15,12,0,0,0,8,12,10,2,0,0,0,10,11,15,6,9,13,2,1,,,3,2,1,,,
"Apr 20, 2023 10:00 PM",44,7,37,8,4,4,11,2,9,8,1,7,0,0,0,6,9,5,4,0,0,0,5,11,5,1,4,4,0,0,,,0,0,0,,,
"Apr 20, 2023 11:00 PM",27,6,21,4,1,3,10,5,5,6,2,4,,,,3,8,5,3,0,0,0,5,5,3,3,0,6,1,0,,,1,1,0,,,
"Apr 21, 2023 12:00 AM",10,4,6,0,0,0,1,1,0,5,3,2,0,,0,0,5,2,3,0,0,0,3,9,5,5,0,2,0,0,,,0,0,0,,,
"Apr 21, 2023 1:00 AM",5,0,5,1,1,0,4,4,0,1,1,0,,,,0,0,0,0,0,0,0,0,4,1,1,0,1,0,0,,,0,0,0,,,
"Apr 21, 2023 2:00 AM",6,3,3,0,0,0,1,1,0,2,2,0,,,,0,2,2,0,0,0,0,2,0,0,0,0,0,0,0,,,0,0,0,,,
"Apr 21, 2023 3:00 AM",2,1,1,0,0,0,0,0,0,1,1,0,,,,0,0,0,0,0,0,0,0,0,0,0,0,0,0,0,,,0,0,0,,,
"Apr 21, 2023 4:00 AM",5,3,2,0,0,0,1,1,0,1,1,0,,,,1,1,1,0,0,0,0,0,0,0,0,0,0,0,0,,,0,0,0,,,
"Apr 21, 2023 5:00 AM",6,5,1,2,1,1,4,1,3,4,2,2,,,,4,7,7,0,0,0,0,7,2,0,0,0,11,1,0,,,1,1,0,,,
"Apr 21, 2023 6:00 AM",44,23,21,11,6,5,20,10,10,13,5,8,,,,3,13,13,0,0,0,0,11,7,5,4,1,29,1,1,,,0,0,0,,,
"Apr 21, 2023 7:00 AM",112,74,38,54,27,27,54,16,38,45,23,22,,,,16,55,55,0,0,0,0,49,27,26,6,20,69,3,2,,,4,4,0,,,
"Apr 21, 2023 8:00 AM",230,175,55,88,32,56,112,42,70,99,45,54,,,,36,122,116,6,0,0,0,106,35,45,14,31,137,3,5,,,19,17,2,,,
"Apr 21, 2023 9:00 AM",129,87,42,56,23,33,79,40,39,59,32,27,0,,0,19,66,65,1,0,0,0,38,23,32,12,20,69,4,6,,,8,2,6,,,
"Apr 21, 2023 10:00 AM",71,48,23,49,18,31,42,13,29,38,14,24,,,,12,38,35,3,0,0,0,26,5,17,7,10,27,2,2,,,3,1,2,,,
"Apr 21, 2023 11:00 AM",44,21,23,31,12,19,42,16,26,38,16,22,0,,0,7,26,24,2,0,0,0,16,11,17,4,13,17,0,2,,,2,2,0,,,
"Apr 21, 2023 12:00 PM",55,31,24,46,25,21,54,26,28,44,26,18,0,,0,5,32,29,3,0,0,0,21,22,33,20,13,27,1,4,,,3,1,2,,,
"Apr 21, 2023 1:00 PM",75,26,49,46,23,23,54,32,22,36,22,14,,,,10,24,23,1,0,0,0,21,28,17,12,5,27,5,2,,,6,5,1,,,
"Apr 21, 2023 2:00 PM",62,33,29,52,22,30,53,28,25,45,24,21,,,,20,24,21,3,0,0,0,20,27,23,14,9,25,5,3,,,5,3,2,,,
"Apr 21, 2023 3:00 PM",92,29,63,46,25,21,57,39,18,44,27,17,,,,26,18,11,7,0,0,0,12,31,32,21,11,30,6,0,,,8,6,2,,,
"Apr 21, 2023 4:00 PM",129,44,85,42,28,14,68,44,24,58,35,23,,,,18,22,21,1,0,0,0,20,51,42,24,18,17,3,3,,,5,2,3,,,
"Apr 21, 2023 5:00 PM",182,56,126,41,22,19,69,42,27,52,31,21,0,0,0,29,34,22,12,0,0,0,17,58,33,19,14,51,5,3,,,7,5,2,,,
"Apr 21, 2023 6:00 PM",121,39,82,56,35,21,61,49,12,50,33,17,,,,24,33,22,11,0,0,0,20,58,43,30,13,28,7,3,,,6,4,2,,,
"Apr 21, 2023 7:00 PM",89,28,61,33,23,10,58,31,27,32,14,18,,,,18,16,13,3,0,0,0,12,28,23,14,9,19,8,1,,,5,4,1,,,
"Apr 21, 2023 8:00 PM",59,17,42,29,15,14,27,13,14,32,16,16,,,,10,14,11,3,0,0,0,11,25,16,9,7,15,5,0,,,4,2,2,,,
"Apr 21, 2023 9:00 PM",35,11,24,17,13,4,18,7,11,11,7,4,0,0,0,4,11,6,5,0,0,0,6,8,5,1,4,5,1,3,,,1,1,0,,,
"Apr 21, 2023 10:00 PM",39,12,27,1,1,0,4,3,1,4,3,1,0,0,0,9,7,7,0,0,0,0,6,4,3,2,1,5,0,1,,,2,1,1,,,
"Apr 21, 2023 11:00 PM",41,14,27,3,2,1,6,3,3,3,1,2,0,0,0,4,4,3,1,0,0,0,3,5,5,4,1,5,2,0,,,1,1,0,,,
"Apr 22, 2023 12:00 AM",10,2,8,0,0,0,2,1,1,2,1,1,,,,2,5,4,1,0,0,0,4,2,2,2,0,0,1,0,,,0,0,0,,,
"Apr 22, 2023 1:00 AM",7,2,5,0,0,0,4,3,1,1,0,1,,,,0,0,0,0,0,0,0,2,0,2,1,1,2,2,1,,,0,0,0,,,
"Apr 22, 2023 2:00 AM",11,3,8,0,0,0,0,0,0,0,0,0,0,,0,2,1,1,0,0,0,0,1,4,0,0,0,3,0,0,,,0,0,0,,,
"Apr 22, 2023 3:00 AM",3,1,2,0,0,0,1,1,0,0,0,0,,,,0,1,1,0,0,0,0,1,2,1,1,0,1,0,0,,,0,0,0,,,
"Apr 22, 2023 4:00 AM",5,1,4,0,0,0,1,1,0,1,1,0,,,,2,1,1,0,0,0,0,1,1,0,0,0,0,0,0,,,0,0,0,,,
"Apr 22, 2023 5:00 AM",4,3,1,0,0,0,2,0,2,1,0,1,,,,4,0,0,0,0,0,0,0,1,0,0,0,2,0,0,,,0,0,0,,,
"Apr 22, 2023 6:00 AM",8,5,3,6,2,4,0,0,0,2,1,1,,,,0,1,1,0,0,0,0,1,2,0,0,0,5,0,0,,,1,1,0,,,
"Apr 22, 2023 7:00 AM",19,8,11,24,15,9,31,17,14,24,16,8,,,,7,6,6,0,0,0,0,6,13,5,2,3,19,1,3,,,0,0,0,,,
"Apr 22, 2023 8:00 AM",29,13,16,29,15,14,34,19,15,31,21,10,,,,7,12,12,0,0,0,0,13,16,13,7,6,15,4,2,,,6,2,4,,,
"Apr 22, 2023 9:00 AM",40,28,12,98,59,39,78,56,22,66,50,16,,,,20,26,26,0,0,0,0,26,24,28,16,12,25,2,4,,,8,6,2,,,
"Apr 22, 2023 10:00 AM",45,32,13,89,39,50,89,47,42,80,46,34,,,,9,21,21,0,0,0,0,15,24,27,12,15,20,3,3,,,4,3,1,,,
"Apr 22, 2023 11:00 AM",40,25,15,54,25,29,75,44,31,49,22,27,,,,7,18,16,2,0,0,0,15,16,21,11,10,30,1,4,,,10,3,7,,,
"Apr 22, 2023 12:00 PM",32,17,15,47,14,33,56,18,38,48,20,28,,,,6,16,15,1,0,0,0,12,18,14,7,7,21,6,2,,,5,4,1,,,
"Apr 22, 2023 1:00 PM",34,22,12,46,18,28,37,16,21,25,8,17,,,,8,10,10,0,0,0,0,9,4,12,9,3,13,4,4,,,4,4,0,,,
"Apr 22, 2023 2:00 PM",29,13,16,22,12,10,27,13,14,17,10,7,,,,6,14,12,2,0,0,0,10,10,9,4,5,13,1,1,,,5,5,0,,,
"Apr 22, 2023 3:00 PM",24,12,12,18,12,6,24,13,11,21,13,8,,,,6,5,5,0,0,0,0,5,7,4,1,3,7,3,1,,,4,3,1,,,
"Apr 22, 2023 4:00 PM",27,12,15,17,10,7,21,10,11,18,10,8,,,,4,6,6,0,0,0,0,5,5,8,4,4,11,3,1,,,3,2,1,,,
"Apr 22, 2023 5:00 PM",33,16,17,29,21,8,26,9,17,21,10,11,,,,10,5,3,2,0,0,0,4,7,13,6,7,13,1,0,,,6,3,3,,,
"Apr 22, 2023 6:00 PM",30,13,17,8,4,4,12,6,6,10,4,6,,,,5,3,2,1,0,0,0,2,7,5,5,0,5,5,0,,,2,2,0,,,
"Apr 22, 2023 7:00 PM",28,9,19,8,4,4,14,8,6,8,4,4,,,,11,5,3,2,0,0,0,4,7,11,10,1,11,3,2,,,9,2,7,,,
"Apr 22, 2023 8:00 PM",17,5,12,14,9,5,11,6,5,13,9,4,,,,5,5,4,1,0,0,0,4,8,8,5,3,9,0,0,,,0,0,0,,,
"Apr 22, 2023 9:00 PM",18,6,12,8,7,1,8,3,5,9,4,5,,,,1,11,10,1,0,0,0,10,0,2,1,1,6,0,1,,,3,1,2,,,
"Apr 22, 2023 10:00 PM",19,7,12,5,2,3,7,2,5,7,2,5,,,,2,2,2,0,0,0,0,3,4,1,0,1,2,0,0,,,4,2,2,,,
"Apr 22, 2023 11:00 PM",13,4,9,5,4,1,11,5,6,5,3,2,,,,7,2,2,0,0,0,0,1,4,6,4,2,9,1,0,,,2,2,0,,,
"Apr 23, 2023 12:00 AM",5,4,1,0,0,0,0,0,0,3,1,2,,,,0,3,3,0,0,0,0,1,3,0,0,0,4,0,0,,,0,0,0,,,
"Apr 23, 2023 1:00 AM",7,2,5,1,0,1,2,1,1,1,0,1,,,,0,2,2,0,0,0,0,4,0,2,1,1,2,0,0,,,0,0,0,,,
"Apr 23, 2023 2:00 AM",4,1,3,0,0,0,0,0,0,0,0,0,,,,0,1,1,0,0,0,0,1,1,2,2,0,3,0,0,,,0,0,0,,,
"Apr 23, 2023 3:00 AM",4,3,1,0,0,0,2,2,0,1,1,0,,,,0,0,0,0,0,0,0,2,2,1,1,0,0,0,0,,,0,0,0,,,
"Apr 23, 2023 4:00 AM",2,0,2,2,0,2,0,0,0,1,0,1,,,,1,0,0,0,0,0,0,0,0,1,1,0,0,0,0,,,0,0,0,,,
"Apr 23, 2023 5:00 AM",8,2,6,1,1,0,3,2,1,0,0,0,,,,2,2,2,0,0,0,0,2,0,0,0,0,1,0,0,,,0,0,0,,,
"Apr 23, 2023 6:00 AM",5,5,0,2,1,1,1,1,0,2,1,1,,,,2,1,0,1,0,0,0,1,2,2,2,0,8,0,0,,,1,1,0,,,
"Apr 23, 2023 7:00 AM",20,11,9,16,10,6,16,9,7,16,12,4,,,,2,9,8,1,0,0,0,8,12,5,4,1,13,1,4,,,1,0,1,,,
"Apr 23, 2023 8:00 AM",32,15,17,48,29,19,40,21,19,46,34,12,,,,15,13,13,0,0,0,0,11,12,14,9,5,21,1,6,,,2,1,1,,,
"Apr 23, 2023 9:00 AM",46,23,23,92,60,32,89,56,33,98,66,32,0,0,0,8,17,15,2,0,0,0,18,25,26,14,12,34,5,19,,,3,2,1,,,
"Apr 23, 2023 10:00 AM",65,38,27,155,89,66,155,114,41,129,87,42,0,0,0,12,32,31,1,0,0,0,22,43,100,82,18,52,5,6,,,5,4,1,,,
"Apr 23, 2023 11:00 AM",62,46,16,186,110,76,181,114,67,182,107,75,0,0,0,19,29,25,4,0,0,0,28,32,72,46,26,50,8,6,,,6,6,0,,,
"Apr 23, 2023 12:00 PM",79,41,38,166,77,89,178,93,85,136,73,63,0,0,0,21,38,34,4,0,0,0,23,45,91,57,34,43,7,9,,,6,2,4,,,
"Apr 23, 2023 1:00 PM",74,46,28,185,94,91,165,77,88,142,80,62,0,,0,20,20,19,1,0,0,0,19,37,71,42,29,43,11,3,,,9,6,3,,,
"Apr 23, 2023 2:00 PM",67,35,32,125,44,81,134,68,66,131,69,62,,,,25,20,20,0,0,0,0,17,25,54,32,22,47,6,4,,,7,3,4,,,
"Apr 23, 2023 3:00 PM",48,27,21,114,74,40,137,70,67,105,61,44,,,,19,25,23,2,0,0,0,19,16,74,43,31,31,6,1,,,3,1,2,,,
"Apr 23, 2023 4:00 PM",41,13,28,92,43,49,92,21,71,99,28,71,0,0,0,12,15,11,4,0,0,0,9,19,56,12,44,32,2,2,,,3,3,0,,,
"Apr 23, 2023 5:00 PM",39,19,20,60,26,34,69,26,43,50,21,29,,,,14,17,13,4,0,0,0,11,26,24,15,9,21,2,0,,,8,5,3,,,
"Apr 23, 2023 6:00 PM",49,16,33,35,17,18,44,20,24,40,15,25,,,,17,11,11,0,0,0,0,9,10,18,11,7,14,3,2,,,6,5,1,,,
"Apr 23, 2023 7:00 PM",38,19,19,34,19,15,30,15,15,23,15,8,,,,14,9,7,2,0,0,0,6,21,11,6,5,17,2,1,,,4,0,4,,,
"Apr 23, 2023 8:00 PM",37,12,25,30,15,15,23,8,15,10,2,8,,,,6,12,9,3,0,0,0,9,6,16,6,10,9,2,0,,,1,1,0,,,
"Apr 23, 2023 9:00 PM",27,9,18,20,12,8,18,6,12,14,6,8,,,,4,5,4,1,0,0,0,4,2,8,3,5,7,2,1,,,9,7,2,,,
"Apr 23, 2023 10:00 PM",16,4,12,3,3,0,7,3,4,6,3,3,,,,7,6,6,0,0,0,0,7,4,2,1,1,3,0,0,,,1,0,1,,,
"Apr 23, 2023 11:00 PM",3,2,1,1,1,0,3,2,1,2,1,1,,,,2,5,5,0,0,0,0,5,5,2,0,2,0,1,0,,,1,1,0,,,
"Apr 24, 2023 12:00 AM",5,2,3,0,0,0,0,0,0,1,1,0,,,,0,2,2,0,0,0,0,1,1,3,2,1,2,0,0,,,5,1,4,,,
"Apr 24, 2023 1:00 AM",1,0,1,0,0,0,1,1,0,1,1,0,,,,3,1,1,0,0,0,0,1,1,0,0,0,0,0,0,,,0,0,0,,,
"Apr 24, 2023 2:00 AM",1,0,1,0,0,0,2,2,0,2,2,0,,,,0,0,0,0,0,0,0,0,2,0,0,0,1,0,0,,,0,0,0,,,
"Apr 24, 2023 3:00 AM",1,0,1,1,0,1,3,2,1,2,1,1,,,,1,0,0,0,0,0,0,0,0,1,1,0,1,0,0,,,0,0,0,,,
"Apr 24, 2023 4:00 AM",2,0,2,0,0,0,0,0,0,0,0,0,,,,0,1,1,0,0,0,0,1,1,1,0,1,0,0,0,,,0,0,0,,,
"Apr 24, 2023 5:00 AM",8,6,2,0,0,0,2,1,1,1,0,1,,,,1,7,7,0,0,0,0,7,4,2,1,1,3,1,1,,,1,1,0,,,
"Apr 24, 2023 6:00 AM",18,9,9,9,3,6,10,1,9,11,4,7,,,,1,9,9,0,0,0,0,9,5,2,0,2,23,3,2,,,1,0,1,,,
"Apr 24, 2023 7:00 AM",64,43,21,5,2,3,13,3,10,11,1,10,,,,8,36,36,0,0,0,0,38,15,8,2,6,55,1,1,,,1,1,0,,,
"Apr 24, 2023 8:00 AM",135,110,25,10,0,10,25,11,14,15,7,8,,,,17,72,71,1,0,0,0,67,16,14,5,9,75,1,2,,,9,8,1,,,
"Apr 24, 2023 9:00 AM",84,72,12,14,5,9,30,12,18,25,16,9,,,,6,30,30,0,0,0,0,28,11,17,7,10,25,0,2,,,3,1,2,,,
"Apr 24, 2023 10:00 AM",44,35,9,11,3,8,19,10,9,14,5,9,,,,9,24,24,0,0,0,0,14,6,10,5,5,20,2,0,,,1,1,0,,,
"Apr 24, 2023 11:00 AM",39,33,6,11,1,10,19,9,10,13,5,8,,,,4,22,22,0,0,0,0,13,7,12,6,6,16,1,3,,,2,1,1,,,
"Apr 24, 2023 12:00 PM",51,31,20,11,3,8,35,15,20,17,6,11,,,,3,18,17,1,0,0,0,12,7,6,3,3,13,1,0,,,3,2,1,,,
"Apr 24, 2023 1:00 PM",64,38,26,27,17,10,37,21,16,28,15,13,,,,9,23,17,6,0,0,0,10,15,15,9,6,15,3,3,,,5,2,3,,,
"Apr 24, 2023 2:00 PM",58,33,25,31,13,18,32,16,16,24,11,13,,,,21,21,16,5,0,0,0,11,12,14,7,7,14,2,1,,,2,1,1,,,
"Apr 24, 2023 3:00 PM",54,21,33,26,18,8,42,23,19,28,18,10,,,,13,15,13,2,0,0,0,9,15,22,11,11,16,2,1,,,4,3,1,,,
"Apr 24, 2023 4:00 PM",97,27,70,27,16,11,42,26,16,32,22,10,,,,14,18,13,5,0,0,0,12,35,17,11,6,24,1,2,,,6,4,2,,,
"Apr 24, 2023 5:00 PM",142,39,103,42,25,17,68,46,22,64,41,23,0,0,0,23,26,19,7,0,0,0,16,69,36,24,12,32,4,2,,,7,3,4,,,
"Apr 24, 2023 6:00 PM",130,34,96,65,38,27,80,57,23,55,36,19,0,,0,18,26,23,3,0,0,0,23,54,37,27,10,19,4,4,,,8,6,2,,,
"Apr 24, 2023 7:00 PM",84,22,62,34,19,15,63,29,34,53,27,26,,,,20,31,25,6,0,0,0,22,26,42,25,17,20,4,2,,,8,6,2,,,
"Apr 24, 2023 8:00 PM",68,22,46,28,12,16,30,17,13,28,15,13,,,,15,15,9,6,0,0,0,10,19,18,6,12,17,5,0,,,4,3,1,,,
"Apr 24, 2023 9:00 PM",57,15,42,11,4,7,15,5,10,9,1,8,,,,6,11,8,3,0,0,0,8,20,3,1,2,9,6,0,,,1,0,1,,,
"Apr 24, 2023 10:00 PM",39,9,30,5,5,0,5,2,3,4,2,2,,,,5,9,4,5,0,0,0,1,4,3,2,1,7,3,0,,,5,5,0,,,
"Apr 24, 2023 11:00 PM",11,2,9,1,0,1,3,2,1,1,1,0,,,,1,8,5,3,0,0,0,6,7,2,2,0,1,1,0,,,1,1,0,,,
"Apr 25, 2023 12:00 AM",7,2,5,0,0,0,0,0,0,2,0,2,,,,1,1,1,0,0,0,0,1,1,0,0,0,1,0,0,,,1,1,0,,,
"Apr 25, 2023 1:00 AM",4,0,4,0,0,0,2,0,2,0,0,0,,,,0,1,1,0,0,0,0,0,0,0,0,0,1,0,0,,,0,0,0,,,
"Apr 25, 2023 2:00 AM",6,5,1,0,0,0,1,1,0,0,0,0,,,,1,0,0,0,0,0,0,0,0,0,0,0,0,0,0,,,1,1,0,,,
"Apr 25, 2023 3:00 AM",1,1,0,1,0,1,1,0,1,0,0,0,,,,0,0,0,0,0,0,0,0,0,0,0,0,0,0,0,,,0,0,0,,,
"Apr 25, 2023 4:00 AM",2,1,1,0,0,0,2,2,0,0,0,0,,,,1,0,0,0,0,0,0,0,0,2,1,1,0,0,0,,,1,1,0,,,
"Apr 25, 2023 5:00 AM",11,7,4,4,2,2,7,3,4,7,4,3,,,,0,10,10,0,0,0,0,10,3,2,0,2,5,0,1,,,0,0,0,,,
"Apr 25, 2023 6:00 AM",57,39,18,12,5,7,19,6,13,12,5,7,,,,13,18,18,0,0,0,0,15,13,6,3,3,31,1,4,,,1,1,0,,,
"Apr 25, 2023 7:00 AM",167,115,52,59,14,45,102,30,72,67,26,41,,,,21,106,104,2,0,0,0,96,41,42,14,28,138,3,5,,,8,6,2,,,
"Apr 25, 2023 8:00 AM",319,258,61,85,24,61,154,44,110,111,42,69,,,,44,209,207,2,0,0,0,187,65,96,21,75,265,12,13,,,22,16,6,,,
"Apr 25, 2023 9:00 AM",144,122,22,52,16,36,87,37,50,71,33,38,0,,0,24,90,87,3,0,0,0,66,19,42,16,26,97,4,10,,,6,4,2,,,
"Apr 25, 2023 10:00 AM",62,51,11,41,20,21,40,21,19,33,18,15,0,,0,9,42,38,4,0,0,0,28,14,22,12,10,33,3,2,,,3,2,1,,,
"Apr 25, 2023 11:00 AM",61,39,22,59,32,27,61,27,34,56,27,29,0,0,0,6,26,25,1,0,0,0,14,19,19,11,8,25,7,2,,,3,2,1,,,
"Apr 25, 2023 12:00 PM",73,38,35,47,24,23,57,31,26,36,20,16,,,,5,27,25,2,0,0,0,18,14,25,15,10,24,3,0,,,5,5,0,,,
"Apr 25, 2023 1:00 PM",68,24,44,56,27,29,78,34,44,62,28,34,,,,10,25,22,3,0,0,0,14,23,24,11,13,29,5,6,,,8,7,1,,,
"Apr 25, 2023 2:00 PM",69,25,44,33,18,15,44,21,23,28,19,9,,,,16,14,11,3,0,0,0,12,24,17,10,7,33,3,2,,,4,1,3,,,
"Apr 25, 2023 3:00 PM",92,35,57,39,14,25,60,30,30,36,21,15,,,,22,25,22,3,0,0,0,13,29,37,19,18,24,5,3,,,3,2,1,,,
"Apr 25, 2023 4:00 PM",130,43,87,50,36,14,93,69,24,65,47,18,,,,21,32,20,12,0,0,0,19,71,51,37,14,43,6,3,,,13,6,7,,,
"Apr 25, 2023 5:00 PM",245,69,176,76,46,30,120,80,40,80,51,29,0,0,0,39,40,31,9,0,0,0,29,134,71,39,32,58,8,4,,,13,11,2,,,
"Apr 25, 2023 6:00 PM",231,60,171,91,66,25,153,125,28,125,92,33,,,,31,45,35,10,0,0,0,36,146,106,84,22,43,6,2,,,13,10,3,,,
"Apr 25, 2023 7:00 PM",135,34,101,52,34,18,89,54,35,51,34,17,,,,20,22,17,5,0,0,0,16,51,40,30,10,28,4,4,,,6,5,1,,,
"Apr 25, 2023 8:00 PM",104,31,73,27,20,7,43,22,21,32,18,14,,,,12,21,12,9,0,0,0,12,38,20,11,9,15,10,4,,,4,2,2,,,
"Apr 25, 2023 9:00 PM",56,14,42,22,18,4,24,10,14,19,8,11,,,,10,20,17,3,0,0,0,14,16,11,5,6,14,6,3,,,5,3,2,,,
"Apr 25, 2023 10:00 PM",41,10,31,15,14,1,15,5,10,11,3,8,,,,11,8,8,0,0,0,0,9,17,5,5,0,14,1,0,,,5,3,2,,,
"Apr 25, 2023 11:00 PM",10,2,8,2,2,0,5,3,2,5,2,3,,,,1,1,0,1,0,0,0,1,0,7,6,1,4,1,0,,,1,1,0,,,
"Apr 26, 2023 12:00 AM",10,2,8,0,0,0,1,1,0,1,1,0,,,,0,5,5,0,0,0,0,1,5,0,0,0,0,0,0,,,0,0,0,,,
"Apr 26, 2023 1:00 AM",6,2,4,0,0,0,0,0,0,0,0,0,,,,0,2,1,1,0,0,0,0,2,0,0,0,1,0,0,,,0,0,0,,,
"Apr 26, 2023 2:00 AM",6,4,2,0,0,0,1,0,1,0,0,0,0,0,0,1,0,0,0,0,0,0,0,1,0,0,0,1,0,0,,,0,0,0,,,
"Apr 26, 2023 3:00 AM",2,0,2,1,0,1,1,0,1,1,0,1,,,,0,0,0,0,0,0,0,0,0,0,0,0,0,0,0,,,0,0,0,,,
"Apr 26, 2023 4:00 AM",1,0,1,0,0,0,0,0,0,0,0,0,,,,2,3,3,0,0,0,0,3,0,1,0,1,0,0,0,,,0,0,0,,,
"Apr 26, 2023 5:00 AM",12,6,6,4,1,3,3,1,2,2,1,1,,,,1,8,8,0,0,0,0,8,1,3,1,2,5,0,1,,,1,1,0,,,
"Apr 26, 2023 6:00 AM",56,32,24,20,5,15,22,7,15,14,3,11,,,,10,17,17,0,0,0,0,14,19,6,1,5,35,0,3,,,1,0,1,,,
"Apr 26, 2023 7:00 AM",172,126,46,58,19,39,80,22,58,55,23,32,,,,16,110,110,0,0,0,0,106,31,37,7,30,107,3,2,,,3,2,1,,,
"Apr 26, 2023 8:00 AM",314,246,68,97,28,69,164,51,113,124,47,77,,,,45,231,228,3,0,0,0,205,60,90,28,62,239,8,16,,,20,18,2,,,
"Apr 26, 2023 9:00 AM",161,134,27,68,20,48,69,26,43,55,23,32,,,,14,76,76,0,0,0,0,61,19,39,14,25,71,5,3,,,3,3,0,,,
"Apr 26, 2023 10:00 AM",64,46,18,38,13,25,52,24,28,40,16,24,,,,9,33,33,0,0,0,0,20,14,47,30,17,27,4,1,,,3,2,1,,,
"Apr 26, 2023 11:00 AM",55,37,18,43,20,23,37,20,17,30,16,14,,,,3,20,17,3,0,0,0,14,11,20,13,7,26,6,2,,,6,5,1,,,
"Apr 26, 2023 12:00 PM",60,24,36,43,21,22,60,28,32,41,22,19,,,,15,27,22,5,0,0,0,17,23,34,11,23,27,6,2,,,5,5,0,,,
"Apr 26, 2023 1:00 PM",79,40,39,66,38,28,69,39,30,62,38,24,,,,12,21,20,1,0,0,0,14,25,37,22,15,33,2,3,,,5,3,2,,,
"Apr 26, 2023 2:00 PM",74,29,45,48,21,27,54,31,23,38,18,20,,,,21,18,14,4,0,0,0,11,27,28,18,10,32,6,3,,,10,4,6,,,
"Apr 26, 2023 3:00 PM",97,38,59,38,23,15,61,35,26,40,28,12,0,,0,42,30,24,6,0,0,0,17,25,27,14,13,16,2,2,,,6,4,2,,,
"Apr 26, 2023 4:00 PM",139,45,94,67,38,29,73,45,28,57,38,19,0,0,0,29,36,31,5,0,0,0,26,66,44,31,13,50,7,3,,,4,3,1,,,
"Apr 26, 2023 5:00 PM",244,57,187,101,59,42,157,96,61,119,65,54,,,,22,45,32,13,0,0,0,30,121,89,53,36,70,5,9,,,10,6,4,,,
"Apr 26, 2023 6:00 PM",212,51,161,98,75,23,164,131,33,123,85,38,,,,22,44,36,8,0,0,0,32,119,109,57,52,62,12,6,,,11,9,2,,,
"Apr 26, 2023 7:00 PM",141,49,92,69,31,38,103,53,50,62,35,27,,,,31,21,16,5,0,0,0,15,53,49,33,16,39,4,3,,,6,4,2,,,
"Apr 26, 2023 8:00 PM",87,23,64,26,19,7,41,24,17,37,21,16,,,,4,14,11,3,0,0,0,10,42,43,27,16,16,6,3,,,4,4,0,,,
"Apr 26, 2023 9:00 PM",49,7,42,24,19,5,19,10,9,16,11,5,,,,9,15,12,3,0,0,0,12,19,8,5,3,13,8,2,,,0,0,0,,,
"Apr 26, 2023 10:00 PM",47,9,38,10,6,4,5,4,1,6,3,3,,,,4,11,9,2,0,0,0,9,12,3,1,2,6,2,0,,,3,2,1,,,
"Apr 26, 2023 11:00 PM",16,2,14,5,3,2,17,12,5,10,5,5,,,,1,6,4,2,0,0,0,4,5,8,7,1,7,1,0,,,1,1,0,,,
"Apr 27, 2023 12:00 AM",14,4,10,1,1,0,1,1,0,5,4,1,,,,3,2,2,0,0,0,0,2,3,3,3,0,0,0,0,,,1,1,0,,,
"Apr 27, 2023 1:00 AM",4,0,4,1,1,0,2,2,0,1,1,0,,,,1,2,2,0,0,0,0,1,1,1,1,0,1,0,0,,,0,0,0,,,
"Apr 27, 2023 2:00 AM",5,4,1,0,0,0,1,0,1,1,0,1,,,,1,0,0,0,0,0,0,0,1,0,0,0,2,0,0,,,0,0,0,,,
"Apr 27, 2023 3:00 AM",1,0,1,0,0,0,0,0,0,0,0,0,,,,0,0,0,0,0,0,0,0,0,0,0,0,0,0,0,,,0,0,0,,,
"Apr 27, 2023 4:00 AM",6,3,3,0,0,0,1,1,0,0,0,0,,,,2,0,0,0,0,0,0,0,0,1,1,0,1,0,0,,,0,0,0,,,
"Apr 27, 2023 5:00 AM",10,8,2,5,1,4,5,2,3,5,3,2,,,,1,7,7,0,0,0,0,7,2,3,1,2,4,1,1,,,0,0,0,,,
"Apr 27, 2023 6:00 AM",50,29,21,27,14,13,32,13,19,26,12,14,0,0,0,7,21,21,0,0,0,0,18,15,8,6,2,29,0,5,,,3,3,0,,,
"Apr 27, 2023 7:00 AM",158,117,41,32,8,24,60,17,43,33,11,22,,,,24,76,76,0,0,0,0,75,23,24,6,18,111,2,4,,,5,3,2,,,
"Apr 27, 2023 8:00 AM",245,201,44,70,17,53,119,34,85,82,31,51,,,,33,157,153,4,0,0,0,143,52,66,13,53,212,8,8,,,22,16,6,,,
"Apr 27, 2023 9:00 AM",124,103,21,44,13,31,55,24,31,54,28,26,,,,9,78,77,1,0,0,0,61,18,38,20,18,69,0,6,,,6,4,2,,,
"Apr 27, 2023 10:00 AM",61,41,20,35,15,20,30,13,17,25,11,14,,,,12,34,32,2,0,0,0,20,21,18,8,10,25,4,5,,,3,3,0,,,
"Apr 27, 2023 11:00 AM",47,27,20,15,6,9,29,15,14,20,8,12,,,,6,22,18,4,0,0,0,14,8,17,6,11,24,3,0,,,2,1,1,,,
"Apr 27, 2023 12:00 PM",54,31,23,24,11,13,33,16,17,26,17,9,,,,12,22,19,3,0,0,0,13,13,13,7,6,21,2,4,,,5,4,1,,,
"Apr 27, 2023 1:00 PM",60,36,24,31,20,11,40,25,15,31,18,13,0,0,0,5,18,16,2,0,0,0,16,29,21,12,9,19,5,0,,,5,1,4,,,
"Apr 27, 2023 2:00 PM",46,20,26,15,7,8,20,14,6,19,12,7,0,0,0,12,21,15,6,0,0,0,8,24,12,8,4,12,1,3,,,7,5,2,,,
"Apr 27, 2023 3:00 PM",65,29,36,19,13,6,31,17,14,22,15,7,0,0,0,14,21,16,5,0,0,0,10,27,12,7,5,24,0,0,,,4,2,2,,,
"Apr 27, 2023 4:00 PM",109,30,79,32,17,15,52,34,18,33,19,14,0,0,0,16,19,10,9,0,0,0,11,60,29,24,5,36,3,3,,,4,1,3,,,
"Apr 27, 2023 5:00 PM",192,40,152,59,24,35,108,71,37,81,57,24,0,0,0,18,32,22,10,0,0,0,26,111,35,28,7,47,3,2,,,8,5,3,,,
"Apr 27, 2023 6:00 PM",160,40,120,51,36,15,94,73,21,62,45,17,0,,0,22,36,28,8,0,0,0,29,95,58,46,12,30,8,7,,,7,5,2,,,
"Apr 27, 2023 7:00 PM",106,34,72,40,19,21,61,35,26,47,23,24,,,,12,15,14,1,0,0,0,13,49,32,23,9,21,3,3,,,7,6,1,,,
"Apr 27, 2023 8:00 PM",70,25,45,21,15,6,37,24,13,28,18,10,,,,11,16,13,3,0,0,0,11,21,24,15,9,17,5,3,,,4,3,1,,,
"Apr 27, 2023 9:00 PM",51,10,41,25,23,2,17,7,10,12,4,8,,,,5,8,7,1,0,0,0,10,9,6,4,2,15,3,4,,,1,1,0,,,
"Apr 27, 2023 10:00 PM",36,7,29,21,20,1,18,7,11,15,2,13,,,,6,10,8,2,0,0,0,7,5,6,4,2,12,2,0,,,4,3,1,,,
"Apr 27, 2023 11:00 PM",20,7,13,6,5,1,10,7,3,9,3,6,,,,5,3,2,1,0,0,0,4,8,5,3,2,6,0,0,,,0,0,0,,,
"Apr 28, 2023 12:00 AM",11,2,9,0,0,0,2,1,1,4,1,3,,,,2,5,3,2,0,0,0,3,6,1,1,0,2,0,0,,,2,1,1,,,
"Apr 28, 2023 1:00 AM",2,0,2,0,0,0,4,3,1,2,1,1,,,,0,0,0,0,0,0,0,0,3,4,4,0,2,0,0,,,0,0,0,,,
"Apr 28, 2023 2:00 AM",8,5,3,0,0,0,0,0,0,1,1,0,,,,0,0,0,0,0,0,0,0,0,0,0,0,1,0,0,,,0,0,0,,,
"Apr 28, 2023 3:00 AM",1,0,1,1,0,1,0,0,0,1,0,1,,,,0,0,0,0,0,0,0,0,2,0,0,0,0,0,0,,,0,0,0,,,
"Apr 28, 2023 4:00 AM",3,1,2,0,0,0,1,0,1,0,0,0,,,,1,2,1,1,0,0,0,1,1,1,0,1,2,0,0,,,1,1,0,,,
"Apr 28, 2023 5:00 AM",13,8,5,1,1,0,3,2,1,2,2,0,,,,2,5,5,0,0,0,0,4,2,0,0,0,7,0,1,,,0,0,0,,,
"Apr 28, 2023 6:00 AM",38,20,18,14,4,10,24,11,13,12,5,7,,,,7,16,16,0,0,0,0,14,11,8,5,3,34,0,1,,,0,0,0,,,
"Apr 28, 2023 7:00 AM",87,57,30,44,20,24,49,18,31,39,19,20,,,,10,43,43,0,0,0,0,38,29,23,10,13,61,3,0,,,5,4,1,,,
"Apr 28, 2023 8:00 AM",170,133,37,57,20,37,98,31,67,67,24,43,,,,33,126,119,7,0,0,0,109,31,48,15,33,117,8,8,,,23,19,4,,,
"Apr 28, 2023 9:00 AM",96,73,23,44,21,23,68,36,32,55,35,20,,,,9,39,38,1,0,0,0,33,13,29,12,17,56,1,5,,,7,5,2,,,
"Apr 28, 2023 10:00 AM",47,31,16,27,14,13,35,15,20,27,14,13,,,,8,30,28,2,0,0,0,25,15,14,7,7,29,1,0,,,0,0,0,,,
"Apr 28, 2023 11:00 AM",55,33,22,31,12,19,41,17,24,35,17,18,0,0,0,8,20,17,3,0,0,0,13,17,20,9,11,17,1,0,,,1,0,1,,,
"Apr 28, 2023 12:00 PM",48,23,25,27,14,13,40,19,21,20,10,10,0,0,0,16,41,39,2,0,0,0,24,6,12,8,4,22,3,7,,,5,3,2,,,
"Apr 28, 2023 1:00 PM",102,49,53,38,24,14,44,24,20,39,18,21,0,0,0,16,16,13,3,0,0,0,15,18,29,19,10,14,1,1,,,9,3,6,,,
"Apr 28, 2023 2:00 PM",75,33,42,34,17,17,54,41,13,46,31,15,0,0,0,39,18,14,4,0,0,0,14,22,28,20,8,15,3,3,,,5,3,2,,,
"Apr 28, 2023 3:00 PM",85,29,56,54,27,27,66,35,31,46,27,19,0,0,0,21,27,16,11,0,0,0,12,26,27,10,17,29,6,3,,,7,5,2,,,
"Apr 28, 2023 4:00 PM",126,34,92,48,30,18,75,37,38,60,34,26,0,0,0,25,30,25,5,0,0,0,21,46,33,21,12,31,4,6,,,4,1,3,,,
"Apr 28, 2023 5:00 PM",128,24,104,58,36,22,83,59,24,61,42,19,0,0,0,29,26,23,3,0,0,0,17,64,54,39,15,41,8,3,,,3,3,0,,,
"Apr 28, 2023 6:00 PM",125,44,81,72,37,35,104,69,35,67,31,36,0,0,0,25,31,21,10,0,0,0,19,56,56,43,13,28,4,1,,,11,6,5,,,
"Apr 28, 2023 7:00 PM",101,49,52,41,24,17,70,38,32,43,31,12,0,0,0,14,17,14,3,0,0,0,15,25,34,21,13,34,5,0,,,6,3,3,,,
"Apr 28, 2023 8:00 PM",74,28,46,27,19,8,41,27,14,26,13,13,0,0,0,9,10,9,1,0,0,0,9,13,22,8,14,16,6,0,,,3,2,1,,,
"Apr 28, 2023 9:00 PM",44,17,27,17,9,8,31,13,18,19,9,10,0,0,0,1,12,9,3,0,0,0,8,12,14,8,6,7,0,2,,,2,1,1,,,
"Apr 28, 2023 10:00 PM",26,7,19,15,7,8,5,3,2,11,6,5,0,0,0,2,5,4,1,0,0,0,3,8,6,5,1,9,1,1,,,2,1,1,,,
"Apr 28, 2023 11:00 PM",16,4,12,7,4,3,7,5,2,5,2,3,0,0,0,5,3,3,0,0,0,0,3,4,2,2,0,3,2,0,,,7,4,3,,,
"Apr 29, 2023 12:00 AM",8,1,7,0,0,0,1,1,0,5,3,2,0,0,0,0,3,2,1,0,0,0,2,1,4,3,1,5,0,0,,,0,0,0,,,
"Apr 29, 2023 1:00 AM",7,1,6,6,4,2,2,0,2,4,1,3,0,0,0,0,3,3,0,0,0,0,1,8,0,0,0,2,0,0,,,0,0,0,,,
"Apr 29, 2023 2:00 AM",13,5,8,4,2,2,0,0,0,0,0,0,0,0,0,0,0,0,0,0,0,0,0,1,1,1,0,2,0,0,,,0,0,0,,,
"Apr 29, 2023 3:00 AM",2,0,2,2,0,2,2,2,0,2,1,1,0,0,0,1,0,0,0,0,0,0,0,1,2,1,1,0,0,0,,,0,0,0,,,
"Apr 29, 2023 4:00 AM",3,1,2,0,0,0,2,2,0,0,0,0,0,0,0,2,1,1,0,0,0,0,2,1,1,1,0,3,0,0,,,0,0,0,,,
"Apr 29, 2023 5:00 AM",3,2,1,0,0,0,1,1,0,0,0,0,0,0,0,3,0,0,0,0,0,0,0,1,0,0,0,2,0,1,,,0,0,0,,,
"Apr 29, 2023 6:00 AM",10,4,6,12,4,8,9,6,3,7,5,2,0,0,0,1,6,6,0,0,0,0,5,2,3,3,0,8,1,0,,,1,1,0,,,
"Apr 29, 2023 7:00 AM",29,13,16,25,18,7,24,12,12,24,19,5,0,0,0,7,5,5,0,0,0,0,6,14,9,5,4,14,2,6,,,1,1,0,,,
"Apr 29, 2023 8:00 AM",37,14,23,38,20,18,64,38,26,45,28,17,0,0,0,4,8,8,0,0,0,0,8,13,26,18,8,21,2,8,,,3,2,1,,,
"Apr 29, 2023 9:00 AM",43,20,23,80,37,43,79,50,29,60,36,24,0,0,0,10,25,25,0,0,0,0,20,21,25,19,6,29,1,5,,,2,2,0,,,
"Apr 29, 2023 10:00 AM",43,19,24,102,50,52,106,52,54,88,49,39,0,0,0,15,18,18,0,0,0,0,13,26,43,21,22,24,6,8,,,6,5,1,,,
"Apr 29, 2023 11:00 AM",46,25,21,114,51,63,100,43,57,90,42,48,0,0,0,12,21,19,2,0,0,0,18,29,29,13,16,34,9,3,,,7,5,2,,,
"Apr 29, 2023 12:00 PM",42,30,12,87,25,62,72,36,36,71,33,38,0,0,0,6,23,22,1,0,0,0,20,19,26,12,14,28,4,2,,,8,6,2,,,
"Apr 29, 2023 1:00 PM",57,32,25,59,26,33,59,30,29,51,29,22,0,0,0,20,19,19,0,0,0,0,20,17,29,24,5,25,11,4,,,7,6,1,,,
"Apr 29, 2023 2:00 PM",70,54,16,53,28,25,55,27,28,40,20,20,0,0,0,25,21,21,0,0,0,0,19,19,45,22,23,21,2,2,,,4,3,1,,,
"Apr 29, 2023 3:00 PM",49,30,19,42,23,19,64,41,23,51,33,18,0,0,0,17,9,9,0,0,0,0,6,18,34,25,9,15,5,1,,,3,2,1,,,
"Apr 29, 2023 4:00 PM",24,6,18,42,24,18,40,14,26,27,12,15,0,0,0,18,13,12,1,0,0,0,12,15,37,14,23,21,1,0,,,3,3,0,,,
"Apr 29, 2023 5:00 PM",52,17,35,31,26,5,56,27,29,40,19,21,0,0,0,12,13,12,1,0,0,0,11,20,27,16,11,24,2,0,,,3,2,1,,,
"Apr 29, 2023 6:00 PM",47,15,32,54,26,28,52,24,28,43,16,27,0,0,0,4,10,8,2,0,0,0,8,17,22,10,12,18,3,1,,,11,5,6,,,
"Apr 29, 2023 7:00 PM",42,20,22,24,19,5,35,16,19,20,11,9,0,0,0,7,8,6,2,0,0,0,6,9,19,11,8,16,1,0,,,1,1,0,,,
"Apr 29, 2023 8:00 PM",37,12,25,22,11,11,24,11,13,17,8,9,0,0,0,7,5,4,1,0,0,0,4,9,20,10,10,18,0,2,,,3,1,2,,,
"Apr 29, 2023 9:00 PM",31,8,23,19,8,11,19,6,13,8,3,5,0,0,0,3,2,2,0,0,0,0,2,4,9,7,2,15,3,1,,,2,2,0,,,
"Apr 29, 2023 10:00 PM",15,7,8,7,5,2,8,2,6,7,1,6,0,,0,1,5,3,2,0,0,0,2,5,1,0,1,6,0,0,,,2,0,2,,,
"Apr 29, 2023 11:00 PM",11,4,7,6,4,2,7,2,5,8,2,6,,,,3,4,4,0,0,0,0,4,4,3,2,1,3,1,0,,,4,3,1,,,
"Apr 30, 2023 12:00 AM",5,2,3,0,0,0,1,0,1,2,1,1,,,,0,7,7,0,0,0,0,6,5,3,3,0,3,0,0,,,1,0,1,,,
"Apr 30, 2023 1:00 AM",10,2,8,2,1,1,4,2,2,4,1,3,,,,1,2,2,0,0,0,0,2,0,0,0,0,2,0,0,,,2,2,0,,,
"Apr 30, 2023 2:00 AM",5,2,3,2,2,0,2,2,0,2,2,0,,,,1,0,0,0,0,0,0,0,1,1,1,0,2,0,0,,,0,0,0,,,
"Apr 30, 2023 3:00 AM",1,1,0,1,1,0,1,1,0,1,1,0,,,,0,0,0,0,0,0,0,0,0,0,0,0,3,0,0,,,0,0,0,,,
"Apr 30, 2023 4:00 AM",3,0,3,1,0,1,1,0,1,2,1,1,,,,0,0,0,0,0,0,0,0,2,1,0,1,1,0,0,,,0,0,0,,,
"Apr 30, 2023 5:00 AM",2,1,1,0,0,0,1,1,0,1,1,0,,,,3,1,0,1,0,0,0,0,1,0,0,0,1,0,0,,,0,0,0,,,
"Apr 30, 2023 6:00 AM",5,2,3,10,3,7,5,3,2,3,2,1,,,,2,1,1,0,0,0,0,1,6,3,2,1,8,0,0,,,0,0,0,,,
"Apr 30, 2023 7:00 AM",19,10,9,13,5,8,18,12,6,10,7,3,,,,4,8,8,0,0,0,0,7,12,2,1,1,12,0,2,,,0,0,0,,,
"Apr 30, 2023 8:00 AM",23,11,12,47,31,16,55,38,17,43,37,6,,,,12,13,13,0,0,0,0,11,24,16,12,4,110,1,10,,,3,1,2,,,
"Apr 30, 2023 9:00 AM",37,22,15,93,62,31,103,62,41,77,53,24,0,0,0,11,13,13,0,0,0,0,12,19,52,42,10,22,5,4,,,3,3,0,,,
"Apr 30, 2023 10:00 AM",57,33,24,141,73,68,153,84,69,121,70,51,0,0,0,4,11,10,1,0,0,0,9,24,52,25,27,23,5,4,,,4,3,1,,,
"Apr 30, 2023 11:00 AM",50,25,25,130,55,75,159,83,76,103,59,44,0,,0,10,30,26,4,0,0,0,20,29,83,49,34,41,3,8,,,4,2,2,,,
"Apr 30, 2023 12:00 PM",58,28,30,189,86,103,163,72,91,142,74,68,0,,0,14,18,18,0,0,0,0,15,28,61,31,30,49,6,7,,,9,7,2,,,
"Apr 30, 2023 1:00 PM",32,15,17,141,77,64,125,61,64,121,64,57,,,,12,14,14,0,0,0,0,11,26,42,24,18,32,11,5,,,9,9,0,,,
"Apr 30, 2023 2:00 PM",39,23,16,120,50,70,77,41,36,91,55,36,,,,20,12,11,1,0,0,0,6,28,47,33,14,23,4,6,,,10,5,5,,,
"Apr 30, 2023 3:00 PM",54,31,23,106,63,43,96,38,58,90,44,46,,,,16,13,10,3,0,0,0,9,13,54,29,25,13,3,1,,,10,6,4,,,
"Apr 30, 2023 4:00 PM",50,23,27,90,42,48,78,28,50,75,31,44,,,,14,32,30,2,0,0,0,21,17,60,31,29,25,2,6,,,2,2,0,,,
"Apr 30, 2023 5:00 PM",36,15,21,85,36,49,75,30,45,62,20,42,,,,20,17,15,2,0,0,0,13,9,61,17,44,32,3,2,,,3,1,2,,,
"Apr 30, 2023 6:00 PM",28,17,11,52,23,29,45,22,23,39,16,23,0,,0,9,15,12,3,0,0,0,16,9,23,8,15,18,2,1,,,5,5,0,,,
"Apr 30, 2023 7:00 PM",39,22,17,43,23,20,22,8,14,30,15,15,,,,8,8,8,0,0,0,0,6,16,18,11,7,17,2,1,,,0,0,0,,,
"Apr 30, 2023 8:00 PM",33,14,19,20,13,7,18,12,6,21,11,10,0,0,0,8,7,6,1,0,0,0,7,8,7,1,6,18,2,2,,,2,2,0,,,
"Apr 30, 2023 9:00 PM",22,9,13,14,8,6,11,7,4,9,5,4,0,0,0,3,5,3,2,0,0,0,3,5,7,6,1,12,1,1,,,2,2,0,,,
"Apr 30, 2023 10:00 PM",12,4,8,9,6,3,11,3,8,6,1,5,,,,0,3,3,0,0,0,0,3,2,2,0,2,2,0,0,,,2,1,1,,,
"Apr 30, 2023 11:00 PM",9,6,3,8,8,0,8,6,2,5,2,3,0,0,0,1,8,8,0,0,0,0,5,3,4,4,0,5,1,0,,,1,1,0,,,
"May 1, 2023 12:00 AM",12,7,5,0,0,0,1,0,1,5,1,4,,,,1,3,2,1,0,0,0,3,1,1,0,1,4,0,0,,,1,0,1,,,
"May 1, 2023 1:00 AM",5,1,4,4,1,3,4,1,3,2,0,2,,,,1,1,1,0,0,0,0,1,2,4,1,3,5,0,0,,,0,0,0,,,
"May 1, 2023 2:00 AM",2,1,1,2,2,0,2,1,1,4,4,0,,,,0,0,0,0,0,0,0,0,1,0,0,0,0,0,0,,,0,0,0,,,
"May 1, 2023 3:00 AM",3,0,3,0,0,0,1,1,0,1,1,0,,,,1,0,0,0,0,0,0,0,2,1,1,0,1,0,0,,,0,0,0,,,
"May 1, 2023 4:00 AM",3,1,2,0,0,0,0,0,0,0,0,0,,,,0,0,0,0,0,0,0,0,0,0,0,0,2,0,0,,,0,0,0,,,
"May 1, 2023 5:00 AM",4,2,2,0,0,0,0,0,0,0,0,0,,,,1,1,1,0,0,0,0,2,0,0,0,0,0,0,0,,,0,0,0,,,
"May 1, 2023 6:00 AM",14,6,8,7,4,3,13,9,4,7,5,2,,,,3,4,4,0,0,0,0,4,2,1,1,0,4,0,0,,,0,0,0,,,
"May 1, 2023 7:00 AM",18,11,7,20,11,9,22,11,11,18,9,9,,,,6,7,7,0,0,0,0,7,14,6,4,2,19,0,1,,,0,0,0,,,
"May 1, 2023 8:00 AM",40,20,20,48,33,15,38,26,12,33,24,9,,,,8,20,20,0,0,0,0,15,19,12,10,2,54,5,6,,,3,3,0,,,
"May 1, 2023 9:00 AM",48,25,23,89,47,42,89,57,32,80,51,29,,,,13,20,19,1,0,0,0,16,29,33,21,12,30,5,6,,,2,1,1,,,
"May 1, 2023 10:00 AM",39,19,20,144,72,72,176,109,67,110,60,50,,,,10,23,21,2,0,0,0,15,42,62,38,24,41,5,10,,,10,9,1,,,
"May 1, 2023 11:00 AM",57,42,15,171,90,81,176,90,86,130,80,50,,,,15,24,21,3,0,0,0,21,33,65,38,27,42,6,9,,,5,2,3,,,
"May 1, 2023 12:00 PM",80,48,32,226,121,105,206,114,92,186,117,69,,,,17,27,24,3,0,0,0,18,32,104,58,46,59,10,7,,,4,3,1,,,
"May 1, 2023 1:00 PM",55,33,22,160,76,84,160,84,76,143,77,66,,,,23,18,15,3,0,0,0,8,29,69,35,34,31,7,4,,,9,6,3,,,
"May 1, 2023 2:00 PM",76,40,36,121,56,65,170,88,82,119,70,49,,,,12,19,19,0,0,0,0,18,27,109,64,45,21,9,4,,,5,2,3,,,
"May 1, 2023 3:00 PM",61,30,31,169,95,74,167,87,80,163,80,83,,,,19,17,13,4,0,0,0,11,31,96,53,43,38,4,6,,,7,5,2,,,
"May 1, 2023 4:00 PM",60,20,40,166,82,84,149,75,74,129,60,69,,,,25,24,20,4,0,0,0,21,24,82,40,42,43,11,4,,,12,8,4,,,
"May 1, 2023 5:00 PM",64,33,31,121,59,62,106,35,71,99,34,65,,,,17,14,12,2,0,0,0,13,23,55,26,29,31,5,8,,,9,8,1,,,
"May 1, 2023 6:00 PM",67,24,43,79,29,50,78,27,51,66,24,42,,,,33,16,13,3,0,0,0,15,13,38,12,26,26,1,1,,,1,1,0,,,
"May 1, 2023 7:00 PM",50,26,24,52,31,21,39,17,22,37,15,22,,,,13,10,6,4,0,0,0,5,10,23,11,12,16,1,3,,,7,5,2,,,
"May 1, 2023 8:00 PM",49,20,29,27,14,13,30,14,16,24,11,13,,,,7,10,10,0,0,0,0,11,13,16,8,8,15,3,4,,,8,5,3,,,
"May 1, 2023 9:00 PM",32,8,24,16,10,6,22,6,16,14,6,8,,,,5,6,6,0,0,0,0,6,6,13,3,10,15,4,0,,,1,1,0,,,
"May 1, 2023 10:00 PM",11,2,9,11,5,6,7,4,3,6,3,3,,,,5,4,4,0,0,0,0,4,11,7,3,4,7,2,0,,,4,2,2,,,
"May 1, 2023 11:00 PM",11,3,8,9,5,4,6,3,3,3,1,2,,,,0,3,1,2,0,0,0,1,3,1,1,0,9,0,1,,,2,2,0,,,
"May 2, 2023 12:00 AM",6,4,2,0,0,0,2,2,0,1,1,0,,,,1,1,1,0,0,0,0,2,1,3,3,0,0,0,0,,,1,0,1,,,
"May 2, 2023 1:00 AM",1,0,1,0,0,0,4,1,3,3,0,3,,,,1,2,2,0,0,0,0,1,0,1,1,0,1,0,0,,,0,0,0,,,
"May 2, 2023 2:00 AM",3,3,0,1,1,0,0,0,0,0,0,0,,,,0,0,0,0,0,0,0,0,1,0,0,0,2,0,0,,,0,0,0,,,
"May 2, 2023 3:00 AM",0,0,0,0,0,0,3,1,2,1,1,0,,,,0,0,0,0,0,0,0,0,0,0,0,0,1,0,0,,,0,0,0,,,
"May 2, 2023 4:00 AM",3,2,1,0,0,0,0,0,0,0,0,0,,,,0,3,3,0,0,0,0,3,0,0,0,0,1,0,0,,,0,0,0,,,
"May 2, 2023 5:00 AM",15,10,5,1,0,1,5,3,2,1,1,0,,,,3,4,4,0,0,0,0,4,2,2,2,0,5,0,1,,,0,0,0,,,
"May 2, 2023 6:00 AM",51,30,21,11,3,8,22,10,12,15,6,9,,,,9,25,25,0,0,0,0,23,14,5,4,1,34,0,5,,,3,2,1,,,
"May 2, 2023 7:00 AM",165,115,50,46,8,38,85,20,65,58,14,44,,,,20,113,111,2,0,0,0,102,45,36,11,25,144,5,2,,,6,6,0,,,
"May 2, 2023 8:00 AM",295,236,59,78,18,60,151,46,105,97,34,63,,,,29,200,197,3,0,0,0,176,43,98,18,80,226,3,15,,,10,8,2,,,
"May 2, 2023 9:00 AM",134,115,19,55,22,33,77,37,40,71,44,27,,,,21,75,72,3,0,0,0,60,29,39,15,24,88,3,8,,,8,4,4,,,
"May 2, 2023 10:00 AM",65,52,13,49,19,30,61,33,28,50,23,27,,,,12,28,27,1,0,0,0,24,13,27,14,13,31,2,2,,,2,1,1,,,
"May 2, 2023 11:00 AM",45,28,17,44,20,24,58,27,31,46,24,22,,,,16,25,23,2,0,0,0,17,8,24,12,12,25,0,2,,,3,2,1,,,
"May 2, 2023 12:00 PM",67,34,33,40,20,20,57,30,27,35,18,17,,,,13,16,15,1,0,0,0,10,24,32,20,12,26,5,3,,,4,4,0,,,
"May 2, 2023 1:00 PM",68,24,44,62,31,31,79,38,41,56,30,26,,,,17,19,17,2,0,0,0,12,25,28,12,16,24,4,3,,,5,5,0,,,
"May 2, 2023 2:00 PM",63,32,31,36,19,17,53,26,27,32,19,13,,,,12,19,12,7,0,0,0,10,16,22,15,7,30,3,0,,,6,3,3,,,
"May 2, 2023 3:00 PM",87,37,50,45,27,18,72,47,25,55,33,22,,,,19,20,19,1,0,0,0,13,26,51,38,13,21,3,1,,,6,4,2,,,
"May 2, 2023 4:00 PM",146,41,105,61,39,22,84,50,34,70,46,24,,,,15,37,25,12,0,0,0,24,78,56,35,21,38,9,5,,,8,5,3,,,
"May 2, 2023 5:00 PM",263,63,200,112,58,54,153,101,52,115,69,46,,,,35,46,41,5,0,0,0,30,131,94,68,26,62,16,8,,,17,10,7,,,
"May 2, 2023 6:00 PM",239,55,184,109,79,30,170,120,50,137,94,43,,,,32,33,30,3,0,0,0,30,142,105,84,21,44,7,4,,,10,10,0,,,
"May 2, 2023 7:00 PM",148,41,107,80,37,43,106,57,49,93,49,44,,,,25,19,14,5,0,0,0,12,67,66,42,24,36,6,1,,,8,5,3,,,
"May 2, 2023 8:00 PM",98,33,65,39,25,14,46,28,18,35,17,18,,,,21,22,16,6,0,0,0,15,26,30,21,9,16,8,1,,,2,1,1,,,
"May 2, 2023 9:00 PM",56,12,44,34,23,11,44,22,22,33,19,14,,,,5,11,9,2,0,0,0,9,29,9,7,2,19,5,2,,,3,3,0,,,
"May 2, 2023 10:00 PM",38,10,28,15,14,1,11,5,6,10,5,5,,,,4,7,4,3,0,0,0,2,8,7,4,3,11,1,0,,,3,1,2,,,
"May 2, 2023 11:00 PM",9,2,7,4,4,0,3,3,0,0,0,0,,,,0,4,4,0,0,0,0,4,1,1,1,0,2,1,2,,,1,1,0,,,
"May 3, 2023 12:00 AM",5,2,3,0,0,0,1,1,0,0,0,0,,,,1,2,0,2,0,0,0,0,5,0,0,0,0,0,1,,,0,0,0,,,
"May 3, 2023 1:00 AM",5,0,5,1,0,1,5,2,3,4,3,1,,,,0,4,4,0,0,0,0,3,1,1,1,0,1,0,0,,,3,3,0,,,
"May 3, 2023 2:00 AM",4,3,1,2,0,2,0,0,0,1,1,0,,,,0,0,0,0,0,0,0,0,1,0,0,0,0,0,0,,,0,0,0,,,
"May 3, 2023 3:00 AM",1,0,1,0,0,0,0,0,0,0,0,0,,,,0,0,0,0,0,0,0,0,0,0,0,0,0,0,0,,,0,0,0,,,
"May 3, 2023 4:00 AM",3,2,1,0,0,0,0,0,0,0,0,0,,,,0,3,3,0,0,0,0,2,0,0,0,0,0,0,0,,,0,0,0,,,
"May 3, 2023 5:00 AM",11,6,5,9,3,6,10,2,8,7,1,6,,,,2,7,6,1,0,0,0,6,2,4,0,4,6,0,1,,,0,0,0,,,
"May 3, 2023 6:00 AM",61,36,25,20,6,14,18,4,14,14,4,10,,,,10,28,28,0,0,0,0,27,14,2,2,0,45,1,2,,,2,1,1,,,
"May 3, 2023 7:00 AM",178,126,52,52,15,37,94,26,68,69,21,48,,,,21,128,125,3,0,0,0,123,47,58,20,38,144,4,7,,,10,7,3,,,
"May 3, 2023 8:00 AM",319,269,50,106,29,77,171,48,123,132,49,83,,,,46,212,206,6,0,0,0,191,46,99,26,73,269,8,6,,,25,21,4,,,
"May 3, 2023 9:00 AM",138,110,28,61,19,42,83,39,44,74,37,37,,,,16,96,94,2,0,0,0,84,26,46,20,26,89,3,6,,,9,6,3,,,
"May 3, 2023 10:00 AM",68,47,21,42,11,31,59,29,30,35,14,21,,,,10,36,34,2,0,0,0,30,11,38,25,13,31,1,4,,,3,2,1,,,
"May 3, 2023 11:00 AM",57,37,20,44,19,25,67,34,33,50,26,24,,,,8,15,15,0,0,0,0,13,14,36,13,23,25,6,1,,,5,3,2,,,
"May 3, 2023 12:00 PM",65,30,35,39,20,19,57,24,33,47,24,23,,,,8,21,20,1,0,0,0,16,17,25,14,11,34,5,3,,,0,0,0,,,
"May 3, 2023 1:00 PM",58,22,36,39,27,12,83,50,33,50,31,19,,,,19,19,18,1,0,0,0,16,27,27,18,9,21,5,7,,,8,5,3,,,
"May 3, 2023 2:00 PM",65,34,31,40,17,23,57,32,25,41,26,15,,,,20,20,16,4,0,0,0,10,21,27,17,10,21,6,3,,,6,2,4,,,
"May 3, 2023 3:00 PM",91,37,54,43,32,11,65,48,17,47,30,17,,,,14,25,22,3,0,0,0,16,23,37,22,15,20,3,4,,,10,4,6,,,
"May 3, 2023 4:00 PM",162,43,119,52,26,26,90,47,43,71,40,31,,,,13,31,26,5,0,0,0,21,53,36,30,6,34,4,3,,,9,3,6,,,
"May 3, 2023 5:00 PM",255,48,207,94,58,36,127,87,40,97,66,31,,,,30,46,36,10,0,0,0,36,134,68,51,17,71,10,4,,,12,7,5,,,
"May 3, 2023 6:00 PM",245,72,173,97,66,31,170,121,49,116,78,38,,,,33,39,33,6,0,0,0,29,135,106,88,18,42,12,7,,,8,5,3,,,
"May 3, 2023 7:00 PM",142,51,91,90,48,42,111,60,51,99,53,46,,,,23,19,14,5,0,0,0,18,59,59,43,16,39,8,6,,,4,3,1,,,
"May 3, 2023 8:00 PM",104,29,75,56,32,24,58,27,31,41,20,21,,,,11,22,18,4,0,0,0,15,27,41,22,19,17,4,2,,,3,3,0,,,
"May 3, 2023 9:00 PM",66,17,49,36,20,16,31,11,20,15,6,9,,,,12,19,15,4,0,0,0,12,17,16,8,8,9,5,2,,,2,1,1,,,
"May 3, 2023 10:00 PM",37,5,32,16,11,5,12,5,7,9,5,4,,,,1,8,5,3,0,0,0,7,13,9,4,5,6,3,0,,,0,0,0,,,
"May 3, 2023 11:00 PM",23,2,21,3,2,1,3,2,1,1,0,1,,,,0,8,8,0,0,0,0,6,5,2,1,1,1,1,0,,,1,1,0,,,
"May 4, 2023 12:00 AM",12,5,7,1,1,0,2,2,0,2,2,0,,,,1,1,1,0,0,0,0,1,1,1,1,0,6,1,0,,,0,0,0,,,
"May 4, 2023 1:00 AM",2,1,1,0,0,0,1,1,0,1,1,0,,,,0,2,1,1,0,0,0,0,3,2,0,2,0,0,0,,,0,0,0,,,
"May 4, 2023 2:00 AM",5,2,3,0,0,0,2,2,0,2,2,0,,,,0,0,0,0,0,0,0,0,2,0,0,0,0,0,0,,,0,0,0,,,
"May 4, 2023 3:00 AM",1,1,0,1,1,0,0,0,0,0,0,0,,,,0,0,0,0,0,0,0,0,1,0,0,0,0,0,0,,,0,0,0,,,
"May 4, 2023 4:00 AM",3,1,2,0,0,0,0,0,0,1,0,1,,,,2,1,1,0,0,0,0,1,1,0,0,0,0,0,0,,,1,1,0,,,
"May 4, 2023 5:00 AM",11,6,5,7,1,6,4,1,3,4,1,3,,,,0,5,5,0,0,0,0,5,3,1,1,0,4,1,0,,,0,0,0,,,
"May 4, 2023 6:00 AM",43,25,18,27,13,14,26,12,14,23,10,13,,,,15,15,15,0,0,0,0,13,14,2,2,0,37,0,4,,,1,0,1,,,
"May 4, 2023 7:00 AM",157,107,50,76,24,52,90,29,61,76,30,46,,,,19,87,87,0,0,0,0,86,35,34,10,24,113,3,2,,,6,3,3,,,
"May 4, 2023 8:00 AM",289,231,58,80,29,51,133,48,85,99,45,54,,,,36,170,167,3,0,0,0,155,45,82,22,60,245,13,9,,,25,23,2,,,
"May 4, 2023 9:00 AM",128,104,24,70,21,49,86,38,48,81,41,40,,,,14,76,76,0,0,0,0,63,28,50,18,32,75,0,4,,,3,3,0,,,
"May 4, 2023 10:00 AM",51,39,12,56,19,37,60,21,39,45,20,25,,,,9,34,33,1,0,0,0,25,10,23,10,13,32,5,1,,,6,4,2,,,
"May 4, 2023 11:00 AM",34,24,10,34,18,16,47,19,28,34,14,20,,,,5,17,16,1,0,0,0,16,8,18,9,9,24,1,3,,,7,5,2,,,
"May 4, 2023 12:00 PM",60,28,32,48,21,27,51,25,26,33,18,15,,,,7,16,15,1,0,0,0,10,17,20,11,9,20,0,4,,,2,1,1,,,
"May 4, 2023 1:00 PM",99,45,54,36,18,18,58,31,27,45,22,23,,,,13,13,12,1,0,0,0,13,21,19,8,11,20,3,4,,,11,8,3,,,
"May 4, 2023 2:00 PM",71,30,41,24,17,7,39,24,15,27,18,9,,,,40,11,9,2,0,0,0,7,35,26,17,9,23,2,6,,,7,3,4,,,
"May 4, 2023 3:00 PM",91,35,56,28,18,10,39,24,15,26,18,8,,,,29,22,20,2,0,0,0,17,24,25,15,10,29,3,3,,,6,3,3,,,
"May 4, 2023 4:00 PM",119,32,87,50,27,23,68,37,31,51,34,17,,,,28,36,30,6,0,0,0,31,52,36,27,9,29,3,3,,,10,6,4,,,
"May 4, 2023 5:00 PM",207,51,156,63,41,22,105,73,32,85,54,31,,,,31,33,25,8,0,0,0,24,136,61,48,13,52,9,2,,,8,5,3,,,
"May 4, 2023 6:00 PM",160,33,127,52,38,14,83,60,23,61,40,21,,,,14,20,16,4,0,0,0,18,90,58,47,11,33,4,3,,,6,4,2,,,
"May 4, 2023 7:00 PM",81,17,64,23,17,6,35,25,10,27,18,9,,,,11,16,13,3,0,0,0,10,33,16,12,4,23,0,2,,,2,0,2,,,
"May 4, 2023 8:00 PM",47,9,38,12,9,3,25,12,13,18,8,10,,,,6,12,9,3,0,0,0,8,16,6,5,1,11,1,0,,,0,0,0,,,
"May 4, 2023 9:00 PM",35,8,27,9,9,0,19,11,8,14,7,7,,,,3,6,5,1,0,0,0,6,18,5,5,0,14,0,0,,,0,0,0,,,
"May 4, 2023 10:00 PM",24,4,20,5,3,2,7,3,4,7,3,4,,,,2,5,3,2,0,0,0,3,7,1,1,0,10,1,0,,,1,1,0,,,
"May 4, 2023 11:00 PM",15,4,11,7,6,1,5,3,2,2,0,2,,,,2,3,1,2,0,0,0,1,3,3,2,1,2,1,0,,,1,0,1,,,
"May 5, 2023 12:00 AM",2,0,2,0,0,0,1,1,0,3,3,0,,,,0,2,0,2,0,0,0,0,0,1,1,0,1,0,0,,,0,0,0,,,
"May 5, 2023 1:00 AM",3,0,3,0,0,0,4,4,0,1,1,0,,,,0,3,2,1,0,0,0,2,3,1,1,0,2,0,0,,,0,0,0,,,
"May 5, 2023 2:00 AM",2,2,0,0,0,0,0,0,0,0,0,0,,,,0,0,0,0,0,0,0,0,0,0,0,0,0,0,0,,,0,0,0,,,
"May 5, 2023 3:00 AM",0,0,0,0,0,0,1,1,0,0,0,0,,,,0,0,0,0,0,0,0,0,2,0,0,0,0,0,0,,,0,0,0,,,
"May 5, 2023 4:00 AM",2,0,2,0,0,0,0,0,0,0,0,0,,,,0,1,1,0,0,0,0,1,0,0,0,0,1,0,0,,,0,0,0,,,
"May 5, 2023 5:00 AM",9,5,4,3,2,1,6,3,3,5,3,2,,,,1,7,7,0,0,0,0,6,3,2,1,1,6,0,1,,,0,0,0,,,
"May 5, 2023 6:00 AM",46,28,18,26,8,18,26,8,18,20,7,13,,,,4,17,17,0,0,0,0,16,9,13,7,6,25,1,7,,,0,0,0,,,
"May 5, 2023 7:00 AM",90,60,30,50,20,30,69,26,43,56,26,30,,,,21,55,55,0,0,0,0,53,31,26,9,17,72,2,1,,,4,4,0,,,
"May 5, 2023 8:00 AM",197,151,46,83,30,53,111,36,75,83,46,37,,,,29,92,88,4,0,0,0,82,48,47,15,32,135,6,5,,,14,13,1,,,
"May 5, 2023 9:00 AM",120,86,34,53,25,28,71,31,40,62,33,29,,,,20,63,62,1,0,0,0,51,18,34,20,14,65,1,4,,,5,4,1,,,
"May 5, 2023 10:00 AM",52,31,21,45,19,26,62,34,28,37,22,15,,,,6,25,25,0,0,0,0,21,15,31,19,12,26,4,4,,,2,1,1,,,
"May 5, 2023 11:00 AM",56,31,25,67,30,37,85,47,38,64,32,32,,,,7,19,18,1,0,0,0,13,23,38,17,21,17,2,5,,,4,2,2,,,
"May 5, 2023 12:00 PM",52,23,29,63,37,26,93,44,49,61,29,32,,,,8,21,19,2,0,0,0,14,16,31,16,15,24,3,0,,,5,4,1,,,
"May 5, 2023 1:00 PM",78,27,51,43,25,18,83,49,34,58,38,20,,,,16,22,20,2,0,0,0,15,21,33,21,12,40,2,3,,,5,3,2,,,
"May 5, 2023 2:00 PM",54,26,28,23,13,10,46,25,21,33,21,12,,,,14,15,14,1,0,0,0,14,29,41,30,11,29,4,2,,,6,3,3,,,
"May 5, 2023 3:00 PM",92,46,46,67,42,25,75,52,23,60,44,16,,,,23,15,11,4,0,0,0,7,25,45,24,21,15,3,1,,,5,1,4,,,
"May 5, 2023 4:00 PM",132,44,88,70,43,27,96,56,40,83,45,38,,,,26,30,24,6,0,0,0,24,46,48,34,14,39,7,1,,,5,4,1,,,
"May 5, 2023 5:00 PM",159,48,111,86,49,37,126,78,48,101,64,37,,,,21,44,36,8,0,0,0,31,83,58,43,15,47,8,7,,,8,7,1,,,
"May 5, 2023 6:00 PM",136,47,89,104,63,41,136,80,56,108,59,49,,,,29,28,26,2,0,0,0,20,61,72,50,22,39,0,2,,,5,5,0,,,
"May 5, 2023 7:00 PM",97,29,68,86,46,40,83,46,37,75,41,34,,,,18,25,20,5,0,0,0,21,28,47,31,16,31,6,1,,,4,2,2,,,
"May 5, 2023 8:00 PM",64,22,42,59,22,37,62,32,30,34,16,18,,,,12,21,19,2,0,0,0,15,22,35,16,19,23,4,0,,,3,3,0,,,
"May 5, 2023 9:00 PM",50,17,33,33,16,17,46,14,32,26,10,16,,,,42,20,16,4,0,0,0,12,15,25,11,14,15,2,1,,,6,3,3,,,
"May 5, 2023 10:00 PM",51,13,38,12,6,6,16,7,9,13,5,8,,,,5,8,4,4,0,0,0,4,15,14,7,7,6,1,2,,,2,1,1,,,
"May 5, 2023 11:00 PM",32,8,24,4,2,2,23,9,14,14,4,10,,,,7,12,9,3,0,0,0,9,5,8,5,3,10,1,0,,,2,2,0,,,
"May 6, 2023 12:00 AM",7,0,7,0,0,0,3,1,2,3,2,1,,,,1,5,3,2,0,0,0,4,9,6,6,0,6,1,0,,,1,0,1,,,
"May 6, 2023 1:00 AM",15,2,13,0,0,0,10,4,6,3,1,2,,,,1,2,0,2,0,0,0,1,3,1,1,0,4,1,0,,,0,0,0,,,
"May 6, 2023 2:00 AM",10,6,4,2,2,0,0,0,0,0,0,0,,,,0,2,1,1,0,0,0,1,4,3,3,0,0,0,0,,,0,0,0,,,
"May 6, 2023 3:00 AM",6,4,2,1,0,1,4,3,1,0,0,0,,,,0,0,0,0,0,0,0,1,0,3,1,2,4,0,1,,,2,2,0,,,
"May 6, 2023 4:00 AM",10,3,7,0,0,0,5,5,0,2,2,0,,,,0,2,2,0,0,0,0,2,1,1,0,1,4,0,0,,,0,0,0,,,
"May 6, 2023 5:00 AM",7,4,3,8,1,7,10,6,4,2,1,1,,,,2,2,2,0,0,0,0,1,3,3,3,0,1,0,1,,,0,0,0,,,
"May 6, 2023 6:00 AM",13,5,8,11,7,4,18,13,5,13,8,5,,,,4,3,3,0,0,0,0,3,4,5,4,1,8,1,0,,,1,1,0,,,
"May 6, 2023 7:00 AM",26,9,17,30,19,11,31,20,11,26,19,7,,,,8,5,3,2,0,0,0,5,9,9,4,5,19,0,4,,,3,3,0,,,
"May 6, 2023 8:00 AM",40,22,18,53,32,21,50,30,20,45,27,18,,,,24,14,14,0,0,0,0,13,23,26,16,10,20,3,3,,,4,2,2,,,
"May 6, 2023 9:00 AM",55,36,19,81,40,41,87,53,34,69,42,27,,,,12,22,22,0,0,0,0,19,32,32,20,12,29,3,7,,,11,4,7,,,
"May 6, 2023 10:00 AM",63,39,24,111,54,57,110,64,46,101,60,41,,,,18,23,23,0,0,0,0,22,26,29,19,10,22,7,7,,,6,5,1,,,
"May 6, 2023 11:00 AM",57,26,31,87,47,40,124,66,58,90,53,37,,,,19,7,7,0,0,0,0,6,32,48,35,13,43,8,3,,,12,8,4,,,
"May 6, 2023 12:00 PM",80,49,31,132,43,89,139,87,52,94,61,33,,,,22,23,19,4,0,0,0,11,37,39,22,17,33,5,4,,,5,5,0,,,
"May 6, 2023 1:00 PM",70,37,33,79,33,46,114,58,56,86,45,41,,,,16,25,22,3,0,0,0,15,34,43,23,20,34,2,4,,,0,0,0,,,
"May 6, 2023 2:00 PM",67,44,23,77,43,34,93,56,37,83,46,37,,,,15,16,14,2,0,0,0,14,30,41,26,15,40,3,6,,,6,5,1,,,
"May 6, 2023 3:00 PM",53,29,24,95,41,54,96,32,64,88,36,52,,,,21,16,16,0,0,0,0,12,21,34,15,19,29,4,2,,,11,8,3,,,
"May 6, 2023 4:00 PM",65,41,24,85,49,36,87,38,49,74,34,40,,,,15,21,20,1,0,0,0,18,12,40,18,22,35,6,2,,,4,4,0,,,
"May 6, 2023 5:00 PM",50,20,30,95,58,37,94,47,47,80,36,44,,,,16,16,13,3,0,0,0,13,10,47,27,20,25,3,1,,,6,3,3,,,
"May 6, 2023 6:00 PM",43,20,23,42,30,12,42,19,23,46,20,26,,,,3,10,5,5,0,0,0,5,19,27,13,14,20,2,0,,,7,3,4,,,
"May 6, 2023 7:00 PM",63,19,44,16,8,8,32,13,19,30,7,23,,,,5,18,16,2,0,0,0,15,11,23,14,9,19,2,2,,,2,1,1,,,
"May 6, 2023 8:00 PM",51,19,32,20,8,12,23,9,14,12,7,5,,,,6,14,12,2,0,0,0,12,14,10,4,6,14,0,1,,,3,1,2,,,
"May 6, 2023 9:00 PM",22,7,15,12,6,6,21,7,14,14,4,10,,,,4,9,9,0,0,0,0,8,5,6,2,4,18,1,2,,,2,2,0,,,
"May 6, 2023 10:00 PM",19,5,14,10,8,2,12,5,7,6,4,2,,,,4,5,3,2,0,0,0,4,6,1,0,1,7,1,0,,,0,0,0,,,
"May 6, 2023 11:00 PM",16,4,12,7,4,3,14,3,11,12,5,7,,,,5,7,7,0,0,0,0,5,5,9,4,5,6,1,0,,,2,2,0,,,
"May 7, 2023 12:00 AM",8,1,7,0,0,0,2,2,0,4,3,1,,,,0,6,6,0,0,0,0,5,5,6,4,2,2,0,0,,,1,1,0,,,
"May 7, 2023 1:00 AM",5,2,3,3,0,3,4,3,1,4,1,3,,,,0,2,1,1,0,0,0,1,2,2,1,1,3,0,0,,,0,0,0,,,
"May 7, 2023 2:00 AM",4,2,2,0,0,0,2,2,0,0,0,0,,,,0,2,2,0,0,0,0,2,1,1,1,0,2,0,0,,,0,0,0,,,
"May 7, 2023 3:00 AM",2,0,2,0,0,0,1,1,0,0,0,0,,,,0,0,0,0,0,0,0,1,1,1,1,0,0,0,0,,,0,0,0,,,
"May 7, 2023 4:00 AM",6,1,5,0,0,0,0,0,0,0,0,0,,,,0,1,1,0,0,0,0,0,0,0,0,0,0,0,0,,,0,0,0,,,
"May 7, 2023 5:00 AM",4,3,1,6,4,2,4,4,0,3,3,0,,,,1,2,2,0,0,0,0,2,0,1,1,0,0,1,0,,,1,1,0,,,
"May 7, 2023 6:00 AM",9,5,4,7,3,4,12,4,8,8,2,6,,,,2,2,2,0,0,0,0,3,3,5,3,2,6,0,0,,,0,0,0,,,
"May 7, 2023 7:00 AM",17,11,6,32,18,14,38,26,12,31,19,12,,,,7,8,7,1,0,0,0,11,20,19,6,13,13,0,4,,,0,0,0,,,
"May 7, 2023 8:00 AM",27,16,11,115,83,32,121,83,38,121,86,35,,,,15,9,9,0,0,0,0,11,25,28,17,11,22,2,16,,,4,2,2,,,
"May 7, 2023 9:00 AM",63,30,33,126,74,52,111,67,44,96,69,27,,,,11,24,23,1,0,0,0,17,28,33,18,15,33,5,21,,,6,2,4,,,
"May 7, 2023 10:00 AM",74,52,22,159,84,75,141,96,45,117,72,45,,,,14,31,27,4,0,0,0,23,39,67,46,21,53,5,4,,,2,1,1,,,
"May 7, 2023 11:00 AM",70,34,36,177,101,76,197,121,76,177,109,68,,,,18,25,24,1,0,0,0,20,57,80,52,28,54,5,6,,,5,2,3,,,
"May 7, 2023 12:00 PM",72,37,35,219,92,127,273,131,142,185,94,91,,,,24,25,25,0,0,0,0,22,49,81,54,27,70,9,4,,,8,7,1,,,
"May 7, 2023 1:00 PM",82,47,35,161,78,83,240,120,120,146,72,74,,,,23,26,23,3,0,0,0,20,49,117,75,42,48,11,1,,,7,6,1,,,
"May 7, 2023 2:00 PM",67,41,26,167,80,87,233,126,107,177,100,77,,,,16,22,21,1,0,0,0,17,42,118,66,52,65,13,7,,,11,9,2,,,
"May 7, 2023 3:00 PM",56,25,31,177,88,89,198,105,93,168,88,80,,,,10,21,20,1,0,0,0,17,28,89,47,42,50,1,5,,,5,4,1,,,
"May 7, 2023 4:00 PM",57,25,32,145,59,86,185,59,126,141,55,86,,,,21,26,23,3,0,0,0,19,19,92,39,53,41,2,3,,,9,6,3,,,
"May 7, 2023 5:00 PM",68,22,46,109,60,49,136,40,96,96,33,63,,,,19,22,21,1,0,0,0,21,18,60,23,37,35,2,3,,,2,2,0,,,
"May 7, 2023 6:00 PM",79,31,48,49,29,20,67,27,40,57,27,30,,,,8,23,19,4,0,0,0,16,7,32,15,17,27,5,1,,,7,6,1,,,
"May 7, 2023 7:00 PM",65,32,33,32,11,21,49,12,37,49,14,35,,,,15,9,8,1,0,0,0,8,13,32,11,21,23,1,2,,,2,1,1,,,
"May 7, 2023 8:00 PM",38,9,29,28,20,8,28,12,16,19,13,6,,,,2,10,8,2,0,0,0,7,7,23,10,13,16,1,0,,,2,1,1,,,
"May 7, 2023 9:00 PM",28,14,14,14,8,6,14,6,8,14,2,12,,,,4,8,4,4,0,0,0,5,5,9,2,7,7,0,4,,,0,0,0,,,
"May 7, 2023 10:00 PM",29,6,23,3,3,0,8,6,2,5,4,1,,,,4,5,4,1,0,0,0,4,6,3,2,1,2,1,0,,,2,2,0,,,
"May 7, 2023 11:00 PM",14,3,11,0,0,0,1,0,1,1,0,1,,,,0,3,3,0,0,0,0,3,6,2,2,0,3,1,1,,,3,2,1,,,
"May 8, 2023 12:00 AM",4,0,4,0,0,0,3,3,0,0,0,0,,,,1,1,0,1,0,0,0,0,3,2,1,1,1,0,0,,,0,0,0,,,
"May 8, 2023 1:00 AM",3,0,3,0,0,0,1,0,1,1,0,1,,,,0,2,1,1,0,0,0,1,1,0,0,0,1,0,0,,,0,0,0,,,
"May 8, 2023 2:00 AM",3,2,1,0,0,0,1,0,1,0,0,0,,,,0,0,0,0,0,0,0,0,0,0,0,0,1,0,0,,,0,0,0,,,
"May 8, 2023 3:00 AM",1,0,1,0,0,0,0,0,0,1,1,0,,,,1,0,0,0,0,0,0,0,1,0,0,0,0,0,0,,,1,0,1,,,
"May 8, 2023 4:00 AM",2,0,2,0,0,0,0,0,0,0,0,0,,,,0,4,4,0,0,0,0,4,0,0,0,0,2,0,0,,,1,1,0,,,
"May 8, 2023 5:00 AM",7,4,3,1,0,1,6,2,4,4,2,2,,,,1,5,5,0,0,0,0,5,5,0,0,0,4,0,1,,,0,0,0,,,
"May 8, 2023 6:00 AM",46,29,17,11,3,8,13,3,10,10,4,6,,,,7,21,21,0,0,0,0,15,6,4,0,4,32,2,3,,,3,3,0,,,
"May 8, 2023 7:00 AM",121,90,31,37,9,28,49,12,37,38,14,24,,,,17,76,76,0,0,0,0,69,28,19,5,14,90,2,5,,,4,4,0,,,
"May 8, 2023 8:00 AM",242,193,49,62,14,48,99,35,64,61,27,34,,,,36,160,158,2,0,0,0,146,39,58,12,46,184,7,8,,,25,20,5,,,
"May 8, 2023 9:00 AM",142,114,28,48,22,26,71,38,33,59,38,21,,,,14,61,61,0,0,0,0,63,26,40,18,22,62,0,0,,,9,6,3,,,
"May 8, 2023 10:00 AM",36,26,10,38,22,16,44,26,18,37,26,11,,,,10,26,26,0,0,0,0,22,13,24,16,8,26,3,4,,,8,6,2,,,
"May 8, 2023 11:00 AM",48,27,21,50,26,24,48,22,26,43,18,25,,,,3,16,15,1,0,0,0,14,16,19,11,8,17,3,4,,,3,2,1,,,
"May 8, 2023 12:00 PM",48,30,18,41,18,23,55,31,24,44,19,25,,,,17,11,10,1,0,0,0,7,16,24,17,7,26,5,1,,,4,3,1,,,
"May 8, 2023 1:00 PM",60,24,36,50,22,28,70,28,42,52,26,26,,,,10,16,14,2,0,0,0,16,21,30,14,16,14,1,1,,,1,0,1,,,
"May 8, 2023 2:00 PM",80,31,49,50,32,18,59,39,20,27,20,7,,,,11,13,13,0,0,0,0,11,19,32,19,13,27,3,1,,,6,3,3,,,
"May 8, 2023 3:00 PM",88,35,53,42,24,18,55,21,34,37,21,16,,,,19,25,22,3,0,0,0,16,37,31,15,16,35,4,0,,,3,1,2,,,
"May 8, 2023 4:00 PM",121,35,86,58,34,24,98,62,36,58,37,21,,,,19,30,25,5,0,0,0,24,49,38,25,13,42,7,6,,,14,4,10,,,
"May 8, 2023 5:00 PM",193,46,147,79,52,27,101,58,43,84,55,29,,,,29,31,28,3,0,0,0,29,116,53,36,17,57,8,5,,,19,9,10,,,
"May 8, 2023 6:00 PM",179,54,125,66,35,31,102,63,39,77,43,34,,,,21,35,33,2,0,0,0,29,81,54,40,14,27,4,4,,,7,4,3,,,
"May 8, 2023 7:00 PM",70,12,58,42,22,20,49,24,25,45,26,19,,,,12,18,12,6,0,0,0,12,30,22,12,10,22,7,1,,,2,2,0,,,
"May 8, 2023 8:00 PM",48,11,37,8,7,1,21,8,13,18,6,12,,,,12,12,9,3,0,0,0,9,11,9,7,2,10,3,2,,,2,2,0,,,
"May 8, 2023 9:00 PM",41,11,30,23,19,4,29,17,12,26,16,10,,,,8,6,3,3,0,0,0,4,25,10,10,0,16,0,0,,,1,1,0,,,
"May 8, 2023 10:00 PM",15,3,12,8,6,2,10,7,3,8,5,3,,,,2,4,3,1,0,0,0,2,10,4,1,3,3,1,1,,,2,1,1,,,
"May 8, 2023 11:00 PM",8,1,7,0,0,0,5,5,0,5,4,1,,,,1,3,3,0,0,0,0,3,6,6,5,1,1,4,0,,,1,1,0,,,
"May 9, 2023 12:00 AM",2,1,1,0,0,0,0,0,0,1,1,0,,,,0,0,0,0,0,0,0,0,3,1,0,1,2,0,0,,,1,0,1,,,
"May 9, 2023 1:00 AM",1,0,1,0,0,0,1,1,0,1,1,0,,,,0,0,0,0,0,0,0,0,0,1,1,0,0,1,0,,,0,0,0,,,
"May 9, 2023 2:00 AM",3,2,1,1,1,0,2,1,1,0,0,0,,,,0,1,1,0,0,0,0,1,0,1,1,0,0,0,0,,,0,0,0,,,
"May 9, 2023 3:00 AM",0,0,0,0,0,0,0,0,0,0,0,0,,,,0,0,0,0,0,0,0,0,0,0,0,0,1,0,0,,,0,0,0,,,
"May 9, 2023 4:00 AM",2,1,1,0,0,0,0,0,0,0,0,0,,,,0,2,2,0,0,0,0,2,0,0,0,0,1,0,0,,,0,0,0,,,
"May 9, 2023 5:00 AM",11,6,5,2,1,1,4,2,2,2,0,2,,,,3,6,6,0,0,0,0,6,5,1,1,0,9,0,1,,,0,0,0,,,
"May 9, 2023 6:00 AM",59,33,26,22,10,12,41,18,23,25,12,13,,,,9,24,22,2,0,0,0,18,15,12,5,7,39,0,7,,,2,2,0,,,
"May 9, 2023 7:00 AM",174,116,58,56,11,45,69,12,57,52,13,39,,,,22,110,109,1,0,0,0,107,37,34,12,22,157,3,5,,,11,7,4,,,
"May 9, 2023 8:00 AM",300,250,50,91,23,68,161,43,118,109,48,61,,,,55,188,185,3,0,0,0,177,69,88,19,69,268,3,15,,,22,20,2,,,
"May 9, 2023 9:00 AM",121,97,24,79,32,47,92,45,47,84,40,44,,,,21,82,81,1,0,0,0,73,26,45,16,29,93,1,0,,,8,6,2,,,
"May 9, 2023 10:00 AM",62,40,22,53,20,33,70,34,36,48,27,21,,,,11,28,27,1,0,0,0,24,7,29,15,14,38,1,0,,,2,2,0,,,
"May 9, 2023 11:00 AM",52,35,17,60,29,31,84,47,37,71,36,35,,,,6,21,19,2,0,0,0,17,20,26,17,9,23,3,0,,,1,1,0,,,
"May 9, 2023 12:00 PM",64,32,32,57,20,37,79,35,44,63,23,40,,,,13,26,25,1,0,0,0,23,25,27,13,14,24,3,0,,,5,3,2,,,
"May 9, 2023 1:00 PM",85,42,43,55,26,29,74,37,37,49,30,19,,,,17,17,12,5,0,0,0,6,25,41,26,15,21,3,0,,,7,3,4,,,
"May 9, 2023 2:00 PM",60,34,26,52,27,25,63,32,31,33,21,12,,,,19,24,20,4,0,0,0,18,20,26,10,16,34,8,0,,,4,2,2,,,
"May 9, 2023 3:00 PM",81,32,49,50,28,22,64,32,32,39,23,16,,,,22,32,29,3,0,0,0,21,27,23,13,10,34,4,0,,,4,0,4,,,
"May 9, 2023 4:00 PM",152,45,107,41,27,14,95,59,36,59,35,24,,,,23,31,22,9,0,0,0,19,60,53,38,15,36,5,0,,,7,6,1,,,
"May 9, 2023 5:00 PM",237,59,178,79,39,40,133,87,46,95,54,41,,,,32,32,24,8,0,0,0,26,127,75,52,23,71,13,0,,,8,5,3,,,
"May 9, 2023 6:00 PM",189,45,144,73,51,22,115,97,18,86,71,15,,,,18,35,29,6,0,0,0,21,138,70,64,6,45,7,0,,,16,10,6,,,
"May 9, 2023 7:00 PM",151,37,114,53,38,15,83,56,27,61,37,24,,,,11,30,24,6,0,0,0,24,54,55,40,15,18,8,0,,,7,3,4,,,
"May 9, 2023 8:00 PM",101,35,66,31,19,12,44,24,20,38,23,15,,,,11,21,20,1,0,0,0,17,27,23,11,12,17,6,0,,,3,2,1,,,
"May 9, 2023 9:00 PM",55,11,44,43,27,16,36,18,18,28,16,12,,,,5,10,9,1,0,0,0,10,15,21,14,7,10,0,0,,,0,0,0,,,
"May 9, 2023 10:00 PM",37,5,32,17,16,1,18,9,9,16,7,9,,,,2,12,5,7,0,0,0,5,15,9,8,1,11,1,0,,,6,2,4,,,
"May 9, 2023 11:00 PM",18,1,17,5,4,1,5,4,1,6,2,4,,,,3,4,3,1,0,0,0,2,9,4,4,0,3,2,0,,,3,2,1,,,
"May 10, 2023 12:00 AM",6,2,4,0,0,0,4,4,0,4,2,2,,,,0,0,0,0,0,0,0,0,4,4,3,1,2,0,0,,,2,1,1,,,
"May 10, 2023 1:00 AM",1,0,1,1,1,0,3,2,1,5,3,2,,,,0,3,3,0,0,0,0,2,4,1,1,0,0,0,0,,,1,1,0,,,
"May 10, 2023 2:00 AM",1,1,0,0,0,0,0,0,0,0,0,0,,,,0,0,0,0,0,0,0,0,0,0,0,0,0,0,0,,,0,0,0,,,
"May 10, 2023 3:00 AM",1,1,0,0,0,0,0,0,0,0,0,0,,,,0,0,0,0,0,0,0,0,0,0,0,0,0,0,0,,,0,0,0,,,
"May 10, 2023 4:00 AM",3,1,2,0,0,0,0,0,0,0,0,0,,,,0,3,2,1,0,0,0,3,0,0,0,0,1,0,0,,,0,0,0,,,
"May 10, 2023 5:00 AM",13,10,3,1,1,0,3,1,2,2,1,1,,,,1,5,5,0,0,0,0,5,2,0,0,0,7,0,0,,,0,0,0,,,
"May 10, 2023 6:00 AM",54,31,23,15,5,10,26,10,16,19,7,12,,,,9,21,21,0,0,0,0,18,13,7,3,4,36,1,0,,,4,3,1,,,
"May 10, 2023 7:00 AM",161,108,53,55,19,36,77,20,57,71,25,46,,,,14,103,101,2,0,0,0,103,43,37,7,30,139,6,0,,,13,11,2,,,
"May 10, 2023 8:00 AM",292,232,60,102,29,73,157,41,116,118,50,68,,,,48,174,171,3,0,0,0,164,49,88,26,62,249,7,0,,,28,26,2,,,
"May 10, 2023 9:00 AM",127,104,23,47,19,28,73,42,31,68,45,23,,,,17,76,75,1,0,0,0,68,20,33,14,19,92,2,0,,,5,3,2,,,
"May 10, 2023 10:00 AM",53,37,16,51,19,32,44,18,26,40,17,23,,,,5,29,28,1,0,0,0,22,11,39,24,15,24,2,0,,,2,1,1,,,
"May 10, 2023 11:00 AM",42,27,15,29,14,15,32,17,15,27,15,12,,,,2,21,19,2,0,0,0,14,13,15,9,6,19,0,0,,,0,0,0,,,
"May 10, 2023 12:00 PM",56,27,29,31,17,14,48,28,20,39,22,17,,,,7,29,27,2,0,0,0,23,19,38,21,17,25,4,0,,,9,7,2,,,
"May 10, 2023 1:00 PM",69,27,42,57,36,21,66,41,25,44,30,14,,,,10,17,17,0,0,0,0,10,23,26,10,16,26,3,0,,,15,6,9,,,
"May 10, 2023 2:00 PM",56,21,35,27,13,14,47,30,17,40,22,18,,,,18,15,12,3,0,0,0,11,22,19,14,5,25,8,0,,,11,7,4,,,
"May 10, 2023 3:00 PM",92,38,54,29,15,14,49,26,23,34,18,16,,,,16,17,15,2,0,0,0,12,33,25,15,10,23,3,0,,,5,1,4,,,
"May 10, 2023 4:00 PM",144,43,101,58,31,27,85,42,43,55,32,23,,,,21,38,28,10,0,0,0,28,49,32,24,8,33,0,0,,,7,4,3,,,
"May 10, 2023 5:00 PM",257,58,199,93,66,27,127,88,39,103,64,39,,,,28,46,38,8,0,0,0,35,127,87,66,21,54,8,0,,,12,8,4,,,
"May 10, 2023 6:00 PM",206,52,154,66,48,18,146,102,44,84,52,32,,,,20,33,25,8,0,0,0,27,127,88,72,16,34,9,0,,,16,12,4,,,
"May 10, 2023 7:00 PM",110,39,71,61,45,16,80,52,28,58,40,18,,,,13,27,26,1,0,0,0,21,57,33,22,11,20,9,0,,,10,6,4,,,
"May 10, 2023 8:00 PM",83,20,63,25,14,11,42,21,21,32,14,18,,,,11,18,15,3,0,0,0,14,30,25,17,8,12,8,0,,,9,6,3,,,
"May 10, 2023 9:00 PM",65,17,48,10,4,6,17,9,8,8,2,6,,,,12,9,9,0,0,0,0,8,13,6,5,1,10,4,0,,,0,0,0,,,
"May 10, 2023 10:00 PM",26,4,22,9,6,3,19,11,8,7,5,2,,,,7,8,6,2,0,0,0,6,9,4,3,1,5,2,0,,,3,1,2,,,
"May 10, 2023 11:00 PM",13,3,10,1,1,0,2,1,1,2,0,2,,,,0,3,1,2,0,0,0,1,3,8,6,2,1,2,0,,,1,1,0,,,
"May 11, 2023 12:00 AM",8,2,6,0,0,0,0,0,0,4,4,0,,,,0,1,1,0,0,0,0,1,2,2,1,1,3,1,,,,0,0,0,,,
"May 11, 2023 1:00 AM",0,0,0,0,0,0,1,1,0,0,0,0,,,,1,2,1,1,0,0,0,0,2,0,0,0,0,0,,,,0,0,0,,,
"May 11, 2023 2:00 AM",2,1,1,0,0,0,0,0,0,0,0,0,,,,0,1,1,0,0,0,0,0,0,2,2,0,2,0,,,,0,0,0,,,
"May 11, 2023 3:00 AM",0,0,0,0,0,0,0,0,0,0,0,0,,,,0,0,0,0,0,0,0,0,0,0,0,0,0,0,,,,1,1,0,,,
"May 11, 2023 4:00 AM",4,2,2,0,0,0,0,0,0,0,0,0,,,,0,4,4,0,0,0,0,4,0,0,0,0,1,0,,,,0,0,0,,,
"May 11, 2023 5:00 AM",4,3,1,3,1,2,4,0,4,3,0,3,,,,3,6,6,0,0,0,0,6,1,1,1,0,5,1,,,,0,0,0,,,
"May 11, 2023 6:00 AM",47,27,20,14,2,12,26,11,15,18,8,10,,,,9,19,18,1,0,0,0,18,12,3,1,2,31,0,,,,3,2,1,,,
"May 11, 2023 7:00 AM",149,97,52,44,12,32,69,17,52,44,11,33,,,,16,86,84,2,0,0,0,81,31,34,13,21,129,2,,,,8,7,1,,,
"May 11, 2023 8:00 AM",259,211,48,92,18,74,128,27,101,99,32,67,,,,29,162,158,4,0,0,0,152,51,80,12,68,205,11,,,,22,16,6,,,
"May 11, 2023 9:00 AM",122,98,24,57,16,41,87,33,54,67,31,36,,,,14,94,92,2,0,0,0,70,18,40,13,27,100,1,,,,5,4,1,,,
"May 11, 2023 10:00 AM",54,41,13,38,20,18,32,18,14,34,22,12,,,,11,26,25,1,0,0,0,20,8,20,7,13,25,2,,,,2,1,1,,,
"May 11, 2023 11:00 AM",41,29,12,17,7,10,18,6,12,10,2,8,,,,3,19,18,1,0,0,0,16,8,10,6,4,23,1,,,,4,2,2,,,
"May 11, 2023 12:00 PM",35,16,19,15,7,8,16,6,10,10,2,8,,,,4,17,15,2,0,0,0,18,6,16,11,5,18,4,,,,2,2,0,,,
"May 11, 2023 1:00 PM",66,23,43,14,7,7,21,11,10,13,6,7,,,,4,11,10,1,0,0,0,7,17,4,2,2,12,3,,,,4,3,1,,,
"May 11, 2023 2:00 PM",47,14,33,13,9,4,12,8,4,9,4,5,,,,15,11,10,1,0,0,0,11,16,13,7,6,12,0,,,,6,4,2,,,
"May 11, 2023 3:00 PM",77,41,36,14,8,6,35,23,12,27,23,4,,,,9,19,16,3,0,0,0,10,23,10,10,0,30,2,,,,5,1,4,,,
"May 11, 2023 4:00 PM",122,31,91,42,32,10,68,51,17,44,34,10,,,,21,24,17,7,0,0,0,20,58,38,34,4,30,3,,,,7,3,4,,,
"May 11, 2023 5:00 PM",203,52,151,90,40,50,146,105,41,120,86,34,,,,23,36,29,7,0,0,0,31,120,86,68,18,58,10,,,,10,9,1,,,
"May 11, 2023 6:00 PM",171,46,125,91,68,23,138,104,34,92,66,26,,,,17,26,23,3,0,0,0,21,131,72,60,12,47,7,,,,16,9,7,,,
"May 11, 2023 7:00 PM",119,39,80,87,45,42,121,66,55,94,50,44,,,,11,23,20,3,0,0,0,19,47,58,37,21,36,8,,,,10,6,4,,,
"May 11, 2023 8:00 PM",77,24,53,56,32,24,65,34,31,57,31,26,,,,10,17,17,0,0,0,0,17,35,30,18,12,29,11,,,,11,8,3,,,
"May 11, 2023 9:00 PM",63,15,48,38,26,12,51,22,29,44,18,26,,,,7,7,6,1,0,0,0,8,18,21,8,13,22,5,,,,6,2,4,,,
"May 11, 2023 10:00 PM",35,8,27,29,27,2,24,5,19,22,6,16,,,,2,5,4,1,0,0,0,4,7,8,2,6,5,0,,,,5,1,4,,,
"May 11, 2023 11:00 PM",24,5,19,11,11,0,12,5,7,12,2,10,,,,7,4,4,0,0,0,0,4,12,4,3,1,3,1,,,,1,1,0,,,
"May 12, 2023 12:00 AM",7,3,4,0,0,0,4,0,4,8,2,6,,,,0,3,2,1,,,,3,7,4,3,1,6,0,,,,0,0,0,,,
"May 12, 2023 1:00 AM",3,0,3,2,2,0,1,1,0,1,0,1,,,,0,1,1,0,,,,1,3,0,0,0,3,0,,,,1,0,1,,,
"May 12, 2023 2:00 AM",3,3,0,0,0,0,0,0,0,0,0,0,,,,0,0,0,0,,,,0,0,0,0,0,0,0,,,,0,0,0,,,
"May 12, 2023 3:00 AM",2,1,1,0,0,0,0,0,0,0,0,0,,,,0,0,0,0,,,,0,1,0,0,0,1,0,,,,0,0,0,,,
"May 12, 2023 4:00 AM",3,1,2,0,0,0,1,1,0,1,1,0,,,,2,3,3,0,,,,2,1,0,0,0,0,0,,,,1,1,0,,,
"May 12, 2023 5:00 AM",13,11,2,4,2,2,11,7,4,4,2,2,,,,2,3,3,0,,,,4,4,6,6,0,8,0,,,,0,0,0,,,
"May 12, 2023 6:00 AM",49,28,21,28,9,19,38,15,23,26,9,17,,,,5,21,21,0,,,,17,7,17,9,8,41,1,,,,1,1,0,,,
"May 12, 2023 7:00 AM",101,59,42,60,24,36,81,31,50,53,25,28,,,,13,66,66,0,,,,61,37,33,13,20,84,7,,,,10,8,2,,,
"May 12, 2023 8:00 AM",213,164,49,93,35,58,115,35,80,91,38,53,,,,31,111,109,2,,,,98,42,63,23,40,137,8,,,,21,17,4,,,
"May 12, 2023 9:00 AM",101,70,31,56,22,34,87,38,49,64,36,28,,,,14,47,46,1,,,,43,29,45,24,21,74,1,,,,4,3,1,,,
"May 12, 2023 10:00 AM",57,38,19,51,27,24,46,22,24,45,22,23,,,,12,27,26,1,,,,22,14,24,12,12,27,0,,,,1,0,1,,,
"May 12, 2023 11:00 AM",55,36,19,46,17,29,59,31,28,43,24,19,,,,12,26,23,3,,,,19,24,23,14,9,31,4,,,,6,6,0,,,
"May 12, 2023 12:00 PM",60,33,27,47,26,21,53,28,25,48,32,16,,,,10,16,16,0,,,,13,20,22,13,9,35,2,,,,10,4,6,,,
"May 12, 2023 1:00 PM",85,41,44,48,20,28,60,35,25,44,17,27,,,,12,30,30,0,,,,26,33,32,21,11,31,3,,,,14,7,7,,,
"May 12, 2023 2:00 PM",84,39,45,46,30,16,53,25,28,57,30,27,,,,25,21,19,2,,,,21,29,37,19,18,16,2,,,,5,1,4,,,
"May 12, 2023 3:00 PM",90,40,50,62,29,33,73,53,20,55,36,19,,,,25,35,31,4,,,,29,24,36,28,8,35,6,,,,4,3,1,,,
"May 12, 2023 4:00 PM",144,50,94,89,47,42,101,61,40,80,48,32,,,,16,28,23,5,,,,18,58,55,37,18,41,5,,,,6,4,2,,,
"May 12, 2023 5:00 PM",175,57,118,115,73,42,193,115,78,133,76,57,,,,25,26,23,3,,,,24,80,105,74,31,59,12,,,,2,2,0,,,
"May 12, 2023 6:00 PM",160,64,96,110,64,46,187,120,67,94,62,32,,,,23,23,21,2,,,,20,71,88,65,23,42,6,,,,8,7,1,,,
"May 12, 2023 7:00 PM",113,45,68,72,45,27,118,50,68,72,41,31,,,,27,23,20,3,,,,16,38,54,28,26,42,6,,,,5,3,2,,,
"May 12, 2023 8:00 PM",72,20,52,52,26,26,86,35,51,54,27,27,,,,13,15,12,3,,,,10,23,30,13,17,30,3,,,,7,4,3,,,
"May 12, 2023 9:00 PM",43,15,28,39,20,19,39,9,30,31,9,22,,,,5,8,5,3,,,,3,18,25,12,13,24,0,,,,4,2,2,,,
"May 12, 2023 10:00 PM",40,13,27,11,4,7,25,11,14,17,7,10,,,,11,5,2,3,,,,3,10,8,3,5,19,3,,,,7,1,6,,,
"May 12, 2023 11:00 PM",28,9,19,4,4,0,9,5,4,9,5,4,,,,1,6,6,0,,,,6,8,6,4,2,6,2,,,,8,6,2,,,
"May 13, 2023 12:00 AM",14,3,11,0,0,0,0,0,0,5,2,3,,,,2,3,0,3,,,,0,7,2,0,2,7,0,,,,0,0,0,,,
"May 13, 2023 1:00 AM",12,5,7,5,3,2,9,5,4,6,2,4,,,,0,0,0,0,,,,0,5,1,0,1,5,0,,,,0,0,0,,,
"May 13, 2023 2:00 AM",6,1,5,1,1,0,3,3,0,3,3,0,,,,0,0,0,0,,,,0,2,2,2,0,1,0,,,,0,0,0,,,
"May 13, 2023 3:00 AM",4,2,2,0,0,0,3,1,2,1,1,0,,,,0,0,0,0,,,,0,3,0,0,0,2,0,,,,0,0,0,,,
"May 13, 2023 4:00 AM",5,3,2,2,0,2,4,3,1,2,0,2,,,,0,1,1,0,,,,1,0,3,3,0,1,0,,,,0,0,0,,,
"May 13, 2023 5:00 AM",3,2,1,2,1,1,11,10,1,1,1,0,,,,2,2,2,0,,,,2,1,3,2,1,1,0,,,,0,0,0,,,
"May 13, 2023 6:00 AM",10,5,5,14,5,9,29,10,19,8,5,3,,,,4,5,5,0,,,,5,6,9,5,4,8,0,,,,0,0,0,,,
"May 13, 2023 7:00 AM",20,10,10,37,20,17,38,20,18,31,19,12,,,,7,4,4,0,,,,2,18,17,7,10,16,1,,,,0,0,0,,,
"May 13, 2023 8:00 AM",35,16,19,40,17,23,67,46,21,38,19,19,,,,8,28,25,3,,,,26,21,22,16,6,26,1,,,,8,4,4,,,
"May 13, 2023 9:00 AM",62,33,29,98,63,35,106,70,36,91,68,23,,,,9,22,21,1,,,,20,24,45,30,15,29,5,,,,8,5,3,,,
"May 13, 2023 10:00 AM",58,27,31,113,59,54,122,63,59,99,65,34,,,,14,29,27,2,,,,26,33,41,33,8,31,4,,,,11,8,3,,,
"May 13, 2023 11:00 AM",57,30,27,136,75,61,122,70,52,120,65,55,,,,15,15,13,2,,,,10,35,67,42,25,36,6,,,,11,5,6,,,
"May 13, 2023 12:00 PM",75,40,35,144,54,90,147,82,65,144,87,57,,,,19,26,25,1,,,,16,31,51,28,23,43,19,,,,15,12,3,,,
"May 13, 2023 1:00 PM",67,37,30,133,70,63,133,83,50,138,88,50,,,,26,23,21,2,,,,19,33,70,52,18,50,4,,,,9,6,3,,,
"May 13, 2023 2:00 PM",73,43,30,148,78,70,120,70,50,135,85,50,,,,27,24,23,1,,,,21,38,70,42,28,39,6,,,,10,8,2,,,
"May 13, 2023 3:00 PM",82,45,37,125,65,60,123,61,62,104,50,54,,,,29,23,22,1,,,,22,32,69,32,37,45,8,,,,11,6,5,,,
"May 13, 2023 4:00 PM",85,47,38,97,43,54,130,60,70,106,44,62,,,,19,22,20,2,,,,20,31,66,37,29,41,7,,,,7,6,1,,,
"May 13, 2023 5:00 PM",58,30,28,114,73,41,129,55,74,120,55,65,,,,21,19,19,0,,,,19,23,66,28,38,36,6,,,,15,8,7,,,
"May 13, 2023 6:00 PM",67,27,40,94,51,43,108,47,61,83,33,50,,,,14,11,10,1,,,,7,24,51,32,19,31,9,,,,8,7,1,,,
"May 13, 2023 7:00 PM",59,27,32,51,17,34,86,36,50,43,19,24,,,,16,19,15,4,,,,17,31,34,20,14,25,0,,,,4,2,2,,,
"May 13, 2023 8:00 PM",75,17,58,34,19,15,61,23,38,31,11,20,,,,17,16,15,1,,,,16,14,42,20,22,25,0,,,,4,2,2,,,
"May 13, 2023 9:00 PM",30,10,20,13,5,8,31,13,18,15,5,10,,,,4,12,11,1,,,,13,7,22,10,12,11,0,,,,3,1,2,,,
"May 13, 2023 10:00 PM",16,4,12,3,3,0,12,4,8,7,1,6,,,,2,2,2,0,,,,2,3,10,6,4,9,3,,,,6,1,5,,,
"May 13, 2023 11:00 PM",16,4,12,5,4,1,8,3,5,5,3,2,,,,4,7,5,2,,,,6,3,7,0,7,7,1,,,,0,0,0,,,
"May 14, 2023 12:00 AM",8,1,7,0,0,0,5,2,3,8,1,7,,,,0,3,3,0,,,,2,4,0,0,0,5,0,,,,0,0,0,,,
"May 14, 2023 1:00 AM",12,4,8,3,3,0,7,4,3,3,3,0,,,,0,3,2,1,,,,1,3,1,1,0,7,1,,,,0,0,0,,,
"May 14, 2023 2:00 AM",6,1,5,1,0,1,5,3,2,3,2,1,,,,0,5,5,0,,,,5,0,2,2,0,6,1,,,,1,1,0,,,
"May 14, 2023 3:00 AM",2,1,1,1,1,0,0,0,0,1,1,0,,,,0,0,0,0,,,,0,0,0,0,0,1,0,,,,0,0,0,,,
"May 14, 2023 4:00 AM",4,0,4,1,0,1,2,1,1,2,1,1,,,,0,2,0,2,,,,1,0,3,2,1,1,0,,,,0,0,0,,,
"May 14, 2023 5:00 AM",2,2,0,2,0,2,5,2,3,3,0,3,,,,2,0,0,0,,,,0,0,2,0,2,2,0,,,,1,1,0,,,
"May 14, 2023 6:00 AM",6,2,4,8,3,5,9,5,4,4,1,3,,,,1,1,1,0,,,,1,1,2,2,0,6,0,,,,1,1,0,,,
"May 14, 2023 7:00 AM",11,6,5,18,9,9,28,18,10,19,12,7,,,,6,6,6,0,,,,7,10,9,5,4,12,0,,,,1,1,0,,,
"May 14, 2023 8:00 AM",34,20,14,47,34,13,64,48,16,46,36,10,,,,9,12,11,1,,,,6,31,15,14,1,16,1,,,,4,2,2,,,
"May 14, 2023 9:00 AM",44,24,20,86,49,37,121,73,48,83,59,24,,,,11,22,22,0,,,,21,28,31,22,9,51,3,,,,8,4,4,,,
"May 14, 2023 10:00 AM",41,15,26,117,71,46,126,75,51,103,68,35,,,,14,25,24,1,,,,19,24,50,40,10,28,1,,,,11,4,7,,,
"May 14, 2023 11:00 AM",49,22,27,112,47,65,114,53,61,119,55,64,,,,8,18,17,1,,,,13,21,41,25,16,41,7,,,,5,2,3,,,
"May 14, 2023 12:00 PM",65,38,27,112,51,61,79,28,51,97,48,49,,,,4,20,17,3,,,,17,28,29,18,11,44,6,,,,13,10,3,,,
"May 14, 2023 1:00 PM",51,20,31,76,29,47,77,31,46,75,33,42,,,,9,16,15,1,,,,11,29,32,15,17,24,2,,,,2,2,0,,,
"May 14, 2023 2:00 PM",38,22,16,80,42,38,62,33,29,72,37,35,,,,10,19,18,1,,,,14,16,42,29,13,26,7,,,,6,5,1,,,
"May 14, 2023 3:00 PM",53,32,21,64,37,27,76,39,37,60,28,32,,,,16,21,19,2,,,,15,20,44,26,18,27,6,,,,10,6,4,,,
"May 14, 2023 4:00 PM",56,28,28,71,40,31,71,34,37,65,31,34,,,,10,16,13,3,,,,14,28,50,24,26,21,2,,,,5,4,1,,,
"May 14, 2023 5:00 PM",36,15,21,73,31,42,64,27,37,67,28,39,,,,9,11,10,1,,,,7,19,36,20,16,36,4,,,,10,7,3,,,
"May 14, 2023 6:00 PM",42,11,31,59,26,33,61,24,37,43,17,26,,,,20,9,7,2,,,,7,12,31,20,11,35,3,,,,8,5,3,,,
"May 14, 2023 7:00 PM",42,23,19,30,19,11,35,15,20,42,26,16,,,,10,9,8,1,,,,8,10,31,14,17,18,5,,,,5,1,4,,,
"May 14, 2023 8:00 PM",41,13,28,15,5,10,38,14,24,9,2,7,,,,5,9,7,2,,,,8,2,24,8,16,8,2,,,,5,4,1,,,
"May 14, 2023 9:00 PM",30,11,19,14,7,7,14,5,9,12,4,8,,,,11,6,5,1,,,,4,3,15,3,12,5,3,,,,6,3,3,,,
"May 14, 2023 10:00 PM",11,7,4,3,3,0,8,3,5,4,1,3,,,,5,6,3,3,,,,4,5,8,2,6,6,0,,,,0,0,0,,,
"May 14, 2023 11:00 PM",5,2,3,1,1,0,6,1,5,5,1,4,,,,5,2,2,0,,,,2,4,1,0,1,8,0,,,,2,0,2,,,
"May 15, 2023 12:00 AM",6,2,4,0,0,0,1,1,0,2,0,2,,,,1,2,2,0,,,,2,1,2,1,1,0,1,,,,1,1,0,,,
"May 15, 2023 1:00 AM",2,0,2,0,0,0,1,1,0,1,1,0,,,,1,3,3,0,,,,2,1,3,3,0,1,0,,,,0,0,0,,,
"May 15, 2023 2:00 AM",0,0,0,0,0,0,1,0,1,0,0,0,,,,0,0,0,0,,,,0,2,0,0,0,0,0,,,,0,0,0,,,
"May 15, 2023 3:00 AM",4,2,2,0,0,0,1,0,1,0,0,0,,,,0,0,0,0,,,,0,0,1,0,1,0,0,,,,0,0,0,,,
"May 15, 2023 4:00 AM",1,0,1,0,0,0,1,1,0,0,0,0,,,,0,2,2,0,,,,2,0,1,1,0,2,0,,,,0,0,0,,,
"May 15, 2023 5:00 AM",10,7,3,3,0,3,9,4,5,8,3,5,,,,1,8,8,0,,,,9,3,3,2,1,8,0,,,,0,0,0,,,
"May 15, 2023 6:00 AM",56,32,24,24,8,16,33,13,20,18,6,12,,,,11,17,17,0,,,,16,8,11,6,5,42,0,,,,1,1,0,,,
"May 15, 2023 7:00 AM",150,108,42,51,17,34,82,26,56,57,23,34,,,,11,97,95,2,,,,89,37,28,8,20,126,5,,,,6,5,1,,,
"May 15, 2023 8:00 AM",246,189,57,105,26,79,156,39,117,100,34,66,,,,41,182,179,3,,,,159,49,86,17,69,228,12,,,,32,28,4,,,
"May 15, 2023 9:00 AM",125,106,19,66,24,42,97,51,46,67,39,28,,,,14,71,71,0,,,,61,30,53,19,34,83,1,,,,6,4,2,,,
"May 15, 2023 10:00 AM",51,40,11,53,29,24,72,39,33,53,31,22,,,,9,27,27,0,,,,26,11,28,16,12,28,5,,,,2,1,1,,,
"May 15, 2023 11:00 AM",47,35,12,47,19,28,55,21,34,42,19,23,,,,5,20,17,3,,,,12,13,17,9,8,27,2,,,,2,2,0,,,
"May 15, 2023 12:00 PM",55,30,25,42,17,25,48,25,23,39,20,19,,,,8,21,19,2,,,,18,17,17,12,5,23,3,,,,0,0,0,,,
"May 15, 2023 1:00 PM",70,35,35,36,21,15,77,38,39,51,26,25,,,,13,26,25,1,,,,23,22,28,17,11,19,6,,,,6,2,4,,,
"May 15, 2023 2:00 PM",74,30,44,38,22,16,51,26,25,34,16,18,,,,19,9,7,2,,,,7,17,25,17,8,22,4,,,,13,6,7,,,
"May 15, 2023 3:00 PM",105,42,63,47,28,19,62,43,19,48,32,16,,,,25,29,26,3,,,,16,35,28,15,13,33,7,,,,15,10,5,,,
"May 15, 2023 4:00 PM",146,49,97,57,39,18,70,42,28,54,32,22,,,,19,28,25,3,,,,26,45,41,27,14,39,4,,,,8,4,4,,,
"May 15, 2023 5:00 PM",226,69,157,101,73,28,134,87,47,116,70,46,,,,41,34,30,4,,,,31,125,82,63,19,71,7,,,,5,1,4,,,
"May 15, 2023 6:00 PM",189,46,143,100,60,40,142,102,40,93,57,36,,,,30,39,32,7,,,,28,127,82,68,14,40,9,,,,13,8,5,,,
"May 15, 2023 7:00 PM",103,29,74,77,47,30,128,74,54,90,51,39,,,,20,22,18,4,,,,18,46,54,39,15,33,7,,,,14,12,2,,,
"May 15, 2023 8:00 PM",76,23,53,41,27,14,78,45,33,56,31,25,,,,12,19,14,5,,,,12,24,35,22,13,24,9,,,,6,1,5,,,
"May 15, 2023 9:00 PM",42,13,29,34,23,11,52,21,31,37,15,22,,,,15,16,11,5,,,,9,24,20,10,10,18,2,,,,2,2,0,,,
"May 15, 2023 10:00 PM",23,7,16,5,5,0,14,7,7,9,6,3,,,,1,5,3,2,,,,3,10,7,3,4,7,2,,,,1,0,1,,,
"May 15, 2023 11:00 PM",10,2,8,2,2,0,7,3,4,8,5,3,,,,3,8,6,2,,,,5,12,4,2,2,2,1,,,,1,1,0,,,
"May 16, 2023 12:00 AM",9,3,6,0,0,0,0,0,0,0,0,0,,,,0,0,0,0,,,,0,3,0,0,0,0,0,,,,0,0,0,,,
"May 16, 2023 1:00 AM",4,1,3,0,0,0,1,1,0,0,0,0,,,,0,0,0,0,,,,0,0,1,1,0,0,0,,,,0,0,0,,,
"May 16, 2023 2:00 AM",4,3,1,0,0,0,2,1,1,0,0,0,,,,2,1,1,0,,,,1,0,0,0,0,0,0,,,,0,0,0,,,
"May 16, 2023 3:00 AM",3,2,1,0,0,0,0,0,0,0,0,0,,,,0,0,0,0,,,,0,0,0,0,0,0,0,,,,0,0,0,,,
"May 16, 2023 4:00 AM",3,2,1,0,0,0,0,0,0,1,1,0,,,,1,0,0,0,,,,0,0,0,0,0,2,0,,,,0,0,0,,,
"May 16, 2023 5:00 AM",11,8,3,3,1,2,10,4,6,7,3,4,,,,4,6,6,0,,,,6,6,4,2,2,7,0,,,,1,1,0,,,
"May 16, 2023 6:00 AM",59,32,27,22,11,11,38,19,19,29,14,15,,,,15,30,30,0,,,,30,11,10,7,3,47,1,,,,3,2,1,,,
"May 16, 2023 7:00 AM",194,141,53,61,13,48,89,16,73,54,15,39,,,,21,93,92,1,,,,85,48,51,17,34,151,5,,,,6,6,0,,,
"May 16, 2023 8:00 AM",323,255,68,104,16,88,181,48,133,123,39,84,,,,42,202,200,2,,,,195,59,108,27,81,304,12,,,,18,15,3,,,
"May 16, 2023 9:00 AM",140,115,25,75,27,48,117,60,57,99,57,42,,,,13,100,100,0,,,,90,32,49,23,26,98,3,,,,8,5,3,,,
"May 16, 2023 10:00 AM",64,43,21,67,36,31,90,49,41,52,31,21,,,,20,35,34,1,,,,29,22,34,16,18,30,4,,,,7,7,0,,,
"May 16, 2023 11:00 AM",51,35,16,45,20,25,79,44,35,46,22,24,,,,10,23,23,0,,,,21,17,36,24,12,25,3,,,,4,3,1,,,
"May 16, 2023 12:00 PM",78,37,41,68,38,30,97,47,50,49,25,24,,,,17,30,29,1,,,,22,24,30,18,12,33,4,,,,4,3,1,,,
"May 16, 2023 1:00 PM",93,26,67,71,37,34,69,31,38,58,35,23,,,,17,27,23,4,,,,26,29,39,24,15,37,7,,,,7,4,3,,,
"May 16, 2023 2:00 PM",90,39,51,36,21,15,58,34,24,51,32,19,,,,15,23,21,2,,,,20,26,38,21,17,32,5,,,,6,2,4,,,
"May 16, 2023 3:00 PM",107,41,66,69,39,30,85,45,40,63,35,28,,,,17,40,36,4,,,,31,41,49,32,17,29,3,,,,9,3,6,,,
"May 16, 2023 4:00 PM",141,49,92,70,45,25,102,63,39,79,44,35,,,,17,25,22,3,,,,25,85,74,56,18,44,5,,,,7,4,3,,,
"May 16, 2023 5:00 PM",277,80,197,131,68,63,181,115,66,140,81,59,,,,36,47,39,8,,,,40,169,90,69,21,76,9,,,,10,8,2,,,
"May 16, 2023 6:00 PM",216,64,152,102,79,23,152,118,34,117,86,31,,,,49,30,29,1,,,,29,144,92,77,15,50,7,,,,5,3,2,,,
"May 16, 2023 7:00 PM",154,49,105,109,64,45,112,76,36,110,63,47,,,,26,26,19,7,,,,18,58,68,49,19,37,5,,,,6,4,2,,,
"May 16, 2023 8:00 PM",83,16,67,55,32,23,73,30,43,52,28,24,,,,12,18,14,4,,,,14,32,51,18,33,25,9,,,,6,3,3,,,
"May 16, 2023 9:00 PM",56,14,42,42,31,11,51,27,24,36,14,22,,,,7,14,12,2,,,,11,14,26,18,8,18,3,,,,5,2,3,,,
"May 16, 2023 10:00 PM",30,4,26,18,17,1,16,4,12,11,4,7,,,,3,7,5,2,,,,2,14,10,5,5,12,2,,,,1,1,0,,,
"May 16, 2023 11:00 PM",16,3,13,2,2,0,8,4,4,4,1,3,,,,0,4,2,2,,,,2,7,8,3,5,9,2,,,,0,0,0,,,
"May 17, 2023 12:00 AM",11,2,9,0,0,0,1,0,1,4,1,3,,,,0,4,2,2,,,,2,0,2,0,2,11,0,,,,1,1,0,,,
"May 17, 2023 1:00 AM",5,1,4,0,0,0,2,2,0,2,2,0,,,,0,1,1,0,,,,1,0,0,0,0,1,0,,,,0,0,0,,,
"May 17, 2023 2:00 AM",3,3,0,0,0,0,0,0,0,0,0,0,,,,2,1,1,0,,,,1,0,0,0,0,2,0,,,,0,0,0,,,
"May 17, 2023 3:00 AM",2,1,1,0,0,0,0,0,0,0,0,0,,,,0,1,1,0,,,,1,0,0,0,0,0,0,,,,0,0,0,,,
"May 17, 2023 4:00 AM",2,1,1,0,0,0,0,0,0,1,1,0,,,,0,4,4,0,,,,4,0,0,0,0,2,0,,,,0,0,0,,,
"May 17, 2023 5:00 AM",13,9,4,1,0,1,5,3,2,4,4,0,,,,2,8,8,0,,,,8,1,1,0,1,5,0,,,,1,1,0,,,
"May 17, 2023 6:00 AM",60,37,23,19,5,14,29,9,20,16,3,13,,,,9,25,25,0,,,,23,12,6,2,4,46,1,,,,3,2,1,,,
"May 17, 2023 7:00 AM",166,115,51,65,19,46,100,30,70,73,26,47,,,,23,130,130,0,,,,121,29,45,16,29,146,11,,,,5,4,1,,,
"May 17, 2023 8:00 AM",324,259,65,99,26,73,177,62,115,129,55,74,,,,44,222,217,5,,,,201,56,91,22,69,256,6,,,,18,12,6,,,
"May 17, 2023 9:00 AM",128,102,26,66,26,40,104,50,54,88,53,35,,,,10,89,89,0,,,,69,33,57,26,31,107,3,,,,9,7,2,,,
"May 17, 2023 10:00 AM",54,42,12,66,27,39,83,42,41,73,42,31,,,,13,39,38,1,,,,27,14,55,34,21,46,7,,,,3,2,1,,,
"May 17, 2023 11:00 AM",70,46,24,59,33,26,73,38,35,36,21,15,,,,9,28,26,2,,,,21,9,44,21,23,26,7,,,,4,4,0,,,
"May 17, 2023 12:00 PM",75,37,38,50,23,27,89,43,46,57,28,29,,,,4,30,27,3,,,,22,23,41,15,26,36,2,,,,4,2,2,,,
"May 17, 2023 1:00 PM",107,49,58,66,34,32,97,51,46,72,39,33,,,,9,26,22,4,,,,17,30,52,31,21,29,5,,,,8,4,4,,,
"May 17, 2023 2:00 PM",64,30,34,66,33,33,73,35,38,64,34,30,,,,12,17,13,4,,,,13,32,46,30,16,41,7,,,,12,9,3,,,
"May 17, 2023 3:00 PM",104,34,70,59,37,22,78,44,34,51,29,22,,,,16,19,17,2,,,,12,35,58,34,24,31,7,,,,12,4,8,,,
"May 17, 2023 4:00 PM",141,44,97,84,38,46,100,55,45,84,43,41,,,,25,44,33,11,,,,31,56,44,29,15,46,5,,,,8,5,3,,,
"May 17, 2023 5:00 PM",253,72,181,123,88,35,173,113,60,144,96,48,,,,42,36,31,5,,,,37,147,107,79,28,79,18,,,,7,7,0,,,
"May 17, 2023 6:00 PM",223,59,164,140,85,55,192,148,44,141,97,44,,,,34,36,29,7,,,,28,124,93,72,21,52,15,,,,6,3,3,,,
"May 17, 2023 7:00 PM",162,50,112,114,66,48,147,84,63,114,65,49,,,,25,34,32,2,,,,29,65,74,51,23,39,5,,,,5,3,2,,,
"May 17, 2023 8:00 PM",96,27,69,83,45,38,103,44,59,72,31,41,,,,15,17,14,3,,,,17,21,50,27,23,27,5,,,,6,4,2,,,
"May 17, 2023 9:00 PM",51,15,36,23,14,9,49,11,38,34,10,24,,,,8,12,10,2,,,,11,10,26,17,9,21,6,,,,2,1,1,,,
"May 17, 2023 10:00 PM",49,17,32,12,9,3,18,9,9,12,5,7,,,,8,11,9,2,,,,9,13,9,7,2,17,4,,,,4,3,1,,,
"May 17, 2023 11:00 PM",15,3,12,6,3,3,9,5,4,6,4,2,,,,1,8,3,5,,,,2,11,4,1,3,3,1,,,,1,1,0,,,
"May 18, 2023 12:00 AM",9,1,8,0,0,0,2,2,0,1,0,1,,,,2,2,2,0,,,,0,6,1,1,0,1,0,,,,0,0,0,,,
"May 18, 2023 1:00 AM",1,0,1,0,0,0,1,0,1,1,0,1,,,,0,3,2,1,,,,2,1,1,1,0,0,0,,,,0,0,0,,,
"May 18, 2023 2:00 AM",5,5,0,0,0,0,0,0,0,0,0,0,,,,1,1,1,0,,,,1,0,1,0,1,0,0,,,,0,0,0,,,
"May 18, 2023 3:00 AM",0,0,0,0,0,0,0,0,0,0,0,0,,,,0,0,0,0,,,,0,1,0,0,0,0,0,,,,0,0,0,,,
"May 18, 2023 4:00 AM",2,1,1,0,0,0,1,1,0,1,1,0,,,,0,1,0,1,,,,0,2,1,1,0,0,0,,,,0,0,0,,,
"May 18, 2023 5:00 AM",11,8,3,1,1,0,5,3,2,6,4,2,,,,3,10,10,0,,,,9,4,2,1,1,7,1,,,,0,0,0,,,
"May 18, 2023 6:00 AM",55,35,20,26,9,17,21,9,12,26,11,15,,,,11,21,21,0,,,,19,11,5,3,2,33,1,,,,1,1,0,,,
"May 18, 2023 7:00 AM",140,94,46,64,22,42,92,32,60,57,23,34,,,,19,109,107,2,,,,99,38,33,14,19,130,7,,,,6,5,1,,,
"May 18, 2023 8:00 AM",294,217,77,108,25,83,182,55,127,121,38,83,,,,39,182,180,2,,,,180,54,94,20,74,254,10,,,,24,22,2,,,
"May 18, 2023 9:00 AM",125,102,23,45,24,21,87,43,44,63,41,22,,,,21,79,78,1,,,,62,30,54,20,34,83,3,,,,6,4,2,,,
"May 18, 2023 10:00 AM",59,49,10,64,25,39,57,27,30,64,30,34,,,,10,26,24,2,,,,23,14,38,20,18,25,5,,,,4,3,1,,,
"May 18, 2023 11:00 AM",58,45,13,61,36,25,76,42,34,42,30,12,,,,7,22,22,0,,,,17,12,46,25,21,20,4,,,,5,5,0,,,
"May 18, 2023 12:00 PM",77,38,39,63,31,32,98,51,47,76,43,33,,,,15,29,28,1,,,,27,28,51,26,25,26,3,,,,2,1,1,,,
"May 18, 2023 1:00 PM",86,35,51,62,32,30,90,44,46,59,31,28,,,,14,22,19,3,,,,15,21,30,22,8,38,7,,,,9,7,2,,,
"May 18, 2023 2:00 PM",95,40,55,65,33,32,65,32,33,53,25,28,,,,24,23,19,4,,,,16,22,44,23,21,33,4,,,,9,4,5,,,
"May 18, 2023 3:00 PM",110,48,62,37,17,20,67,42,25,49,30,19,,,,19,27,22,5,,,,18,35,29,14,15,42,5,,,,6,3,3,,,
"May 18, 2023 4:00 PM",129,40,89,64,39,25,113,67,46,80,47,33,,,,29,28,21,7,,,,19,77,37,29,8,56,6,,,,6,3,3,,,
"May 18, 2023 5:00 PM",220,55,165,104,50,54,156,106,50,139,99,40,,,,33,48,43,5,,,,44,137,69,55,14,70,13,,,,12,8,4,,,
"May 18, 2023 6:00 PM",205,44,161,105,66,39,143,99,44,117,80,37,,,,28,43,37,6,,,,33,119,83,66,17,42,5,,,,13,7,6,,,
"May 18, 2023 7:00 PM",127,51,76,108,66,42,110,71,39,107,71,36,,,,21,20,18,2,,,,14,58,50,28,22,29,6,,,,6,5,1,,,
"May 18, 2023 8:00 PM",87,23,64,45,25,20,59,27,32,47,21,26,,,,13,17,15,2,,,,17,26,24,13,11,44,5,,,,4,4,0,,,
"May 18, 2023 9:00 PM",66,14,52,43,38,5,69,27,42,51,18,33,,,,6,9,7,2,,,,6,21,19,11,8,18,5,,,,5,3,2,,,
"May 18, 2023 10:00 PM",29,8,21,19,11,8,32,10,22,21,4,17,,,,2,10,8,2,,,,9,16,7,4,3,13,2,,,,1,1,0,,,
"May 18, 2023 11:00 PM",24,2,22,7,6,1,12,6,6,14,5,9,,,,3,2,1,1,,,,2,9,10,7,3,7,2,,,,2,1,1,,,
"May 19, 2023 12:00 AM",13,3,10,0,0,0,2,1,1,7,3,4,,,,4,5,4,1,,,,5,6,1,1,0,8,1,,,,1,0,1,,,
"May 19, 2023 1:00 AM",3,0,3,3,3,0,2,1,1,1,0,1,,,,0,2,2,0,,,,2,7,1,1,0,0,0,,,,0,0,0,,,
"May 19, 2023 2:00 AM",7,5,2,2,0,2,2,2,0,2,0,2,,,,0,0,0,0,,,,0,1,0,0,0,1,1,,,,0,0,0,,,
"May 19, 2023 3:00 AM",4,1,3,0,0,0,0,0,0,0,0,0,,,,0,0,0,0,,,,0,3,0,0,0,2,0,,,,0,0,0,,,
"May 19, 2023 4:00 AM",5,2,3,2,2,0,3,3,0,1,1,0,,,,1,1,1,0,,,,2,0,0,0,0,2,0,,,,1,1,0,,,
"May 19, 2023 5:00 AM",14,9,5,6,6,0,9,7,2,9,8,1,,,,1,9,9,0,,,,10,6,2,2,0,5,0,,,,0,0,0,,,
"May 19, 2023 6:00 AM",47,25,22,33,16,17,40,24,16,35,20,15,,,,3,19,19,0,,,,17,13,8,4,4,39,1,,,,0,0,0,,,
"May 19, 2023 7:00 AM",113,75,38,87,42,45,86,38,48,71,32,39,,,,13,55,54,1,,,,52,42,25,9,16,96,6,,,,11,9,2,,,
"May 19, 2023 8:00 AM",201,148,53,112,28,84,148,39,109,112,42,70,,,,26,118,116,2,,,,101,52,76,22,54,150,9,,,,18,15,3,,,
"May 19, 2023 9:00 AM",91,66,25,74,36,38,94,54,40,91,54,37,,,,11,55,54,1,,,,48,14,38,26,12,57,4,,,,6,5,1,,,
"May 19, 2023 10:00 AM",53,29,24,57,26,31,68,40,28,46,29,17,,,,7,18,16,2,,,,16,11,21,10,11,33,4,,,,4,3,1,,,
"May 19, 2023 11:00 AM",58,35,23,46,22,24,57,26,31,37,18,19,,,,14,22,22,0,,,,19,16,35,18,17,17,2,,,,3,0,3,,,
"May 19, 2023 12:00 PM",76,40,36,50,19,31,65,37,28,34,17,17,,,,5,24,21,3,,,,13,22,36,23,13,28,5,,,,5,1,4,,,
"May 19, 2023 1:00 PM",84,32,52,41,25,16,93,48,45,60,30,30,,,,14,21,19,2,,,,16,32,44,21,23,44,2,,,,4,1,3,,,
"May 19, 2023 2:00 PM",76,30,46,71,35,36,81,54,27,63,33,30,,,,18,25,22,3,,,,22,33,61,45,16,37,4,,,,6,2,4,,,
"May 19, 2023 3:00 PM",104,46,58,49,29,20,94,51,43,68,43,25,,,,20,25,24,1,,,,21,30,42,25,17,41,4,,,,9,5,4,,,
"May 19, 2023 4:00 PM",121,49,72,82,49,33,111,66,45,86,59,27,,,,17,33,28,5,,,,25,53,56,38,18,45,6,,,,8,4,4,,,
"May 19, 2023 5:00 PM",165,51,114,101,60,41,116,60,56,99,51,48,,,,32,32,26,6,,,,27,78,69,43,26,55,8,,,,11,9,2,,,
"May 19, 2023 6:00 PM",146,52,94,75,49,26,116,78,38,90,52,38,,,,22,40,37,3,,,,39,68,55,33,22,36,5,,,,6,5,1,,,
"May 19, 2023 7:00 PM",96,31,65,53,24,29,62,32,30,45,20,25,,,,26,19,16,3,,,,15,31,33,19,14,24,5,,,,4,1,3,,,
"May 19, 2023 8:00 PM",64,19,45,37,22,15,42,22,20,36,17,19,,,,7,13,11,2,,,,10,22,35,21,14,19,1,,,,3,1,2,,,
"May 19, 2023 9:00 PM",35,11,24,28,23,5,32,15,17,20,10,10,,,,7,6,4,2,,,,6,11,12,9,3,14,2,,,,1,0,1,,,
"May 19, 2023 10:00 PM",37,16,21,11,3,8,27,2,25,12,2,10,,,,4,7,6,1,,,,7,10,9,6,3,14,1,,,,3,2,1,,,
"May 19, 2023 11:00 PM",27,7,20,5,5,0,9,5,4,7,6,1,,,,4,5,4,1,,,,4,11,8,5,3,5,1,,,,1,0,1,,,
"May 20, 2023 12:00 AM",11,4,7,0,0,0,7,3,4,9,5,4,,,,2,0,0,0,,,,1,7,3,3,0,8,0,,,,1,0,1,,,
"May 20, 2023 1:00 AM",5,1,4,4,4,0,8,8,0,5,5,0,,,,1,1,0,1,,,,0,4,2,2,0,4,1,,,,1,1,0,,,
"May 20, 2023 2:00 AM",5,2,3,1,1,0,2,1,1,1,1,0,,,,0,2,2,0,,,,2,2,0,0,0,0,0,,,,0,0,0,,,
"May 20, 2023 3:00 AM",2,1,1,2,1,1,5,4,1,4,4,0,,,,0,0,0,0,,,,1,1,0,0,0,2,0,,,,0,0,0,,,
"May 20, 2023 4:00 AM",3,0,3,2,2,0,2,2,0,0,0,0,,,,0,3,3,0,,,,3,0,1,1,0,1,0,,,,1,1,0,,,
"May 20, 2023 5:00 AM",3,1,2,6,4,2,5,3,2,4,3,1,,,,1,0,0,0,,,,0,2,1,0,1,2,0,,,,0,0,0,,,
"May 20, 2023 6:00 AM",17,10,7,5,4,1,16,12,4,10,7,3,,,,3,2,2,0,,,,2,2,9,6,3,6,0,,,,0,0,0,,,
"May 20, 2023 7:00 AM",23,9,14,30,17,13,41,22,19,31,16,15,,,,6,12,12,0,,,,12,13,15,7,8,23,1,,,,1,1,0,,,
"May 20, 2023 8:00 AM",37,16,21,40,18,22,39,30,9,40,27,13,,,,6,13,13,0,,,,14,23,11,8,3,22,2,,,,4,2,2,,,
"May 20, 2023 9:00 AM",58,29,29,88,39,49,80,44,36,59,40,19,,,,25,23,23,0,,,,25,19,33,17,16,29,5,,,,10,7,3,,,
"May 20, 2023 10:00 AM",49,33,16,93,42,51,123,78,45,93,53,40,,,,15,21,19,2,,,,19,31,50,38,12,28,9,,,,10,9,1,,,
"May 20, 2023 11:00 AM",59,36,23,126,71,55,185,112,73,146,95,51,,,,24,26,23,3,,,,19,35,72,48,24,39,6,,,,11,8,3,,,
"May 20, 2023 12:00 PM",60,32,28,173,76,97,207,108,99,149,93,56,,,,23,13,13,0,,,,10,41,81,50,31,42,5,,,,6,4,2,,,
"May 20, 2023 1:00 PM",73,51,22,142,72,70,155,75,80,114,57,57,,,,9,22,22,0,,,,24,28,76,43,33,36,6,,,,10,9,1,,,
"May 20, 2023 2:00 PM",76,53,23,134,80,54,142,55,87,108,55,53,,,,23,24,24,0,,,,19,28,67,34,33,42,4,,,,4,2,2,,,
"May 20, 2023 3:00 PM",63,37,26,114,50,64,112,44,68,106,43,63,,,,30,33,29,4,,,,29,16,65,34,31,50,4,,,,9,4,5,,,
"May 20, 2023 4:00 PM",55,33,22,88,46,42,110,49,61,84,34,50,,,,11,23,20,3,,,,18,22,42,18,24,31,6,,,,12,8,4,,,
"May 20, 2023 5:00 PM",60,23,37,55,35,20,57,22,35,61,30,31,,,,6,5,5,0,,,,7,20,32,15,17,34,1,,,,4,1,3,,,
"May 20, 2023 6:00 PM",60,23,37,51,26,25,57,25,32,44,16,28,,,,11,13,13,0,,,,10,15,31,11,20,25,7,,,,2,1,1,,,
"May 20, 2023 7:00 PM",55,24,31,30,15,15,41,20,21,34,20,14,,,,10,7,6,1,,,,6,20,26,14,12,12,5,,,,11,6,5,,,
"May 20, 2023 8:00 PM",57,19,38,24,11,13,27,11,16,24,10,14,,,,7,10,10,0,,,,9,5,20,9,11,13,3,,,,9,8,1,,,
"May 20, 2023 9:00 PM",30,10,20,20,10,10,22,8,14,20,8,12,,,,13,7,7,0,,,,7,7,14,4,10,15,0,,,,7,3,4,,,
"May 20, 2023 10:00 PM",29,9,20,5,3,2,9,3,6,7,4,3,,,,1,5,4,1,,,,5,7,2,1,1,7,0,,,,1,0,1,,,
"May 20, 2023 11:00 PM",10,2,8,4,4,0,16,6,10,9,5,4,,,,2,2,2,0,,,,3,6,6,2,4,7,2,,,,4,1,3,,,
"May 21, 2023 12:00 AM",10,2,8,0,0,0,5,5,0,4,2,2,,,,0,4,4,0,,,,4,11,6,4,2,6,1,,,,2,2,0,,,
"May 21, 2023 1:00 AM",14,5,9,4,2,2,5,3,2,6,4,2,,,,0,0,0,0,,,,0,4,2,2,0,1,0,,,,3,2,1,,,
"May 21, 2023 2:00 AM",8,6,2,0,0,0,1,1,0,0,0,0,,,,1,3,3,0,,,,2,3,0,0,0,1,1,,,,0,0,0,,,
"May 21, 2023 3:00 AM",3,3,0,4,2,2,4,2,2,3,2,1,,,,0,0,0,0,,,,1,2,0,0,0,3,0,,,,2,1,1,,,
"May 21, 2023 4:00 AM",2,0,2,1,1,0,3,3,0,0,0,0,,,,0,3,3,0,,,,3,1,3,3,0,0,0,,,,0,0,0,,,
"May 21, 2023 5:00 AM",3,1,2,3,1,2,1,1,0,2,2,0,,,,3,1,1,0,,,,1,2,1,1,0,1,0,,,,0,0,0,,,
"May 21, 2023 6:00 AM",9,6,3,12,7,5,10,7,3,12,8,4,,,,4,3,3,0,,,,4,7,3,3,0,10,1,,,,3,3,0,,,
"May 21, 2023 7:00 AM",23,12,11,27,10,17,29,13,16,26,13,13,,,,4,9,9,0,,,,9,13,11,6,5,17,2,,,,2,2,0,,,
"May 21, 2023 8:00 AM",37,12,25,51,27,24,50,35,15,51,36,15,,,,8,18,18,0,,,,16,23,10,9,1,18,2,,,,5,1,4,,,
"May 21, 2023 9:00 AM",43,24,19,118,58,60,114,79,35,116,79,37,,,,8,15,15,0,,,,14,35,33,26,7,44,1,,,,5,3,2,,,
"May 21, 2023 10:00 AM",70,44,26,119,67,52,104,61,43,98,64,34,,,,17,21,18,3,,,,19,26,47,30,17,32,2,,,,5,2,3,,,
"May 21, 2023 11:00 AM",53,30,23,138,61,77,125,70,55,96,57,39,,,,15,44,41,3,,,,30,35,92,59,33,44,7,,,,6,6,0,,,
"May 21, 2023 12:00 PM",68,33,35,154,81,73,198,108,90,166,106,60,,,,29,24,23,1,,,,26,38,72,42,30,51,4,,,,4,2,2,,,
"May 21, 2023 1:00 PM",69,31,38,187,90,97,227,125,102,150,82,68,,,,18,19,18,1,,,,16,48,89,48,41,38,7,,,,6,5,1,,,
"May 21, 2023 2:00 PM",64,36,28,129,73,56,192,111,81,131,80,51,,,,11,27,25,2,,,,22,29,86,64,22,48,6,,,,9,9,0,,,
"May 21, 2023 3:00 PM",60,30,30,163,81,82,217,103,114,134,66,68,,,,25,17,16,1,,,,10,39,110,53,57,41,8,,,,5,4,1,,,
"May 21, 2023 4:00 PM",69,34,35,162,76,86,174,72,102,146,69,77,,,,24,13,12,1,,,,11,21,91,42,49,34,4,,,,6,3,3,,,
"May 21, 2023 5:00 PM",60,22,38,122,59,63,148,60,88,142,57,85,,,,31,23,18,5,,,,15,19,73,23,50,46,6,,,,10,4,6,,,
"May 21, 2023 6:00 PM",77,33,44,73,36,37,96,46,50,82,38,44,,,,6,17,16,1,,,,14,22,33,15,18,32,1,,,,8,4,4,,,
"May 21, 2023 7:00 PM",51,29,22,63,25,38,61,17,44,55,19,36,,,,16,12,12,0,,,,8,18,37,17,20,22,4,,,,13,8,5,,,
"May 21, 2023 8:00 PM",50,20,30,30,20,10,38,17,21,22,10,12,,,,4,8,7,1,,,,6,9,20,9,11,17,4,,,,3,2,1,,,
"May 21, 2023 9:00 PM",24,12,12,15,6,9,20,7,13,14,8,6,,,,5,11,10,1,,,,10,8,13,4,9,6,7,,,,8,6,2,,,
"May 21, 2023 10:00 PM",16,10,6,3,2,1,10,7,3,9,5,4,,,,4,3,3,0,,,,3,11,9,6,3,9,0,,,,2,1,1,,,
"May 21, 2023 11:00 PM",18,5,13,4,3,1,9,3,6,5,2,3,,,,2,6,6,0,,,,3,6,1,1,0,7,1,,,,2,1,1,,,
"May 22, 2023 12:00 AM",8,4,4,0,0,0,0,0,0,2,2,0,,,,0,0,0,0,,,,1,2,0,0,0,2,0,,,,0,0,0,,,
"May 22, 2023 1:00 AM",6,4,2,0,0,0,1,1,0,0,0,0,,,,2,1,1,0,,,,0,0,0,0,0,1,0,,,,0,0,0,,,
"May 22, 2023 2:00 AM",5,3,2,0,0,0,1,1,0,1,1,0,,,,0,0,0,0,,,,0,0,0,0,0,0,0,,,,0,0,0,,,
"May 22, 2023 3:00 AM",0,0,0,0,0,0,1,1,0,0,0,0,,,,1,0,0,0,,,,0,1,0,0,0,0,0,,,,0,0,0,,,
"May 22, 2023 4:00 AM",1,0,1,0,0,0,0,0,0,0,0,0,,,,0,2,2,0,,,,3,1,0,0,0,0,0,,,,0,0,0,,,
"May 22, 2023 5:00 AM",13,9,4,2,1,1,5,3,2,4,2,2,,,,3,6,5,1,,,,6,4,3,2,1,5,0,,,,0,0,0,,,
"May 22, 2023 6:00 AM",52,33,19,19,7,12,30,10,20,23,9,14,,,,9,25,25,0,,,,22,16,9,4,5,45,0,,,,2,1,1,,,
"May 22, 2023 7:00 AM",121,73,48,51,22,29,73,29,44,53,27,26,,,,14,97,97,0,,,,91,35,29,10,19,109,7,,,,7,5,2,,,
"May 22, 2023 8:00 AM",229,176,53,92,20,72,159,50,109,110,41,69,,,,30,152,151,1,,,,144,54,79,22,57,224,14,,,,21,18,3,,,
"May 22, 2023 9:00 AM",134,111,23,53,20,33,70,35,35,65,38,27,,,,10,65,64,1,,,,50,18,41,18,23,76,5,,,,8,8,0,,,
"May 22, 2023 10:00 AM",53,37,16,47,26,21,50,32,18,52,37,15,,,,11,24,23,1,,,,21,14,22,15,7,33,2,,,,1,0,1,,,
"May 22, 2023 11:00 AM",49,23,26,53,25,28,54,27,27,53,30,23,,,,6,28,27,1,,,,22,16,33,21,12,19,4,,,,4,3,1,,,
"May 22, 2023 12:00 PM",50,28,22,78,49,29,83,52,31,45,25,20,,,,10,13,12,1,,,,8,20,32,23,9,21,5,,,,5,4,1,,,
"May 22, 2023 1:00 PM",70,38,32,50,26,24,89,44,45,52,25,27,,,,18,28,25,3,,,,26,34,47,23,24,19,7,,,,4,2,2,,,
"May 22, 2023 2:00 PM",64,30,34,62,35,27,79,48,31,51,31,20,,,,21,22,20,2,,,,15,24,36,25,11,25,3,,,,7,5,2,,,
"May 22, 2023 3:00 PM",93,34,59,50,30,20,82,35,47,51,29,22,,,,23,27,26,1,,,,24,25,38,22,16,40,6,,,,7,3,4,,,
"May 22, 2023 4:00 PM",142,54,88,66,33,33,101,59,42,75,43,32,,,,18,26,23,3,,,,22,55,59,41,18,51,3,,,,13,5,8,,,
"May 22, 2023 5:00 PM",199,54,145,90,57,33,152,92,60,126,70,56,,,,36,38,34,4,,,,36,121,90,63,27,63,15,,,,7,4,3,,,
"May 22, 2023 6:00 PM",193,71,122,105,66,39,128,89,39,111,70,41,,,,23,29,28,1,,,,30,115,82,61,21,54,8,,,,10,4,6,,,
"May 22, 2023 7:00 PM",93,29,64,90,50,40,106,63,43,91,50,41,,,,30,21,18,3,,,,14,59,49,33,16,32,11,,,,6,3,3,,,
"May 22, 2023 8:00 PM",69,25,44,63,35,28,81,44,37,56,29,27,,,,12,16,15,1,,,,10,26,37,20,17,18,7,,,,4,2,2,,,
"May 22, 2023 9:00 PM",46,10,36,60,39,21,36,21,15,34,18,16,,,,16,9,7,2,,,,7,16,13,3,10,11,2,,,,1,0,1,,,
"May 22, 2023 10:00 PM",25,7,18,21,13,8,24,11,13,22,8,14,,,,5,2,2,0,,,,4,9,3,1,2,8,2,,,,2,2,0,,,
"May 22, 2023 11:00 PM",8,2,6,6,5,1,8,5,3,5,4,1,,,,0,3,2,1,,,,2,10,4,3,1,6,1,,,,1,1,0,,,
"May 23, 2023 12:00 AM",6,1,5,0,0,0,1,1,0,0,0,0,,,,1,1,1,0,,,,1,3,2,2,0,2,0,,,,1,1,0,,,
"May 23, 2023 1:00 AM",1,0,1,0,0,0,0,0,0,0,0,0,,,,0,1,1,0,,,,1,1,0,0,0,0,0,,,,0,0,0,,,
"May 23, 2023 2:00 AM",4,3,1,0,0,0,0,0,0,0,0,0,,,,0,0,0,0,,,,0,0,0,0,0,0,0,,,,0,0,0,,,
"May 23, 2023 3:00 AM",0,0,0,0,0,0,2,2,0,1,1,0,,,,0,0,0,0,,,,1,0,1,1,0,1,0,,,,0,0,0,,,
"May 23, 2023 4:00 AM",3,1,2,0,0,0,1,0,1,1,1,0,,,,1,0,0,0,,,,0,1,0,0,0,1,0,,,,1,1,0,,,
"May 23, 2023 5:00 AM",15,9,6,2,0,2,4,2,2,6,3,3,,,,0,7,7,0,,,,9,4,2,1,1,6,0,,,,0,0,0,,,
"May 23, 2023 6:00 AM",62,39,23,26,6,20,38,10,28,27,8,19,,,,11,23,23,0,,,,21,19,10,3,7,44,3,,,,2,2,0,,,
"May 23, 2023 7:00 AM",137,86,51,54,20,34,79,23,56,59,20,39,,,,28,108,108,0,,,,100,41,44,16,28,164,9,,,,11,10,1,,,
"May 23, 2023 8:00 AM",288,219,69,93,21,72,143,42,101,115,45,70,,,,42,233,231,2,,,,212,70,80,15,65,287,13,,,,24,23,1,,,
"May 23, 2023 9:00 AM",146,116,30,59,25,34,90,48,42,72,46,26,,,,11,89,89,0,,,,78,24,50,20,30,82,3,,,,6,4,2,,,
"May 23, 2023 10:00 AM",62,32,30,49,17,32,59,30,29,51,28,23,,,,17,40,39,1,,,,37,17,27,18,9,34,3,,,,5,3,2,,,
"May 23, 2023 11:00 AM",65,50,15,55,28,27,49,22,27,47,24,23,,,,9,28,27,1,,,,23,17,30,13,17,36,2,,,,4,3,1,,,
"May 23, 2023 12:00 PM",65,30,35,45,21,24,89,47,42,46,24,22,,,,16,31,27,4,,,,19,20,28,15,13,22,2,,,,3,3,0,,,
"May 23, 2023 1:00 PM",70,33,37,37,22,15,88,47,41,48,30,18,,,,23,23,19,4,,,,23,33,41,27,14,36,5,,,,6,5,1,,,
"May 23, 2023 2:00 PM",70,41,29,64,28,36,74,38,36,59,33,26,,,,19,14,13,1,,,,11,34,35,19,16,26,7,,,,10,6,4,,,
"May 23, 2023 3:00 PM",124,47,77,64,32,32,98,56,42,58,33,25,,,,21,23,23,0,,,,16,43,63,42,21,32,6,,,,8,6,2,,,
"May 23, 2023 4:00 PM",130,40,90,85,51,34,135,77,58,82,57,25,,,,22,42,33,9,,,,32,87,79,53,26,60,8,,,,9,6,3,,,
"May 23, 2023 5:00 PM",236,65,171,117,67,50,201,119,82,124,76,48,,,,39,44,36,8,,,,38,156,100,68,32,91,17,,,,20,15,5,,,
"May 23, 2023 6:00 PM",256,72,184,138,97,41,180,125,55,139,92,47,,,,38,29,26,3,,,,29,142,115,83,32,60,6,,,,8,7,1,,,
"May 23, 2023 7:00 PM",144,40,104,129,62,67,175,100,75,139,75,64,,,,21,34,31,3,,,,28,88,75,50,25,53,9,,,,14,6,8,,,
"May 23, 2023 8:00 PM",95,34,61,88,39,49,106,52,54,92,44,48,,,,18,25,23,2,,,,22,35,58,35,23,39,3,,,,4,1,3,,,
"May 23, 2023 9:00 PM",62,21,41,50,31,19,61,28,33,53,23,30,,,,15,15,12,3,,,,13,15,35,20,15,27,3,,,,3,2,1,,,
"May 23, 2023 10:00 PM",41,17,24,29,20,9,26,9,17,21,10,11,,,,1,8,8,0,,,,7,16,11,6,5,12,1,,,,5,4,1,,,
"May 23, 2023 11:00 PM",12,1,11,8,8,0,18,6,12,10,4,6,,,,3,2,1,1,,,,2,5,11,4,7,6,2,,,,1,0,1,,,
"May 24, 2023 12:00 AM",5,1,4,0,0,0,0,0,0,0,0,0,,,,0,5,4,1,,,,4,3,2,2,0,3,0,,,,1,1,0,,,
"May 24, 2023 1:00 AM",1,1,0,0,0,0,2,1,1,0,0,0,,,,0,0,0,0,,,,0,2,0,0,0,1,1,,,,0,0,0,,,
"May 24, 2023 2:00 AM",5,4,1,0,0,0,0,0,0,0,0,0,,,,0,2,2,0,,,,2,0,0,0,0,0,0,,,,0,0,0,,,
"May 24, 2023 3:00 AM",0,0,0,0,0,0,1,1,0,1,1,0,,,,0,0,0,0,,,,0,2,0,0,0,0,0,,,,0,0,0,,,
"May 24, 2023 4:00 AM",5,1,4,0,0,0,2,1,1,1,1,0,,,,0,0,0,0,,,,0,0,0,0,0,1,0,,,,0,0,0,,,
"May 24, 2023 5:00 AM",12,9,3,1,1,0,4,3,1,2,2,0,,,,0,8,8,0,,,,8,5,2,0,2,9,0,,,,0,0,0,,,
"May 24, 2023 6:00 AM",65,39,26,24,9,15,34,7,27,25,10,15,,,,10,28,28,0,,,,25,17,9,4,5,52,0,,,,2,1,1,,,
"May 24, 2023 7:00 AM",156,110,46,76,22,54,111,32,79,80,36,44,,,,15,120,120,0,,,,119,44,58,18,40,144,6,,,,12,9,3,,,
"May 24, 2023 8:00 AM",288,221,67,110,30,80,201,60,141,139,55,84,,,,46,241,234,7,,,,212,79,130,35,95,267,11,,,,19,15,4,,,
"May 24, 2023 9:00 AM",146,113,33,65,29,36,101,54,47,80,54,26,,,,7,83,82,1,,,,75,30,50,18,32,91,5,,,,7,4,3,,,
"May 24, 2023 10:00 AM",62,41,21,56,25,31,63,29,34,57,30,27,,,,9,36,33,3,,,,30,18,19,9,10,27,5,,,,6,3,3,,,
"May 24, 2023 11:00 AM",58,31,27,52,23,29,58,25,33,50,23,27,,,,3,14,13,1,,,,15,15,29,12,17,31,3,,,,5,4,1,,,
"May 24, 2023 12:00 PM",54,26,28,45,23,22,74,43,31,41,26,15,,,,15,18,17,1,,,,14,25,27,14,13,24,3,,,,4,2,2,,,
"May 24, 2023 1:00 PM",86,32,54,80,40,40,100,59,41,76,45,31,,,,23,34,29,5,,,,27,23,45,32,13,32,2,,,,11,6,5,,,
"May 24, 2023 2:00 PM",74,32,42,43,20,23,65,30,35,40,25,15,,,,13,12,12,0,,,,12,33,30,16,14,29,6,,,,10,4,6,,,
"May 24, 2023 3:00 PM",105,50,55,55,30,25,95,50,45,65,37,28,,,,21,20,18,2,,,,15,43,52,30,22,28,6,,,,7,6,1,,,
"May 24, 2023 4:00 PM",155,47,108,83,42,41,119,68,51,72,40,32,,,,31,35,24,11,,,,26,66,68,46,22,57,9,,,,6,3,3,,,
"May 24, 2023 5:00 PM",252,64,188,105,72,33,190,126,64,121,82,39,,,,37,45,42,3,,,,42,132,93,69,24,70,14,,,,7,4,3,,,
"May 24, 2023 6:00 PM",211,66,145,108,74,34,190,124,66,121,69,52,,,,33,49,44,5,,,,46,134,106,84,22,57,6,,,,5,4,1,,,
"May 24, 2023 7:00 PM",112,43,69,132,77,55,119,73,46,113,68,45,,,,16,21,20,1,,,,16,54,71,54,17,34,5,,,,6,5,1,,,
"May 24, 2023 8:00 PM",75,27,48,74,28,46,65,23,42,67,18,49,,,,10,17,17,0,,,,15,30,32,14,18,34,5,,,,7,2,5,,,
"May 24, 2023 9:00 PM",70,18,52,37,19,18,40,11,29,29,11,18,,,,9,9,8,1,,,,10,16,19,8,11,23,4,,,,2,2,0,,,
"May 24, 2023 10:00 PM",36,12,24,13,11,2,14,8,6,16,10,6,,,,4,5,5,0,,,,6,16,6,2,4,9,1,,,,1,1,0,,,
"May 24, 2023 11:00 PM",13,2,11,5,2,3,7,5,2,4,2,2,,,,7,6,6,0,,,,6,8,5,5,0,1,1,,,,0,0,0,,,
"May 25, 2023 12:00 AM",13,4,9,0,0,0,1,1,0,1,1,0,,,,2,3,2,1,,,,2,5,0,0,0,2,0,,,,0,0,0,,,
"May 25, 2023 1:00 AM",3,0,3,0,0,0,2,2,0,0,0,0,,,,0,2,2,0,,,,3,0,4,4,0,0,1,,,,0,0,0,,,
"May 25, 2023 2:00 AM",7,4,3,0,0,0,1,1,0,6,6,0,,,,0,1,1,0,,,,1,2,0,0,0,0,0,,,,0,0,0,,,
"May 25, 2023 3:00 AM",1,1,0,0,0,0,3,0,3,0,0,0,,,,1,0,0,0,,,,0,0,0,0,0,0,0,,,,0,0,0,,,
"May 25, 2023 4:00 AM",1,0,1,0,0,0,0,0,0,0,0,0,,,,0,1,1,0,,,,1,2,0,0,0,0,0,,,,0,0,0,,,
"May 25, 2023 5:00 AM",15,10,5,3,2,1,7,3,4,4,3,1,,,,3,5,5,0,,,,5,4,2,1,1,4,2,,,,2,2,0,,,
"May 25, 2023 6:00 AM",48,28,20,37,16,21,50,28,22,37,18,19,,,,14,20,20,0,,,,18,17,8,4,4,35,1,,,,6,4,2,,,
"May 25, 2023 7:00 AM",153,95,58,52,18,34,84,20,64,53,21,32,,,,21,105,104,1,,,,99,32,46,23,23,129,4,,,,4,3,1,,,
"May 25, 2023 8:00 AM",283,209,74,99,28,71,153,51,102,114,41,73,,,,31,181,178,3,,,,175,64,92,28,64,252,12,,,,27,21,6,,,
"May 25, 2023 9:00 AM",112,85,27,68,23,45,95,39,56,82,42,40,,,,20,74,74,0,,,,61,23,47,14,33,78,2,,,,3,2,1,,,
"May 25, 2023 10:00 AM",55,40,15,60,29,31,58,30,28,57,34,23,,,,16,35,35,0,,,,37,17,28,15,13,41,4,,,,3,3,0,,,
"May 25, 2023 11:00 AM",56,36,20,76,45,31,77,46,31,70,47,23,,,,11,20,20,0,,,,15,15,36,20,16,22,5,,,,7,5,2,,,
"May 25, 2023 12:00 PM",69,37,32,106,60,46,111,59,52,81,42,39,,,,13,35,32,3,,,,25,24,42,28,14,33,2,,,,3,2,1,,,
"May 25, 2023 1:00 PM",84,37,47,117,51,66,121,61,60,72,33,39,,,,22,18,15,3,,,,18,31,50,26,24,30,7,,,,7,3,4,,,
"May 25, 2023 2:00 PM",61,24,37,73,35,38,127,68,59,56,32,24,,,,25,19,16,3,,,,16,38,50,33,17,39,5,,,,12,8,4,,,
"May 25, 2023 3:00 PM",94,35,59,82,46,36,129,80,49,87,58,29,,,,19,15,14,1,,,,14,48,52,36,16,38,8,,,,9,6,3,,,
"May 25, 2023 4:00 PM",128,35,93,112,56,56,194,114,80,117,64,53,,,,26,30,21,9,,,,22,100,98,63,35,47,4,,,,9,7,2,,,
"May 25, 2023 5:00 PM",237,74,163,170,82,88,279,183,96,187,130,57,,,,27,40,37,3,,,,39,157,122,83,39,87,10,,,,15,12,3,,,
"May 25, 2023 6:00 PM",201,65,136,143,82,61,206,122,84,126,82,44,,,,31,29,27,2,,,,25,138,103,71,32,54,13,,,,14,7,7,,,
"May 25, 2023 7:00 PM",92,35,57,98,54,44,155,85,70,113,63,50,,,,19,19,16,3,,,,15,48,72,44,28,49,4,,,,10,6,4,,,
"May 25, 2023 8:00 PM",86,28,58,51,31,20,57,24,33,47,17,30,,,,22,16,14,2,,,,16,27,34,17,17,30,7,,,,9,6,3,,,
"May 25, 2023 9:00 PM",58,13,45,56,40,16,56,19,37,52,11,41,,,,14,15,10,5,,,,12,25,17,8,9,27,1,,,,3,1,2,,,
"May 25, 2023 10:00 PM",50,12,38,44,33,11,53,13,40,40,14,26,,,,4,7,5,2,,,,4,22,15,5,10,19,2,,,,2,0,2,,,
"May 25, 2023 11:00 PM",34,7,27,14,12,2,15,4,11,12,2,10,,,,6,4,4,0,,,,4,10,9,7,2,9,1,,,,1,1,0,,,
"May 26, 2023 12:00 AM",13,0,13,1,1,0,4,3,1,6,4,2,,,,2,1,1,0,,,,1,8,10,5,5,6,0,,,,0,0,0,,,
"May 26, 2023 1:00 AM",6,2,4,0,0,0,1,1,0,1,1,0,,,,0,1,1,0,,,,0,3,0,0,0,2,0,,,,0,0,0,,,
"May 26, 2023 2:00 AM",7,5,2,0,0,0,1,1,0,0,0,0,,,,0,1,1,0,,,,2,1,1,0,1,0,1,,,,0,0,0,,,
"May 26, 2023 3:00 AM",1,1,0,0,0,0,0,0,0,0,0,0,,,,0,0,0,0,,,,0,1,0,0,0,0,0,,,,0,0,0,,,
"May 26, 2023 4:00 AM",5,1,4,0,0,0,0,0,0,1,1,0,,,,1,3,3,0,,,,3,1,0,0,0,1,1,,,,1,1,0,,,
"May 26, 2023 5:00 AM",11,7,4,0,0,0,5,3,2,2,2,0,,,,1,7,7,0,,,,8,6,1,0,1,4,0,,,,1,1,0,,,
"May 26, 2023 6:00 AM",43,20,23,18,9,9,37,17,20,25,14,11,,,,4,20,20,0,,,,19,22,14,7,7,36,1,,,,1,1,0,,,
"May 26, 2023 7:00 AM",106,63,43,59,22,37,78,30,48,46,21,25,,,,13,58,58,0,,,,57,36,29,16,13,85,8,,,,6,4,2,,,
"May 26, 2023 8:00 AM",196,138,58,91,37,54,147,57,90,95,50,45,,,,43,98,97,1,,,,94,57,73,27,46,122,9,,,,17,14,3,,,
"May 26, 2023 9:00 AM",130,96,34,81,33,48,103,47,56,81,48,33,,,,21,58,58,0,,,,48,16,51,33,18,61,2,,,,1,0,1,,,
"May 26, 2023 10:00 AM",65,48,17,103,45,58,89,41,48,82,37,45,,,,15,32,32,0,,,,32,24,42,19,23,37,4,,,,5,3,2,,,
"May 26, 2023 11:00 AM",59,25,34,67,33,34,93,54,39,72,45,27,,,,10,14,13,1,,,,10,27,49,28,21,32,2,,,,6,5,1,,,
"May 26, 2023 12:00 PM",68,24,44,91,50,41,94,47,47,71,40,31,,,,18,20,16,4,,,,13,19,43,27,16,32,3,,,,5,3,2,,,
"May 26, 2023 1:00 PM",82,31,51,93,50,43,114,64,50,69,35,34,,,,20,20,19,1,,,,18,32,48,31,17,32,9,,,,14,6,8,,,
"May 26, 2023 2:00 PM",64,30,34,90,55,35,126,77,49,87,59,28,,,,23,31,30,1,,,,27,37,62,42,20,36,7,,,,7,3,4,,,
"May 26, 2023 3:00 PM",100,48,52,99,54,45,189,124,65,94,53,41,,,,25,24,20,4,,,,20,53,58,35,23,40,5,,,,9,6,3,,,
"May 26, 2023 4:00 PM",107,39,68,125,58,67,200,102,98,130,65,65,,,,25,27,22,5,,,,24,53,101,71,30,57,5,,,,5,2,3,,,
"May 26, 2023 5:00 PM",177,51,126,156,91,65,227,141,86,131,77,54,,,,29,35,34,1,,,,35,92,100,67,33,78,10,,,,3,1,2,,,
"May 26, 2023 6:00 PM",125,46,79,141,76,65,248,157,91,137,81,56,,,,21,21,20,1,,,,20,75,98,73,25,58,3,,,,5,2,3,,,
"May 26, 2023 7:00 PM",92,31,61,109,58,51,190,94,96,104,55,49,,,,13,16,13,3,,,,13,30,90,43,47,43,7,,,,4,2,2,,,
"May 26, 2023 8:00 PM",73,22,51,93,43,50,125,44,81,77,37,40,,,,11,18,17,1,,,,18,30,30,13,17,42,5,,,,5,2,3,,,
"May 26, 2023 9:00 PM",54,21,33,67,39,28,72,18,54,42,12,30,,,,16,13,12,1,,,,12,13,41,20,21,34,4,,,,4,2,2,,,
"May 26, 2023 10:00 PM",35,7,28,20,6,14,26,8,18,21,7,14,,,,14,5,5,0,,,,6,13,24,7,17,14,3,,,,7,6,1,,,
"May 26, 2023 11:00 PM",20,6,14,11,8,3,15,10,5,12,8,4,,,,2,7,7,0,,,,6,11,8,5,3,3,0,,,,3,3,0,,,
"May 27, 2023 12:00 AM",17,2,15,0,0,0,8,0,8,5,2,3,,,,5,4,4,0,,,,5,2,1,1,0,6,1,,,,1,1,0,,,
"May 27, 2023 1:00 AM",13,3,10,4,4,0,9,7,2,4,1,3,,,,1,0,0,0,,,,0,8,9,6,3,3,0,,,,0,0,0,,,
"May 27, 2023 2:00 AM",8,3,5,1,1,0,3,2,1,2,1,1,,,,1,2,2,0,,,,1,1,0,0,0,1,1,,,,0,0,0,,,
"May 27, 2023 3:00 AM",2,2,0,3,1,2,2,0,2,5,3,2,,,,0,0,0,0,,,,0,1,0,0,0,3,0,,,,0,0,0,,,
"May 27, 2023 4:00 AM",5,0,5,0,0,0,1,1,0,0,0,0,,,,1,2,2,0,,,,2,0,3,1,2,0,2,,,,1,1,0,,,
"May 27, 2023 5:00 AM",1,0,1,6,4,2,11,5,6,7,3,4,,,,3,3,3,0,,,,3,3,0,0,0,1,0,,,,0,0,0,,,
"May 27, 2023 6:00 AM",15,9,6,11,5,6,15,7,8,11,4,7,,,,2,4,4,0,,,,3,6,8,2,6,5,2,,,,0,0,0,,,
"May 27, 2023 7:00 AM",22,12,10,50,33,17,50,33,17,45,31,14,,,,5,6,6,0,,,,7,11,15,9,6,15,0,,,,1,1,0,,,
"May 27, 2023 8:00 AM",40,17,23,80,47,33,112,67,45,70,45,25,,,,22,17,17,0,,,,15,27,33,24,9,26,1,,,,1,0,1,,,
"May 27, 2023 9:00 AM",59,34,25,137,79,58,173,116,57,118,73,45,,,,19,26,24,2,,,,22,40,77,51,26,36,3,,,,9,8,1,,,
"May 27, 2023 10:00 AM",59,33,26,172,107,65,197,120,77,163,115,48,,,,9,19,18,1,,,,17,35,80,55,25,50,13,,,,10,6,4,,,
"May 27, 2023 11:00 AM",57,28,29,203,98,105,182,111,71,160,92,68,,,,26,24,23,1,,,,24,39,102,67,35,58,10,,,,12,6,6,,,
"May 27, 2023 12:00 PM",70,40,30,198,93,105,243,143,100,211,131,80,,,,17,25,25,0,,,,23,59,113,69,44,49,6,,,,11,7,4,,,
"May 27, 2023 1:00 PM",59,34,25,211,120,91,209,122,87,206,121,85,,,,20,28,22,6,,,,20,41,85,57,28,51,8,,,,11,10,1,,,
"May 27, 2023 2:00 PM",72,38,34,182,93,89,190,111,79,151,80,71,,,,12,25,21,4,,,,24,40,85,60,25,34,5,,,,10,7,3,,,
"May 27, 2023 3:00 PM",67,40,27,203,120,83,295,175,120,185,105,80,,,,22,14,14,0,,,,13,56,117,82,35,51,8,,,,7,7,0,,,
"May 27, 2023 4:00 PM",59,29,30,214,96,118,256,131,125,143,70,73,,,,15,21,20,1,,,,17,36,127,66,61,62,10,,,,8,6,2,,,
"May 27, 2023 5:00 PM",66,32,34,169,79,90,240,86,154,171,68,103,,,,16,18,18,0,,,,24,38,101,42,59,59,6,,,,8,6,2,,,
"May 27, 2023 6:00 PM",51,22,29,111,52,59,225,68,157,112,43,69,,,,13,24,23,1,,,,19,23,88,31,57,70,3,,,,5,4,1,,,
"May 27, 2023 7:00 PM",48,22,26,83,51,32,108,40,68,85,34,51,,,,11,21,19,2,,,,17,23,38,16,22,49,1,,,,11,4,7,,,
"May 27, 2023 8:00 PM",31,10,21,60,31,29,82,29,53,64,29,35,,,,10,14,14,0,,,,13,10,41,15,26,38,4,,,,6,3,3,,,
"May 27, 2023 9:00 PM",22,12,10,41,13,28,50,11,39,45,10,35,,,,10,11,11,0,,,,12,10,27,4,23,22,0,,,,4,2,2,,,
"May 27, 2023 10:00 PM",22,4,18,14,6,8,15,4,11,15,6,9,,,,1,6,6,0,,,,5,5,11,5,6,13,1,,,,3,1,2,,,
"May 27, 2023 11:00 PM",24,10,14,10,7,3,13,6,7,15,6,9,,,,5,9,9,0,,,,9,5,4,2,2,9,2,,,,1,0,1,,,
"May 28, 2023 12:00 AM",13,4,9,0,0,0,5,4,1,9,0,9,,,,4,4,4,0,,,,3,2,2,1,1,4,0,,,,0,0,0,,,
"May 28, 2023 1:00 AM",10,3,7,6,5,1,4,3,1,3,2,1,,,,0,2,2,0,,,,2,6,1,1,0,7,0,,,,0,0,0,,,
"May 28, 2023 2:00 AM",8,4,4,3,1,2,1,1,0,2,0,2,,,,0,2,2,0,,,,2,4,1,1,0,3,0,,,,0,0,0,,,
"May 28, 2023 3:00 AM",3,1,2,0,0,0,0,0,0,1,1,0,,,,2,0,0,0,,,,0,0,2,2,0,0,0,,,,0,0,0,,,
"May 28, 2023 4:00 AM",6,1,5,0,0,0,1,1,0,0,0,0,,,,0,2,2,0,,,,2,3,2,2,0,0,0,,,,0,0,0,,,
"May 28, 2023 5:00 AM",2,0,2,8,3,5,3,1,2,5,4,1,,,,1,0,0,0,,,,0,3,0,0,0,0,0,,,,0,0,0,,,
"May 28, 2023 6:00 AM",13,9,4,6,3,3,11,8,3,6,3,3,,,,2,5,5,0,,,,5,4,8,4,4,8,0,,,,0,0,0,,,
"May 28, 2023 7:00 AM",14,6,8,28,16,12,36,25,11,24,18,6,,,,5,9,9,0,,,,8,13,10,5,5,15,1,,,,1,1,0,,,
"May 28, 2023 8:00 AM",39,19,20,69,50,19,88,60,28,63,51,12,,,,6,8,8,0,,,,7,18,19,15,4,21,4,,,,4,1,3,,,
"May 28, 2023 9:00 AM",38,19,19,100,56,44,111,74,37,85,55,30,,,,11,16,15,1,,,,14,21,45,30,15,18,3,,,,4,2,2,,,
"May 28, 2023 10:00 AM",58,34,24,149,82,67,155,93,62,136,83,53,,,,7,16,16,0,,,,19,31,52,38,14,45,6,,,,0,0,0,,,
"May 28, 2023 11:00 AM",70,40,30,150,70,80,142,74,68,122,66,56,,,,23,18,16,2,,,,9,46,63,39,24,40,7,,,,7,5,2,,,
"May 28, 2023 12:00 PM",74,42,32,177,66,111,164,71,93,175,85,90,,,,10,24,23,1,,,,21,29,88,43,45,41,11,,,,6,3,3,,,
"May 28, 2023 1:00 PM",76,43,33,192,105,87,160,97,63,149,90,59,,,,14,16,15,1,,,,12,24,92,61,31,31,5,,,,6,2,4,,,
"May 28, 2023 2:00 PM",57,37,20,178,111,67,158,111,47,140,95,45,,,,13,27,26,1,,,,20,38,88,59,29,39,11,,,,5,2,3,,,
"May 28, 2023 3:00 PM",56,38,18,204,95,109,195,92,103,160,81,79,,,,13,19,17,2,,,,16,30,112,60,52,41,12,,,,7,5,2,,,
"May 28, 2023 4:00 PM",52,24,28,176,91,85,188,87,101,134,70,64,,,,24,22,21,1,,,,23,25,76,38,38,50,5,,,,6,2,4,,,
"May 28, 2023 5:00 PM",58,21,37,177,73,104,188,77,111,134,58,76,,,,11,12,12,0,,,,12,28,96,43,53,46,5,,,,8,3,5,,,
"May 28, 2023 6:00 PM",62,25,37,154,56,98,171,58,113,102,29,73,,,,13,13,12,1,,,,11,13,95,41,54,45,5,,,,5,3,2,,,
"May 28, 2023 7:00 PM",49,22,27,80,39,41,97,42,55,76,39,37,,,,19,9,9,0,,,,9,24,50,18,32,27,2,,,,3,1,2,,,
"May 28, 2023 8:00 PM",47,23,24,56,24,32,82,28,54,60,24,36,,,,6,12,12,0,,,,11,17,33,12,21,31,6,,,,3,3,0,,,
"May 28, 2023 9:00 PM",26,9,17,34,13,21,38,11,27,34,8,26,,,,8,9,9,0,,,,7,6,16,6,10,17,0,,,,1,1,0,,,
"May 28, 2023 10:00 PM",17,8,9,13,10,3,21,14,7,17,10,7,,,,1,2,2,0,,,,3,8,5,1,4,10,0,,,,0,0,0,,,
"May 28, 2023 11:00 PM",10,3,7,3,3,0,6,2,4,4,2,2,,,,0,7,7,0,,,,7,6,1,1,0,1,1,,,,2,1,1,,,
"May 29, 2023 12:00 AM",6,1,5,0,0,0,2,0,2,8,5,3,,,,0,2,2,0,,,,2,3,0,0,0,5,0,,,,0,0,0,,,
"May 29, 2023 1:00 AM",5,1,4,0,0,0,2,0,2,0,0,0,,,,0,1,1,0,,,,1,3,1,0,1,1,0,,,,0,0,0,,,
"May 29, 2023 2:00 AM",1,0,1,1,0,1,0,0,0,0,0,0,,,,0,2,0,2,,,,0,0,0,0,0,0,0,,,,1,1,0,,,
"May 29, 2023 3:00 AM",3,2,1,1,0,1,1,0,1,1,0,1,,,,0,0,0,0,,,,0,1,0,0,0,0,0,,,,0,0,0,,,
"May 29, 2023 4:00 AM",3,0,3,0,0,0,1,1,0,2,2,0,,,,0,0,0,0,,,,0,0,2,1,1,1,0,,,,0,0,0,,,
"May 29, 2023 5:00 AM",13,12,1,1,0,1,4,2,2,3,2,1,,,,1,7,7,0,,,,7,3,6,3,3,3,0,,,,0,0,0,,,
"May 29, 2023 6:00 AM",51,34,17,26,10,16,32,14,18,18,7,11,,,,7,22,22,0,,,,22,15,6,2,4,33,2,,,,2,2,0,,,
"May 29, 2023 7:00 AM",148,95,53,51,10,41,85,23,62,50,13,37,,,,11,82,79,3,,,,73,34,34,12,22,111,7,,,,4,4,0,,,
"May 29, 2023 8:00 AM",252,191,61,100,31,69,180,67,113,113,47,66,,,,36,160,154,6,,,,149,59,94,29,65,214,8,,,,24,22,2,,,
"May 29, 2023 9:00 AM",120,95,25,67,27,40,111,56,55,67,39,28,,,,12,65,65,0,,,,58,26,48,27,21,86,4,,,,5,3,2,,,
"May 29, 2023 10:00 AM",41,26,15,54,28,26,82,43,39,54,30,24,,,,24,41,36,5,,,,30,18,32,12,20,26,2,,,,4,2,2,,,
"May 29, 2023 11:00 AM",42,27,15,69,29,40,85,34,51,62,32,30,,,,9,21,19,2,,,,19,10,32,16,16,26,1,,,,9,7,2,,,
"May 29, 2023 12:00 PM",67,28,39,79,41,38,80,46,34,63,34,29,,,,13,21,21,0,,,,15,29,39,26,13,26,4,,,,5,5,0,,,
"May 29, 2023 1:00 PM",72,30,42,97,47,50,110,52,58,84,41,43,,,,22,21,16,5,,,,16,28,38,19,19,22,3,,,,9,4,5,,,
"May 29, 2023 2:00 PM",74,32,42,52,33,19,67,36,31,55,33,22,,,,20,22,19,3,,,,21,28,43,26,17,31,7,,,,7,4,3,,,
"May 29, 2023 3:00 PM",94,34,60,68,39,29,82,56,26,72,49,23,,,,19,23,20,3,,,,13,41,57,37,20,30,6,,,,8,4,4,,,
"May 29, 2023 4:00 PM",138,46,92,91,47,44,114,70,44,81,48,33,,,,20,23,22,1,,,,19,60,60,44,16,50,4,,,,8,6,2,,,
"May 29, 2023 5:00 PM",233,61,172,144,87,57,182,119,63,152,90,62,,,,24,40,37,3,,,,43,134,92,68,24,81,16,,,,13,8,5,,,
"May 29, 2023 6:00 PM",167,54,113,157,97,60,233,162,71,138,89,49,,,,32,42,38,4,,,,41,127,119,94,25,49,11,,,,10,5,5,,,
"May 29, 2023 7:00 PM",118,41,77,117,70,47,196,106,90,113,63,50,,,,28,33,24,9,,,,22,73,85,55,30,56,6,,,,8,2,6,,,
"May 29, 2023 8:00 PM",59,20,39,102,51,51,126,60,66,78,34,44,,,,9,24,23,1,,,,22,29,56,29,27,43,7,,,,4,4,0,,,
"May 29, 2023 9:00 PM",43,14,29,38,17,21,64,20,44,34,13,21,,,,19,9,9,0,,,,9,22,19,2,17,30,7,,,,8,4,4,,,
"May 29, 2023 10:00 PM",28,10,18,18,14,4,21,8,13,19,8,11,,,,8,5,5,0,,,,6,11,8,4,4,14,2,,,,1,1,0,,,
"May 29, 2023 11:00 PM",16,6,10,2,2,0,8,4,4,6,2,4,,,,4,8,6,2,,,,4,5,2,2,0,1,1,,,,2,2,0,,,
"May 30, 2023 12:00 AM",9,2,7,0,0,0,1,0,1,1,0,1,,,,0,4,3,1,,,,3,2,0,0,0,5,0,,,,1,0,1,,,
"May 30, 2023 1:00 AM",5,1,4,0,0,0,0,0,0,0,0,0,,,,0,0,0,0,,,,0,3,0,0,0,0,0,,,,0,0,0,,,
"May 30, 2023 2:00 AM",1,1,0,0,0,0,3,2,1,0,0,0,,,,1,3,2,1,,,,2,0,1,1,0,0,0,,,,0,0,0,,,
"May 30, 2023 3:00 AM",1,0,1,2,1,1,2,1,1,2,1,1,,,,0,0,0,0,,,,0,1,0,0,0,0,0,,,,0,0,0,,,
"May 30, 2023 4:00 AM",3,2,1,0,0,0,2,2,0,2,2,0,,,,0,2,2,0,,,,2,1,2,1,1,0,0,,,,2,1,1,,,
"May 30, 2023 5:00 AM",7,6,1,7,3,4,9,4,5,10,5,5,,,,2,8,8,0,,,,9,4,2,0,2,14,0,,,,0,0,0,,,
"May 30, 2023 6:00 AM",66,39,27,31,11,20,49,22,27,34,14,20,,,,16,29,29,0,,,,26,16,10,3,7,42,1,,,,3,2,1,,,
"May 30, 2023 7:00 AM",182,128,54,57,19,38,107,21,86,67,18,49,,,,16,95,95,0,,,,95,46,52,17,35,175,6,,,,7,6,1,,,
"May 30, 2023 8:00 AM",322,251,71,115,34,81,222,81,141,125,49,76,,,,46,218,216,2,,,,200,79,113,38,75,250,8,,,,19,16,3,,,
"May 30, 2023 9:00 AM",137,111,26,70,27,43,130,57,73,81,52,29,,,,10,112,110,2,,,,76,29,60,24,36,93,1,,,,6,2,4,,,
"May 30, 2023 10:00 AM",59,37,22,64,30,34,105,60,45,56,40,16,,,,24,29,29,0,,,,0,26,45,25,20,33,3,,,,2,2,0,,,
"May 30, 2023 11:00 AM",56,36,20,101,55,46,100,54,46,61,39,22,,,,14,31,26,5,,,,0,21,54,33,21,21,1,,,,2,1,1,,,
"May 30, 2023 12:00 PM",68,36,32,91,52,39,95,55,40,82,50,32,,,,20,26,24,2,,,,0,32,63,32,31,45,6,,,,4,2,2,,,
"May 30, 2023 1:00 PM",83,36,47,92,48,44,96,50,46,96,46,50,,,,21,25,21,4,,,,0,25,44,23,21,23,4,,,,7,5,2,,,
"May 30, 2023 2:00 PM",79,33,46,72,33,39,97,51,46,68,35,33,,,,19,16,13,3,,,,4,34,56,31,25,29,7,,,,9,3,6,,,
"May 30, 2023 3:00 PM",113,50,63,68,38,30,82,50,32,79,53,26,,,,32,27,19,8,,,,16,46,44,30,14,40,9,,,,14,7,7,,,
"May 30, 2023 4:00 PM",149,39,110,111,60,51,126,78,48,98,57,41,,,,38,44,37,7,,,,34,82,78,55,23,54,16,,,,15,13,2,,,
"May 30, 2023 5:00 PM",259,64,195,156,81,75,244,161,83,164,108,56,,,,41,42,39,3,,,,38,174,121,87,34,86,18,,,,12,10,2,,,
"May 30, 2023 6:00 PM",257,59,198,176,126,50,281,203,78,171,120,51,,,,34,30,25,5,,,,24,152,157,122,35,64,6,,,,14,9,5,,,
"May 30, 2023 7:00 PM",142,56,86,145,87,58,263,177,86,165,98,67,,,,35,37,28,9,,,,25,79,114,92,22,60,8,,,,6,3,3,,,
"May 30, 2023 8:00 PM",101,37,64,133,57,76,247,77,170,121,50,71,,,,20,20,17,3,,,,13,57,90,32,58,64,6,,,,4,2,2,,,
"May 30, 2023 9:00 PM",55,9,46,54,31,23,128,39,89,47,12,35,,,,10,20,19,1,,,,18,27,51,12,39,47,5,,,,1,0,1,,,
"May 30, 2023 10:00 PM",36,13,23,29,21,8,46,15,31,28,10,18,,,,2,5,4,1,,,,5,14,26,11,15,22,0,,,,1,1,0,,,
"May 30, 2023 11:00 PM",18,6,12,17,14,3,14,8,6,10,7,3,,,,4,5,5,0,,,,5,5,8,6,2,8,1,,,,1,1,0,,,
"May 31, 2023 12:00 AM",6,4,2,0,0,0,1,1,0,1,1,0,,,,1,2,2,0,,,,2,5,0,0,0,3,2,,,,0,0,0,,,
"May 31, 2023 1:00 AM",5,0,5,0,0,0,2,1,1,0,0,0,,,,1,2,2,0,,,,2,0,1,1,0,1,0,,,,0,0,0,,,
"May 31, 2023 2:00 AM",4,4,0,0,0,0,3,2,1,1,1,0,,,,0,0,0,0,,,,1,0,0,0,0,0,0,,,,0,0,0,,,
"May 31, 2023 3:00 AM",3,1,2,1,0,1,2,1,1,2,1,1,,,,0,0,0,0,,,,0,0,0,0,0,0,0,,,,0,0,0,,,
"May 31, 2023 4:00 AM",5,3,2,3,3,0,0,0,0,2,2,0,,,,0,2,2,0,,,,3,0,1,0,1,1,0,,,,1,1,0,,,
"May 31, 2023 5:00 AM",13,9,4,4,1,3,6,4,2,6,4,2,,,,2,8,8,0,,,,9,5,0,0,0,13,0,,,,0,0,0,,,
"May 31, 2023 6:00 AM",71,49,22,36,19,17,36,19,17,33,14,19,,,,17,31,31,0,,,,28,17,5,2,3,47,1,,,,3,3,0,,,
"May 31, 2023 7:00 AM",171,112,59,105,42,63,142,50,92,87,35,52,,,,26,109,107,2,,,,110,57,56,26,30,162,5,,,,6,4,2,,,
"May 31, 2023 8:00 AM",304,235,69,114,30,84,213,86,127,136,55,81,,,,39,193,189,4,,,,182,68,110,29,81,267,5,,,,19,13,6,,,
"May 31, 2023 9:00 AM",138,116,22,76,28,48,135,63,72,87,52,35,,,,9,73,72,1,,,,61,37,63,30,33,96,4,,,,7,4,3,,,
"May 31, 2023 10:00 AM",58,42,16,60,31,29,96,47,49,54,31,23,,,,16,38,38,0,,,,35,20,45,23,22,24,5,,,,11,8,3,,,
"May 31, 2023 11:00 AM",50,33,17,58,24,34,94,49,45,49,31,18,,,,12,26,23,3,,,,22,12,41,30,11,40,5,,,,10,6,4,,,
"May 31, 2023 12:00 PM",79,42,37,63,28,35,81,43,38,63,30,33,,,,14,33,30,3,,,,24,24,36,18,18,31,4,,,,8,5,3,,,
"May 31, 2023 1:00 PM",82,38,44,67,31,36,89,41,48,62,29,33,,,,22,23,22,1,,,,18,21,47,29,18,27,7,,,,11,10,1,,,
"May 31, 2023 2:00 PM",62,30,32,53,28,25,62,33,29,48,29,19,,,,15,18,13,5,,,,13,35,38,16,22,39,4,,,,14,8,6,,,
"May 31, 2023 3:00 PM",79,35,44,52,34,18,54,31,23,42,27,15,,,,20,17,16,1,,,,13,30,35,24,11,31,1,,,,4,3,1,,,
"May 31, 2023 4:00 PM",122,32,90,103,54,49,96,62,34,83,49,34,,,,22,42,33,9,,,,32,80,50,41,9,40,3,,,,5,3,2,,,
"May 31, 2023 5:00 PM",273,78,195,125,87,38,186,122,64,152,107,45,,,,36,57,50,7,,,,46,147,98,75,23,79,15,,,,15,4,11,,,
"May 31, 2023 6:00 PM",265,63,202,142,100,42,225,166,59,136,100,36,,,,26,36,34,2,,,,36,138,135,100,35,52,12,,,,11,7,4,,,
"May 31, 2023 7:00 PM",121,44,77,130,79,51,180,109,71,121,65,56,,,,22,32,29,3,,,,27,71,69,48,21,47,7,,,,10,6,4,,,
"May 31, 2023 8:00 PM",90,22,68,107,52,55,117,48,69,77,31,46,,,,27,25,23,2,,,,24,39,44,26,18,24,7,,,,8,5,3,,,
"May 31, 2023 9:00 PM",67,26,41,45,23,22,94,36,58,49,19,30,,,,18,19,18,1,,,,13,19,34,18,16,24,4,,,,3,2,1,,,
"May 31, 2023 10:00 PM",34,6,28,36,24,12,38,12,26,19,10,9,,,,4,6,5,1,,,,7,13,15,9,6,13,2,,,,2,1,1,,,
"May 31, 2023 11:00 PM",9,2,7,4,3,1,16,6,10,8,3,5,,,,2,7,7,0,,,,6,14,8,6,2,9,1,,,,1,1,0,,,
"Jun 1, 2023 12:00 AM",8,4,4,0,0,0,1,1,0,1,1,0,,,,1,3,2,1,,,,2,6,4,4,0,4,1,,,,0,0,0,,,
"Jun 1, 2023 1:00 AM",4,1,3,3,3,0,3,3,0,2,2,0,,,,0,0,0,0,,,,0,0,0,0,0,0,0,,,,0,0,0,,,
"Jun 1, 2023 2:00 AM",6,4,2,0,0,0,0,0,0,0,0,0,,,,0,0,0,0,,,,0,3,0,0,0,0,0,,,,0,0,0,,,
"Jun 1, 2023 3:00 AM",2,1,1,1,0,1,1,0,1,1,0,1,,,,1,0,0,0,,,,0,0,0,0,0,0,0,,,,0,0,0,,,
"Jun 1, 2023 4:00 AM",5,3,2,0,0,0,0,0,0,1,1,0,,,,1,3,3,0,,,,3,0,1,0,1,2,0,,,,0,0,0,,,
"Jun 1, 2023 5:00 AM",11,9,2,5,3,2,6,3,3,5,4,1,,,,2,5,5,0,,,,6,2,2,0,2,12,1,,,,0,0,0,,,
"Jun 1, 2023 6:00 AM",51,34,17,32,12,20,37,17,20,29,12,17,,,,14,26,26,0,,,,23,22,10,2,8,36,0,,,,1,0,1,,,
"Jun 1, 2023 7:00 AM",146,95,51,86,31,55,108,35,73,71,25,46,,,,18,92,91,1,,,,81,36,57,28,29,144,4,,,,4,4,0,,,
"Jun 1, 2023 8:00 AM",288,220,68,97,40,57,188,78,110,113,60,53,,,,31,179,179,0,,,,172,45,79,19,60,232,8,,,,16,11,5,,,
"Jun 1, 2023 9:00 AM",132,106,26,71,27,44,126,55,71,77,41,36,,,,12,90,87,3,,,,82,31,58,23,35,77,8,,,,10,8,2,,,
"Jun 1, 2023 10:00 AM",65,41,24,75,27,48,102,48,54,80,35,45,,,,12,28,27,1,,,,26,18,42,26,16,40,3,,,,2,2,0,,,
"Jun 1, 2023 11:00 AM",45,23,22,42,16,26,69,31,38,43,15,28,,,,10,33,30,3,,,,28,18,34,20,14,26,1,,,,6,3,3,,,
"Jun 1, 2023 12:00 PM",78,39,39,61,38,23,98,55,43,60,40,20,,,,10,20,19,1,,,,18,20,44,24,20,32,5,,,,3,3,0,,,
"Jun 1, 2023 1:00 PM",77,33,44,58,26,32,82,42,40,63,32,31,,,,12,23,19,4,,,,14,32,33,21,12,22,2,,,,4,1,3,,,
"Jun 1, 2023 2:00 PM",81,43,38,67,30,37,75,44,31,61,35,26,,,,13,19,18,1,,,,14,32,37,22,15,22,6,,,,5,1,4,,,
"Jun 1, 2023 3:00 PM",104,51,53,73,42,31,72,41,31,58,33,25,,,,27,22,22,0,,,,21,33,49,30,19,42,5,,,,10,7,3,,,
"Jun 1, 2023 4:00 PM",145,40,105,81,45,36,83,47,36,78,50,28,,,,13,32,27,5,,,,28,59,39,27,12,42,12,,,,9,4,5,,,
"Jun 1, 2023 5:00 PM",251,61,190,143,62,81,186,125,61,147,104,43,,,,31,52,45,7,,,,43,141,93,72,21,70,16,,,,6,3,3,,,
"Jun 1, 2023 6:00 PM",211,54,157,127,94,33,192,144,48,150,110,40,,,,36,46,43,3,,,,43,124,106,82,24,48,10,,,,11,4,7,,,
"Jun 1, 2023 7:00 PM",113,45,68,119,64,55,147,87,60,119,71,48,,,,25,27,25,2,,,,21,64,73,50,23,33,10,,,,12,6,6,,,
"Jun 1, 2023 8:00 PM",107,39,68,119,55,64,120,55,65,88,36,52,,,,16,22,21,1,,,,14,47,55,21,34,27,9,,,,10,7,3,,,
"Jun 1, 2023 9:00 PM",67,23,44,65,45,20,70,26,44,49,14,35,,,,9,15,14,1,,,,17,20,25,13,12,22,4,,,,6,4,2,,,
"Jun 1, 2023 10:00 PM",51,14,37,42,28,14,47,9,38,38,6,32,,,,5,6,6,0,,,,7,14,9,2,7,18,2,,,,0,0,0,,,
"Jun 1, 2023 11:00 PM",23,9,14,10,7,3,30,9,21,13,2,11,,,,2,8,7,1,,,,5,7,6,2,4,5,3,,,,2,1,1,,,
"Jun 2, 2023 12:00 AM",8,1,7,1,1,0,8,4,4,8,5,3,,,,0,4,4,0,,,,4,2,6,5,1,5,0,,,,1,1,0,,,
"Jun 2, 2023 1:00 AM",3,1,2,2,2,0,3,1,2,4,1,3,,,,0,2,2,0,,,,2,5,2,1,1,0,0,,,,0,0,0,,,
"Jun 2, 2023 2:00 AM",3,2,1,0,0,0,3,3,0,1,1,0,,,,0,1,0,1,,,,0,2,2,0,2,0,0,,,,0,0,0,,,
"Jun 2, 2023 3:00 AM",1,0,1,1,0,1,1,0,1,1,0,1,,,,0,0,0,0,,,,0,3,0,0,0,1,0,,,,0,0,0,,,
"Jun 2, 2023 4:00 AM",5,2,3,0,0,0,1,0,1,0,0,0,,,,0,0,0,0,,,,1,2,1,0,1,2,0,,,,0,0,0,,,
"Jun 2, 2023 5:00 AM",10,7,3,3,3,0,5,2,3,3,2,1,,,,3,4,4,0,,,,3,4,1,1,0,4,0,,,,0,0,0,,,
"Jun 2, 2023 6:00 AM",47,27,20,34,18,16,35,20,15,26,17,9,,,,6,18,18,0,,,,16,15,9,6,3,23,0,,,,0,0,0,,,
"Jun 2, 2023 7:00 AM",94,61,33,86,38,48,75,29,46,56,26,30,,,,18,54,54,0,,,,47,25,32,18,14,76,4,,,,6,4,2,,,
"Jun 2, 2023 8:00 AM",169,118,51,92,30,62,131,45,86,92,33,59,,,,18,113,111,2,,,,99,50,60,18,42,117,13,,,,6,4,2,,,
"Jun 2, 2023 9:00 AM",90,72,18,70,28,42,87,51,36,69,43,26,,,,11,47,46,1,,,,43,31,43,16,27,86,5,,,,5,4,1,,,
"Jun 2, 2023 10:00 AM",59,27,32,56,31,25,80,44,36,52,30,22,,,,13,24,22,2,,,,22,16,62,37,25,29,0,,,,4,4,0,,,
"Jun 2, 2023 11:00 AM",43,25,18,81,45,36,100,52,48,64,38,26,,,,11,26,24,2,,,,19,19,28,16,12,40,3,,,,9,6,3,,,
"Jun 2, 2023 12:00 PM",68,41,27,54,21,33,73,42,31,62,30,32,,,,18,23,21,2,,,,16,25,49,26,23,34,10,,,,8,2,6,,,
"Jun 2, 2023 1:00 PM",79,36,43,54,28,26,107,57,50,61,33,28,,,,9,19,14,5,,,,15,29,44,30,14,37,7,,,,6,4,2,,,
"Jun 2, 2023 2:00 PM",96,36,60,57,29,28,73,44,29,50,32,18,,,,19,21,20,1,,,,16,41,29,16,13,31,4,,,,8,5,3,,,
"Jun 2, 2023 3:00 PM",93,47,46,61,28,33,73,40,33,53,29,24,,,,24,20,17,3,,,,16,33,34,16,18,25,4,,,,4,2,2,,,
"Jun 2, 2023 4:00 PM",138,47,91,95,56,39,102,55,47,83,52,31,,,,30,23,21,2,,,,22,49,66,51,15,37,5,,,,0,0,0,,,
"Jun 2, 2023 5:00 PM",153,44,109,124,89,35,137,94,43,115,78,37,,,,19,42,36,6,,,,36,76,56,39,17,51,7,,,,4,2,2,,,
"Jun 2, 2023 6:00 PM",121,48,73,116,78,38,134,79,55,114,72,42,,,,33,22,19,3,,,,19,70,58,45,13,36,7,,,,3,2,1,,,
"Jun 2, 2023 7:00 PM",72,26,46,103,48,55,109,64,45,84,45,39,,,,7,15,14,1,,,,14,27,45,27,18,29,7,,,,5,3,2,,,
"Jun 2, 2023 8:00 PM",57,15,42,64,39,25,63,30,33,57,26,31,,,,13,17,17,0,,,,17,28,25,14,11,21,4,,,,8,4,4,,,
"Jun 2, 2023 9:00 PM",61,21,40,59,19,40,53,15,38,38,8,30,,,,4,5,4,1,,,,4,8,34,13,21,21,3,,,,2,0,2,,,
"Jun 2, 2023 10:00 PM",36,11,25,34,21,13,29,6,23,27,13,14,,,,3,6,5,1,,,,5,14,10,4,6,6,0,,,,3,2,1,,,
"Jun 2, 2023 11:00 PM",29,11,18,13,7,6,16,7,9,10,5,5,,,,7,5,5,0,,,,4,8,11,4,7,10,2,,,,0,0,0,,,
"Jun 3, 2023 12:00 AM",9,2,7,0,0,0,5,1,4,8,3,5,,,,3,2,2,0,,,,3,2,5,1,4,5,0,,,,3,2,1,,,
"Jun 3, 2023 1:00 AM",6,1,5,3,3,0,3,3,0,1,0,1,,,,0,1,1,0,,,,1,3,1,0,1,6,0,,,,0,0,0,,,
"Jun 3, 2023 2:00 AM",7,4,3,0,0,0,1,0,1,1,0,1,,,,2,1,1,0,,,,1,0,1,0,1,0,0,,,,2,1,1,,,
"Jun 3, 2023 3:00 AM",5,2,3,0,0,0,1,0,1,0,0,0,,,,1,0,0,0,,,,0,1,3,0,3,0,1,,,,0,0,0,,,
"Jun 3, 2023 4:00 AM",0,0,0,1,1,0,3,2,1,1,1,0,,,,0,1,1,0,,,,1,0,0,0,0,0,0,,,,0,0,0,,,
"Jun 3, 2023 5:00 AM",0,0,0,0,0,0,8,5,3,1,0,1,,,,0,2,2,0,,,,1,1,3,3,0,1,1,,,,0,0,0,,,
"Jun 3, 2023 6:00 AM",9,4,5,6,2,4,9,5,4,3,2,1,,,,0,4,4,0,,,,4,3,8,4,4,9,0,,,,0,0,0,,,
"Jun 3, 2023 7:00 AM",21,10,11,35,22,13,23,15,8,24,16,8,,,,7,5,5,0,,,,5,7,9,7,2,15,1,,,,2,1,1,,,
"Jun 3, 2023 8:00 AM",30,15,15,56,30,26,68,48,20,64,49,15,,,,11,19,19,0,,,,20,24,16,12,4,29,6,,,,3,1,2,,,
"Jun 3, 2023 9:00 AM",35,21,14,101,62,39,119,85,34,84,56,28,,,,9,16,16,0,,,,15,31,38,27,11,31,2,,,,4,4,0,,,
"Jun 3, 2023 10:00 AM",63,45,18,162,88,74,188,119,69,152,102,50,,,,10,26,23,3,,,,22,41,58,48,10,39,4,,,,11,6,5,,,
"Jun 3, 2023 11:00 AM",68,46,22,151,83,68,208,119,89,130,80,50,,,,35,18,17,1,,,,15,38,88,56,32,37,8,,,,9,7,2,,,
"Jun 3, 2023 12:00 PM",74,34,40,212,88,124,273,161,112,187,112,75,,,,23,19,19,0,,,,18,50,77,49,28,38,7,,,,12,10,2,,,
"Jun 3, 2023 1:00 PM",55,32,23,196,100,96,274,155,119,207,122,85,,,,20,27,27,0,,,,27,56,109,71,38,31,6,,,,8,6,2,,,
"Jun 3, 2023 2:00 PM",59,38,21,186,99,87,271,140,131,163,99,64,,,,10,15,15,0,,,,15,38,102,61,41,68,8,,,,13,7,6,,,
"Jun 3, 2023 3:00 PM",58,20,38,163,77,86,175,71,104,146,72,74,,,,14,14,13,1,,,,15,29,101,52,49,29,4,,,,5,3,2,,,
"Jun 3, 2023 4:00 PM",55,17,38,168,82,86,167,75,92,131,56,75,,,,18,17,16,1,,,,14,14,82,48,34,36,5,,,,4,3,1,,,
"Jun 3, 2023 5:00 PM",55,20,35,148,81,67,147,48,99,142,52,90,,,,19,8,7,1,,,,6,15,82,36,46,41,10,,,,5,4,1,,,
"Jun 3, 2023 6:00 PM",49,27,22,119,66,53,111,41,70,87,34,53,,,,16,14,12,2,,,,12,30,65,26,39,32,0,,,,5,1,4,,,
"Jun 3, 2023 7:00 PM",41,22,19,88,52,36,72,33,39,64,40,24,,,,19,7,7,0,,,,9,11,31,9,22,30,3,,,,5,2,3,,,
"Jun 3, 2023 8:00 PM",37,12,25,47,21,26,70,29,41,52,17,35,,,,5,18,18,0,,,,16,12,27,18,9,16,1,,,,4,2,2,,,
"Jun 3, 2023 9:00 PM",14,6,8,51,23,28,63,20,43,43,14,29,,,,5,10,10,0,,,,10,14,25,7,18,17,1,,,,2,1,1,,,
"Jun 3, 2023 10:00 PM",22,5,17,37,14,23,33,7,26,41,10,31,,,,6,7,7,0,,,,7,3,24,9,15,22,1,,,,1,0,1,,,
"Jun 3, 2023 11:00 PM",16,9,7,10,3,7,22,5,17,23,8,15,,,,3,8,8,0,,,,7,9,15,4,11,13,0,,,,0,0,0,,,
"Jun 4, 2023 12:00 AM",4,0,4,1,1,0,6,1,5,12,4,8,,,,1,7,7,0,,,,4,3,12,5,7,8,1,,,,2,1,1,,,
"Jun 4, 2023 1:00 AM",4,1,3,1,0,1,3,1,2,1,0,1,,,,0,2,1,1,,,,1,2,0,0,0,3,0,,,,1,1,0,,,
"Jun 4, 2023 2:00 AM",7,3,4,1,1,0,0,0,0,0,0,0,,,,0,0,0,0,,,,0,1,1,1,0,0,0,,,,0,0,0,,,
"Jun 4, 2023 3:00 AM",3,2,1,0,0,0,2,2,0,1,1,0,,,,0,0,0,0,,,,0,1,1,1,0,0,1,,,,0,0,0,,,
"Jun 4, 2023 4:00 AM",4,0,4,2,0,2,5,2,3,2,0,2,,,,0,2,2,0,,,,3,2,0,0,0,1,0,,,,0,0,0,,,
"Jun 4, 2023 5:00 AM",3,3,0,2,1,1,2,1,1,2,1,1,,,,0,0,0,0,,,,0,0,1,0,1,4,0,,,,0,0,0,,,
"Jun 4, 2023 6:00 AM",10,7,3,10,6,4,10,6,4,6,5,1,,,,1,5,5,0,,,,5,6,2,2,0,8,1,,,,2,2,0,,,
"Jun 4, 2023 7:00 AM",22,15,7,26,9,17,18,10,8,17,11,6,,,,4,10,10,0,,,,10,10,3,2,1,17,0,,,,2,1,1,,,
"Jun 4, 2023 8:00 AM",27,15,12,81,59,22,87,65,22,93,70,23,,,,11,10,9,1,,,,9,14,27,19,8,23,2,,,,4,3,1,,,
"Jun 4, 2023 9:00 AM",45,19,26,139,92,47,136,98,38,108,83,25,,,,10,17,17,0,,,,14,34,42,32,10,39,4,,,,8,7,1,,,
"Jun 4, 2023 10:00 AM",63,40,23,165,86,79,218,134,84,154,91,63,,,,7,18,14,4,,,,18,36,95,67,28,48,12,,,,9,6,3,,,
"Jun 4, 2023 11:00 AM",50,28,22,226,121,105,228,137,91,188,112,76,,,,14,22,19,3,,,,21,44,118,74,44,46,8,,,,7,5,2,,,
"Jun 4, 2023 12:00 PM",74,48,26,202,97,105,317,194,123,208,122,86,,,,17,23,19,4,,,,15,72,131,90,41,54,11,,,,13,8,5,,,
"Jun 4, 2023 1:00 PM",73,27,46,219,119,100,311,189,122,199,127,72,,,,18,14,12,2,,,,9,49,136,83,53,47,8,,,,6,4,2,,,
"Jun 4, 2023 2:00 PM",48,24,24,205,115,90,282,158,124,174,111,63,,,,15,16,16,0,,,,11,46,126,78,48,40,5,,,,9,8,1,,,
"Jun 4, 2023 3:00 PM",64,36,28,223,125,98,271,135,136,187,116,71,,,,11,18,15,3,,,,16,40,137,85,52,48,3,,,,11,9,2,,,
"Jun 4, 2023 4:00 PM",52,23,29,210,99,111,232,102,130,192,92,100,,,,17,22,20,2,,,,19,32,106,32,74,72,2,,,,3,2,1,,,
"Jun 4, 2023 5:00 PM",84,39,45,167,85,82,201,61,140,145,55,90,,,,19,16,15,1,,,,16,29,105,44,61,57,6,,,,9,6,3,,,
"Jun 4, 2023 6:00 PM",55,12,43,115,54,61,134,44,90,125,46,79,,,,24,15,12,3,,,,14,32,58,19,39,63,5,,,,7,4,3,,,
"Jun 4, 2023 7:00 PM",52,26,26,97,37,60,105,34,71,93,33,60,,,,12,12,11,1,,,,11,12,46,22,24,39,3,,,,8,6,2,,,
"Jun 4, 2023 8:00 PM",40,16,24,82,35,47,72,22,50,64,29,35,,,,8,16,16,0,,,,16,12,32,15,17,26,2,,,,1,1,0,,,
"Jun 4, 2023 9:00 PM",20,8,12,41,21,20,42,13,29,38,8,30,,,,7,9,8,1,,,,7,6,23,6,17,28,1,,,,0,0,0,,,
"Jun 4, 2023 10:00 PM",24,9,15,21,6,15,26,5,21,22,7,15,,,,8,6,6,0,,,,7,5,12,2,10,7,1,,,,2,2,0,,,
"Jun 4, 2023 11:00 PM",7,5,2,5,1,4,9,4,5,9,3,6,,,,3,4,4,0,,,,3,6,5,0,5,7,2,,,,2,0,2,,,
"Jun 5, 2023 12:00 AM",10,2,8,0,0,0,3,2,1,10,5,5,,,,0,0,0,0,,,,0,2,7,2,5,5,0,,,,1,1,0,,,
"Jun 5, 2023 1:00 AM",2,1,1,3,3,0,5,3,2,3,2,1,,,,2,2,2,0,,,,2,1,3,1,2,5,0,,,,0,0,0,,,
"Jun 5, 2023 2:00 AM",6,2,4,1,1,0,1,1,0,2,2,0,,,,0,2,2,0,,,,3,1,1,1,0,1,0,,,,0,0,0,,,
"Jun 5, 2023 3:00 AM",4,1,3,0,0,0,2,2,0,0,0,0,,,,0,1,1,0,,,,1,1,0,0,0,0,0,,,,1,1,0,,,
"Jun 5, 2023 4:00 AM",5,1,4,2,0,2,0,0,0,1,1,0,,,,0,3,2,1,,,,2,0,1,1,0,0,0,,,,1,0,1,,,
"Jun 5, 2023 5:00 AM",7,3,4,4,3,1,3,3,0,5,3,2,,,,1,4,4,0,,,,3,3,0,0,0,2,0,,,,0,0,0,,,
"Jun 5, 2023 6:00 AM",16,7,9,11,4,7,14,5,9,11,5,6,,,,4,3,3,0,,,,3,11,1,0,1,12,2,,,,0,0,0,,,
"Jun 5, 2023 7:00 AM",24,8,16,31,18,13,33,19,14,28,18,10,,,,4,11,11,0,,,,10,12,14,9,5,20,0,,,,1,0,1,,,
"Jun 5, 2023 8:00 AM",28,13,15,64,40,24,68,46,22,58,43,15,,,,4,5,5,0,,,,5,19,20,14,6,17,3,,,,4,3,1,,,
"Jun 5, 2023 9:00 AM",35,13,22,112,56,56,103,69,34,92,61,31,,,,9,19,18,1,,,,16,23,36,25,11,33,1,,,,8,6,2,,,
"Jun 5, 2023 10:00 AM",51,29,22,173,96,77,167,104,63,133,89,44,,,,7,17,16,1,,,,12,46,64,46,18,36,4,,,,5,5,0,,,
"Jun 5, 2023 11:00 AM",54,28,26,225,113,112,288,174,114,212,119,93,,,,17,19,18,1,,,,17,49,95,72,23,32,13,,,,20,12,8,,,
"Jun 5, 2023 12:00 PM",58,29,29,230,132,98,336,215,121,220,135,85,,,,9,16,15,1,,,,15,65,163,114,49,67,6,,,,11,8,3,,,
"Jun 5, 2023 1:00 PM",63,36,27,233,129,104,331,201,130,231,130,101,,,,15,26,25,1,,,,22,52,155,103,52,51,5,,,,10,7,3,,,
"Jun 5, 2023 2:00 PM",64,31,33,249,158,91,377,233,144,201,133,68,,,,15,27,27,0,,,,25,52,179,111,68,68,9,,,,8,4,4,,,
"Jun 5, 2023 3:00 PM",66,26,40,195,101,94,368,166,202,229,118,111,,,,22,25,23,2,,,,20,28,191,90,101,58,6,,,,5,3,2,,,
"Jun 5, 2023 4:00 PM",72,29,43,226,100,126,326,133,193,229,112,117,,,,23,23,22,1,,,,23,33,173,75,98,79,4,,,,26,15,11,,,
"Jun 5, 2023 5:00 PM",72,28,44,201,91,110,279,119,160,180,68,112,,,,44,15,12,3,,,,12,41,115,46,69,62,5,,,,4,3,1,,,
"Jun 5, 2023 6:00 PM",56,27,29,119,66,53,170,66,104,130,58,72,,,,20,26,23,3,,,,22,27,84,41,43,42,2,,,,10,6,4,,,
"Jun 5, 2023 7:00 PM",44,23,21,92,41,51,107,38,69,74,31,43,,,,30,13,12,1,,,,13,27,48,14,34,40,2,,,,6,4,2,,,
"Jun 5, 2023 8:00 PM",33,17,16,102,40,62,125,44,81,103,38,65,,,,23,10,9,1,,,,7,19,46,14,32,36,5,,,,7,5,2,,,
"Jun 5, 2023 9:00 PM",30,8,22,33,19,14,47,15,32,37,16,21,,,,9,13,12,1,,,,13,12,18,6,12,21,1,,,,6,5,1,,,
"Jun 5, 2023 10:00 PM",18,10,8,12,5,7,26,5,21,16,4,12,,,,3,3,3,0,,,,4,8,7,2,5,7,0,,,,1,1,0,,,
"Jun 5, 2023 11:00 PM",9,3,6,5,5,0,4,2,2,3,0,3,,,,1,7,6,1,,,,5,4,2,1,1,7,1,,,,1,0,1,,,
"Jun 6, 2023 12:00 AM",11,4,7,0,0,0,0,0,0,4,2,2,,,,0,0,0,0,,,,0,3,2,2,0,1,0,,,,0,0,0,,,
"Jun 6, 2023 1:00 AM",3,0,3,4,1,3,3,2,1,0,0,0,,,,0,1,0,1,,,,0,1,0,0,0,0,0,,,,0,0,0,,,
"Jun 6, 2023 2:00 AM",3,3,0,0,0,0,0,0,0,0,0,0,,,,0,2,2,0,,,,2,0,2,0,2,1,0,,,,0,0,0,,,
"Jun 6, 2023 3:00 AM",1,0,1,2,2,0,4,1,3,3,1,2,,,,0,0,0,0,,,,0,0,1,0,1,0,0,,,,0,0,0,,,
"Jun 6, 2023 4:00 AM",5,2,3,1,1,0,0,0,0,1,1,0,,,,1,4,4,0,,,,4,0,0,0,0,2,0,,,,0,0,0,,,
"Jun 6, 2023 5:00 AM",11,7,4,10,2,8,6,3,3,13,7,6,,,,3,5,5,0,,,,5,3,3,2,1,5,0,,,,0,0,0,,,
"Jun 6, 2023 6:00 AM",70,44,26,28,10,18,32,14,18,27,14,13,,,,14,28,28,0,,,,29,18,5,2,3,43,0,,,,2,1,1,,,
"Jun 6, 2023 7:00 AM",167,108,59,70,19,51,97,24,73,69,19,50,,,,12,103,103,0,,,,101,28,62,23,39,139,5,,,,10,7,3,,,
"Jun 6, 2023 8:00 AM",237,176,61,96,31,65,147,50,97,110,49,61,,,,34,191,188,3,,,,168,56,83,21,62,241,8,,,,9,5,4,,,
"Jun 6, 2023 9:00 AM",139,116,23,66,18,48,97,45,52,75,38,37,,,,15,84,84,0,,,,74,26,55,25,30,67,7,,,,4,3,1,,,
"Jun 6, 2023 10:00 AM",50,33,17,79,31,48,78,42,36,64,30,34,,,,30,36,35,1,,,,32,18,29,18,11,33,4,,,,3,1,2,,,
"Jun 6, 2023 11:00 AM",51,31,20,69,47,22,72,43,29,62,38,24,,,,22,32,30,2,,,,23,17,27,14,13,28,0,,,,4,4,0,,,
"Jun 6, 2023 12:00 PM",58,27,31,57,30,27,85,47,38,51,33,18,,,,36,28,26,2,,,,19,24,45,26,19,27,4,,,,5,5,0,,,
"Jun 6, 2023 1:00 PM",87,42,45,75,40,35,116,59,57,77,45,32,,,,42,15,14,1,,,,14,31,52,30,22,37,5,,,,3,1,2,,,
"Jun 6, 2023 2:00 PM",77,35,42,61,32,29,93,51,42,59,31,28,,,,29,12,11,1,,,,10,26,33,16,17,27,3,,,,4,1,3,,,
"Jun 6, 2023 3:00 PM",90,38,52,62,32,30,91,42,49,54,22,32,,,,30,23,21,2,,,,21,33,35,16,19,37,3,,,,4,3,1,,,
"Jun 6, 2023 4:00 PM",139,46,93,58,37,21,83,45,38,58,35,23,,,,27,22,17,5,,,,20,62,49,34,15,36,9,,,,10,5,5,,,
"Jun 6, 2023 5:00 PM",262,65,197,97,56,41,161,106,55,123,79,44,,,,16,36,30,6,,,,31,147,98,75,23,73,9,,,,6,5,1,,,
"Jun 6, 2023 6:00 PM",207,58,149,121,74,47,165,118,47,141,93,48,,,,41,43,32,11,,,,27,132,95,75,20,46,10,,,,16,14,2,,,
"Jun 6, 2023 7:00 PM",116,33,83,80,48,32,127,79,48,106,66,40,,,,19,24,24,0,,,,25,55,48,35,13,29,11,,,,4,3,1,,,
"Jun 6, 2023 8:00 PM",94,23,71,88,45,43,87,37,50,91,33,58,,,,13,21,20,1,,,,15,39,40,23,17,25,3,,,,7,3,4,,,
"Jun 6, 2023 9:00 PM",58,20,38,54,32,22,43,18,25,28,12,16,,,,7,9,7,2,,,,7,17,19,10,9,15,2,,,,4,2,2,,,
"Jun 6, 2023 10:00 PM",30,10,20,24,21,3,27,10,17,16,9,7,,,,4,5,3,2,,,,4,10,12,7,5,13,1,,,,0,0,0,,,
"Jun 6, 2023 11:00 PM",15,5,10,8,6,2,9,2,7,4,2,2,,,,3,4,4,0,,,,3,6,5,3,2,8,0,,,,1,0,1,,,
"Jun 7, 2023 12:00 AM",10,2,8,0,0,0,1,1,0,1,0,1,,,,0,3,3,0,,,,3,1,2,2,0,1,1,,,,2,2,0,,,
"Jun 7, 2023 1:00 AM",9,4,5,1,1,0,1,0,1,1,1,0,,,,0,0,0,0,,,,0,1,1,0,1,0,0,,,,0,0,0,,,
"Jun 7, 2023 2:00 AM",4,4,0,0,0,0,0,0,0,0,0,0,,,,0,2,1,1,,,,3,0,0,0,0,0,0,,,,0,0,0,,,
"Jun 7, 2023 3:00 AM",2,1,1,0,0,0,0,0,0,0,0,0,,,,1,0,0,0,,,,0,1,0,0,0,1,0,,,,0,0,0,,,
"Jun 7, 2023 4:00 AM",1,0,1,1,1,0,3,3,0,3,3,0,,,,0,4,4,0,,,,5,2,0,0,0,2,0,,,,1,1,0,,,
"Jun 7, 2023 5:00 AM",8,7,1,5,5,0,6,4,2,5,4,1,,,,2,6,6,0,,,,6,2,3,0,3,9,0,,,,0,0,0,,,
"Jun 7, 2023 6:00 AM",55,28,27,27,10,17,31,10,21,30,13,17,,,,9,31,31,0,,,,31,19,7,2,5,46,1,,,,2,2,0,,,
"Jun 7, 2023 7:00 AM",156,109,47,73,23,50,93,27,66,69,24,45,,,,13,118,117,1,,,,112,46,42,13,29,124,5,,,,13,9,4,,,
"Jun 7, 2023 8:00 AM",278,204,74,115,33,82,200,69,131,148,62,86,,,,40,197,194,3,,,,182,74,108,31,77,262,9,,,,8,6,2,,,
"Jun 7, 2023 9:00 AM",116,102,14,82,34,48,95,46,49,86,51,35,,,,39,92,90,2,,,,68,29,41,15,26,93,4,,,,8,7,1,,,
"Jun 7, 2023 10:00 AM",39,30,9,57,17,40,71,30,41,59,25,34,,,,38,27,27,0,,,,28,16,30,15,15,31,5,,,,7,2,5,,,
"Jun 7, 2023 11:00 AM",35,16,19,36,18,18,47,26,21,45,25,20,,,,42,18,17,1,,,,12,23,19,9,10,24,9,,,,8,3,5,,,
"Jun 7, 2023 12:00 PM",56,34,22,47,21,26,64,39,25,60,32,28,,,,40,27,27,0,,,,20,27,26,17,9,32,2,,,,4,3,1,,,
"Jun 7, 2023 1:00 PM",76,41,35,53,28,25,72,34,38,65,36,29,,,,7,18,15,3,,,,16,18,35,24,11,19,2,,,,5,4,1,,,
"Jun 7, 2023 2:00 PM",66,36,30,54,30,24,86,45,41,64,27,37,,,,16,14,11,3,,,,12,15,51,29,22,27,3,,,,5,4,1,,,
"Jun 7, 2023 3:00 PM",82,25,57,50,28,22,58,31,27,43,20,23,,,,23,26,21,5,,,,21,29,32,16,16,29,5,,,,10,9,1,,,
"Jun 7, 2023 4:00 PM",116,32,84,74,51,23,101,61,40,85,47,38,,,,23,45,36,9,,,,27,58,42,28,14,39,5,,,,15,8,7,,,
"Jun 7, 2023 5:00 PM",238,54,184,104,65,39,162,108,54,100,65,35,,,,43,43,34,9,,,,34,147,82,64,18,82,7,,,,4,2,2,,,
"Jun 7, 2023 6:00 PM",230,58,172,84,62,22,160,116,44,110,79,31,,,,21,32,29,3,,,,31,129,104,84,20,53,10,,,,8,5,3,,,
"Jun 7, 2023 7:00 PM",140,51,89,108,64,44,107,68,39,94,59,35,,,,25,28,27,1,,,,22,68,64,47,17,41,4,,,,8,2,6,,,
"Jun 7, 2023 8:00 PM",87,23,64,75,38,37,59,25,34,47,17,30,,,,16,20,19,1,,,,13,34,32,17,15,26,9,,,,5,4,1,,,
"Jun 7, 2023 9:00 PM",56,13,43,36,20,16,58,18,40,42,15,27,,,,17,12,9,3,,,,10,22,32,15,17,15,3,,,,3,3,0,,,
"Jun 7, 2023 10:00 PM",42,14,28,20,13,7,25,11,14,25,12,13,,,,2,6,6,0,,,,4,15,18,9,9,10,0,,,,0,0,0,,,
"Jun 7, 2023 11:00 PM",16,6,10,5,3,2,9,6,3,6,3,3,,,,0,8,7,1,,,,7,10,2,2,0,5,1,,,,1,1,0,,,
"Jun 8, 2023 12:00 AM",15,3,12,0,0,0,2,2,0,3,1,2,,,,0,2,2,0,,,,1,3,4,3,1,1,0,,,,1,1,0,,,
"Jun 8, 2023 1:00 AM",4,1,3,1,1,0,2,2,0,0,0,0,,,,0,3,3,0,,,,4,1,1,1,0,0,0,,,,0,0,0,,,
"Jun 8, 2023 2:00 AM",3,3,0,1,1,0,0,0,0,2,2,0,,,,2,1,0,1,,,,0,0,2,2,0,0,1,,,,0,0,0,,,
"Jun 8, 2023 3:00 AM",4,1,3,0,0,0,0,0,0,0,0,0,,,,0,0,0,0,,,,0,2,0,0,0,0,0,,,,0,0,0,,,
"Jun 8, 2023 4:00 AM",5,3,2,0,0,0,0,0,0,0,0,0,,,,0,3,3,0,,,,3,0,1,1,0,0,0,,,,0,0,0,,,
"Jun 8, 2023 5:00 AM",11,8,3,2,1,1,3,2,1,1,1,0,,,,1,5,5,0,,,,4,2,1,1,0,6,1,,,,0,0,0,,,
"Jun 8, 2023 6:00 AM",52,29,23,23,8,15,30,13,17,22,9,13,,,,15,24,23,1,,,,26,16,8,5,3,29,0,,,,5,5,0,,,
"Jun 8, 2023 7:00 AM",144,100,44,67,23,44,75,21,54,64,26,38,,,,17,92,91,1,,,,85,40,36,15,21,127,5,,,,4,4,0,,,
"Jun 8, 2023 8:00 AM",248,184,64,107,28,79,156,46,110,113,42,71,,,,35,178,176,2,,,,177,61,84,13,71,248,7,,,,14,11,3,,,
"Jun 8, 2023 9:00 AM",126,95,31,75,29,46,93,37,56,60,33,27,,,,9,96,95,1,,,,93,40,48,19,29,99,1,,,,6,4,2,,,
"Jun 8, 2023 10:00 AM",56,42,14,42,16,26,52,28,24,49,28,21,,,,15,33,32,1,,,,28,18,24,10,14,28,1,,,,2,0,2,,,
"Jun 8, 2023 11:00 AM",46,31,15,25,15,10,36,17,19,25,10,15,,,,7,22,20,2,,,,18,12,10,2,8,27,6,,,,6,5,1,,,
"Jun 8, 2023 12:00 PM",58,27,31,53,20,33,47,23,24,46,24,22,,,,8,18,15,3,,,,13,24,17,10,7,20,3,,,,2,1,1,,,
"Jun 8, 2023 1:00 PM",63,29,34,46,24,22,67,37,30,47,30,17,,,,22,18,16,2,,,,11,26,29,19,10,19,3,,,,3,2,1,,,
"Jun 8, 2023 2:00 PM",81,44,37,56,35,21,73,37,36,56,38,18,,,,23,21,19,2,,,,18,34,42,23,19,22,4,,,,4,1,3,,,
"Jun 8, 2023 3:00 PM",91,35,56,41,24,17,47,27,20,31,17,14,,,,28,19,18,1,,,,17,36,21,13,8,32,2,,,,0,0,0,,,
"Jun 8, 2023 4:00 PM",126,28,98,56,30,26,97,61,36,65,39,26,,,,13,35,28,7,,,,25,63,31,24,7,45,10,,,,7,6,1,,,
"Jun 8, 2023 5:00 PM",226,68,158,125,59,66,189,124,65,157,110,47,,,,29,59,51,8,,,,46,145,75,61,14,67,16,,,,11,8,3,,,
"Jun 8, 2023 6:00 PM",204,57,147,110,77,33,187,130,57,130,92,38,,,,22,35,34,1,,,,28,148,97,81,16,56,6,,,,18,10,8,,,
"Jun 8, 2023 7:00 PM",148,47,101,102,66,36,105,69,36,92,58,34,,,,20,15,13,2,,,,13,50,52,41,11,42,7,,,,9,5,4,,,
"Jun 8, 2023 8:00 PM",90,21,69,53,26,27,70,35,35,56,30,26,,,,14,16,15,1,,,,17,32,28,19,9,35,6,,,,4,2,2,,,
"Jun 8, 2023 9:00 PM",45,10,35,37,24,13,63,27,36,46,13,33,,,,9,8,8,0,,,,8,28,23,11,12,32,4,,,,5,4,1,,,
"Jun 8, 2023 10:00 PM",30,8,22,31,24,7,46,11,35,34,7,27,,,,9,7,6,1,,,,8,15,17,8,9,13,2,,,,2,1,1,,,
"Jun 8, 2023 11:00 PM",27,6,21,12,11,1,21,5,16,15,3,12,,,,2,3,3,0,,,,3,8,5,4,1,11,3,,,,1,1,0,,,
"Jun 9, 2023 12:00 AM",12,4,8,0,0,0,5,5,0,8,4,4,,,,0,2,1,1,,,,1,9,4,3,1,6,1,,,,5,3,2,,,
"Jun 9, 2023 1:00 AM",4,2,2,3,3,0,1,0,1,0,0,0,,,,0,0,0,0,,,,0,2,2,2,0,3,0,,,,0,0,0,,,
"Jun 9, 2023 2:00 AM",3,3,0,0,0,0,1,1,0,0,0,0,,,,1,1,1,0,,,,0,1,0,0,0,2,0,,,,0,0,0,,,
"Jun 9, 2023 3:00 AM",2,0,2,0,0,0,0,0,0,0,0,0,,,,0,0,0,0,,,,0,0,0,0,0,0,0,,,,0,0,0,,,
"Jun 9, 2023 4:00 AM",3,1,2,0,0,0,1,0,1,0,0,0,,,,0,2,2,0,,,,2,0,1,1,0,1,0,,,,1,1,0,,,
"Jun 9, 2023 5:00 AM",12,11,1,1,1,0,5,2,3,6,5,1,,,,1,3,3,0,,,,2,3,2,1,1,8,0,,,,0,0,0,,,
"Jun 9, 2023 6:00 AM",51,29,22,26,14,12,37,21,16,23,14,9,,,,10,15,14,1,,,,14,22,10,7,3,27,0,,,,1,1,0,,,
"Jun 9, 2023 7:00 AM",106,67,39,88,32,56,93,37,56,69,31,38,,,,16,51,50,1,,,,50,28,48,23,25,96,6,,,,11,10,1,,,
"Jun 9, 2023 8:00 AM",200,146,54,86,30,56,114,36,78,87,37,50,,,,25,101,99,2,,,,97,46,61,11,50,135,8,,,,14,11,3,,,
"Jun 9, 2023 9:00 AM",76,57,19,70,30,40,87,41,46,67,38,29,,,,9,69,68,1,,,,61,24,39,20,19,67,3,,,,3,1,2,,,
"Jun 9, 2023 10:00 AM",44,29,15,59,21,38,67,34,33,63,31,32,,,,9,25,25,0,,,,25,27,25,10,15,33,1,,,,3,3,0,,,
"Jun 9, 2023 11:00 AM",51,30,21,69,29,40,74,38,36,59,33,26,,,,23,17,17,0,,,,21,11,30,21,9,33,3,,,,7,4,3,,,
"Jun 9, 2023 12:00 PM",66,25,41,75,35,40,98,54,44,69,43,26,,,,17,26,23,3,,,,21,18,46,31,15,27,2,,,,7,4,3,,,
"Jun 9, 2023 1:00 PM",102,45,57,83,47,36,127,70,57,88,43,45,,,,21,27,24,3,,,,22,33,49,28,21,26,4,,,,9,3,6,,,
"Jun 9, 2023 2:00 PM",70,33,37,65,38,27,108,58,50,80,44,36,,,,30,22,22,0,,,,19,28,42,23,19,31,16,,,,16,9,7,,,
"Jun 9, 2023 3:00 PM",94,48,46,79,44,35,127,79,48,89,51,38,,,,27,21,19,2,,,,16,52,46,25,21,37,4,,,,5,2,3,,,
"Jun 9, 2023 4:00 PM",134,45,89,91,54,37,155,85,70,82,53,29,,,,24,35,32,3,,,,29,53,81,63,18,57,5,,,,8,3,5,,,
"Jun 9, 2023 5:00 PM",189,64,125,117,76,41,217,143,74,110,76,34,,,,32,37,33,4,,,,40,80,110,75,35,52,8,,,,8,3,5,,,
"Jun 9, 2023 6:00 PM",130,38,92,119,63,56,209,120,89,103,58,45,,,,28,26,24,2,,,,22,84,87,50,37,44,6,,,,6,5,1,,,
"Jun 9, 2023 7:00 PM",97,37,60,112,60,52,142,68,74,79,42,37,,,,21,18,16,2,,,,11,36,67,36,31,53,5,,,,4,1,3,,,
"Jun 9, 2023 8:00 PM",69,28,41,65,33,32,69,25,44,44,18,26,,,,9,22,21,1,,,,21,27,36,15,21,31,4,,,,8,4,4,,,
"Jun 9, 2023 9:00 PM",47,19,28,38,32,6,41,17,24,30,15,15,,,,8,16,14,2,,,,12,16,34,17,17,15,1,,,,3,1,2,,,
"Jun 9, 2023 10:00 PM",35,10,25,13,5,8,23,5,18,16,4,12,,,,4,3,2,1,,,,2,8,12,5,7,16,1,,,,3,2,1,,,
"Jun 9, 2023 11:00 PM",26,6,20,6,4,2,18,7,11,12,5,7,,,,6,5,4,1,,,,5,7,7,4,3,12,0,,,,3,3,0,,,
"Jun 10, 2023 12:00 AM",15,4,11,2,2,0,0,0,0,12,8,4,,,,5,4,4,0,,,,4,16,4,4,0,8,1,,,,1,0,1,,,
"Jun 10, 2023 1:00 AM",11,2,9,0,0,0,4,3,1,0,0,0,,,,1,1,0,1,,,,0,4,4,4,0,8,1,,,,0,0,0,,,
"Jun 10, 2023 2:00 AM",7,4,3,4,1,3,1,1,0,1,0,1,,,,0,2,2,0,,,,2,2,0,0,0,2,0,,,,2,2,0,,,
"Jun 10, 2023 3:00 AM",6,4,2,0,0,0,0,0,0,0,0,0,,,,1,2,2,0,,,,2,2,1,1,0,0,0,,,,0,0,0,,,
"Jun 10, 2023 4:00 AM",3,2,1,3,3,0,4,3,1,2,2,0,,,,0,0,0,0,,,,0,0,2,2,0,1,0,,,,1,1,0,,,
"Jun 10, 2023 5:00 AM",1,1,0,3,2,1,4,3,1,2,0,2,,,,2,0,0,0,,,,0,0,3,3,0,3,0,,,,0,0,0,,,
"Jun 10, 2023 6:00 AM",16,10,6,12,3,9,14,7,7,8,4,4,,,,1,4,4,0,,,,3,13,5,2,3,8,1,,,,2,2,0,,,
"Jun 10, 2023 7:00 AM",17,6,11,34,21,13,48,32,16,36,26,10,,,,5,10,10,0,,,,10,15,11,7,4,17,0,,,,2,1,1,,,
"Jun 10, 2023 8:00 AM",34,17,17,75,46,29,89,60,29,66,51,15,,,,18,12,12,0,,,,12,28,19,16,3,29,3,,,,4,3,1,,,
"Jun 10, 2023 9:00 AM",43,25,18,112,65,47,105,68,37,80,55,25,,,,14,26,26,0,,,,22,25,33,20,13,23,6,,,,7,5,2,,,
"Jun 10, 2023 10:00 AM",56,33,23,135,61,74,131,74,57,129,74,55,,,,7,31,28,3,,,,24,32,55,33,22,27,6,,,,9,8,1,,,
"Jun 10, 2023 11:00 AM",55,29,26,125,51,74,120,46,74,119,59,60,,,,17,18,18,0,,,,19,30,53,30,23,43,1,,,,11,4,7,,,
"Jun 10, 2023 12:00 PM",67,42,25,227,115,112,181,119,62,189,129,60,,,,18,25,22,3,,,,18,62,69,42,27,43,8,,,,10,7,3,,,
"Jun 10, 2023 1:00 PM",75,47,28,141,59,82,131,64,67,123,55,68,,,,19,27,27,0,,,,29,34,71,53,18,70,11,,,,14,10,4,,,
"Jun 10, 2023 2:00 PM",60,31,29,124,58,66,127,73,54,116,68,48,,,,14,23,21,2,,,,20,22,53,24,29,42,5,,,,9,8,1,,,
"Jun 10, 2023 3:00 PM",82,42,40,109,56,53,139,58,81,93,37,56,,,,9,17,16,1,,,,18,22,51,18,33,46,3,,,,6,3,3,,,
"Jun 10, 2023 4:00 PM",58,15,43,79,47,32,81,24,57,61,14,47,,,,10,17,15,2,,,,13,10,46,15,31,29,1,,,,7,6,1,,,
"Jun 10, 2023 5:00 PM",52,13,39,72,44,28,78,38,40,64,26,38,,,,10,9,8,1,,,,6,12,35,18,17,21,2,,,,4,3,1,,,
"Jun 10, 2023 6:00 PM",56,22,34,50,30,20,74,31,43,42,19,23,,,,15,19,13,6,,,,16,18,26,12,14,21,2,,,,5,2,3,,,
"Jun 10, 2023 7:00 PM",41,20,21,27,14,13,46,21,25,26,12,14,,,,7,10,8,2,,,,8,14,16,8,8,15,2,,,,6,4,2,,,
"Jun 10, 2023 8:00 PM",41,20,21,37,21,16,32,15,17,24,12,12,,,,3,8,7,1,,,,6,9,16,7,9,14,4,,,,4,4,0,,,
"Jun 10, 2023 9:00 PM",21,15,6,16,10,6,24,11,13,16,7,9,,,,5,3,3,0,,,,4,6,11,9,2,12,1,,,,2,0,2,,,
"Jun 10, 2023 10:00 PM",25,9,16,4,1,3,16,7,9,12,9,3,,,,0,8,7,1,,,,6,8,10,7,3,8,3,,,,5,2,3,,,
"Jun 10, 2023 11:00 PM",21,7,14,4,2,2,10,5,5,4,1,3,,,,1,6,6,0,,,,6,4,10,3,7,2,1,,,,0,0,0,,,
"Jun 11, 2023 12:00 AM",6,2,4,0,0,0,0,0,0,4,2,2,,,,3,5,5,0,,,,5,8,2,0,2,5,2,,,,1,1,0,,,
"Jun 11, 2023 1:00 AM",9,2,7,5,1,4,6,1,5,4,2,2,,,,0,3,2,1,,,,4,1,6,3,3,9,0,,,,1,0,1,,,
"Jun 11, 2023 2:00 AM",5,3,2,0,0,0,3,3,0,0,0,0,,,,0,0,0,0,,,,1,2,0,0,0,1,1,,,,0,0,0,,,
"Jun 11, 2023 3:00 AM",4,1,3,1,1,0,0,0,0,1,1,0,,,,0,0,0,0,,,,0,1,0,0,0,0,0,,,,0,0,0,,,
"Jun 11, 2023 4:00 AM",2,1,1,0,0,0,1,1,0,0,0,0,,,,0,1,1,0,,,,1,1,0,0,0,2,0,,,,0,0,0,,,
"Jun 11, 2023 5:00 AM",3,1,2,4,3,1,5,3,2,3,3,0,,,,1,0,0,0,,,,0,5,2,2,0,2,0,,,,0,0,0,,,
"Jun 11, 2023 6:00 AM",11,6,5,12,7,5,11,8,3,9,6,3,,,,4,1,1,0,,,,2,7,1,1,0,6,1,,,,1,1,0,,,
"Jun 11, 2023 7:00 AM",16,7,9,37,14,23,53,32,21,38,23,15,,,,4,7,7,0,,,,6,12,10,3,7,22,0,,,,1,1,0,,,
"Jun 11, 2023 8:00 AM",15,9,6,58,38,20,96,56,40,60,38,22,,,,1,9,8,1,,,,8,24,31,21,10,41,4,,,,4,4,0,,,
"Jun 11, 2023 9:00 AM",40,26,14,122,68,54,108,78,30,101,75,26,,,,10,17,16,1,,,,15,22,42,31,11,37,4,,,,7,4,3,,,
"Jun 11, 2023 10:00 AM",64,38,26,176,110,66,177,106,71,174,113,61,,,,8,22,19,3,,,,20,23,84,52,32,38,8,,,,10,8,2,,,
"Jun 11, 2023 11:00 AM",63,33,30,188,99,89,181,108,73,160,89,71,,,,20,12,12,0,,,,14,49,72,38,34,50,7,,,,12,9,3,,,
"Jun 11, 2023 12:00 PM",67,28,39,186,89,97,181,97,84,148,87,61,,,,12,32,28,4,,,,26,37,82,51,31,40,6,,,,12,11,1,,,
"Jun 11, 2023 1:00 PM",51,23,28,236,120,116,221,124,97,208,121,87,,,,23,27,26,1,,,,32,40,115,77,38,49,5,,,,13,6,7,,,
"Jun 11, 2023 2:00 PM",59,36,23,156,82,74,144,71,73,132,70,62,,,,21,28,24,4,,,,20,30,86,54,32,43,16,,,,16,12,4,,,
"Jun 11, 2023 3:00 PM",60,35,25,179,90,89,203,103,100,156,79,77,,,,68,19,18,1,,,,13,39,92,55,37,39,20,,,,14,12,2,,,
"Jun 11, 2023 4:00 PM",48,23,25,155,74,81,244,111,133,145,65,80,,,,29,13,11,2,,,,10,39,112,50,62,66,11,,,,7,7,0,,,
"Jun 11, 2023 5:00 PM",42,17,25,163,75,88,229,106,123,129,56,73,,,,9,20,19,1,,,,20,22,95,44,51,41,2,,,,11,8,3,,,
"Jun 11, 2023 6:00 PM",41,17,24,120,65,55,170,82,88,107,53,54,,,,38,14,13,1,,,,15,28,77,40,37,50,4,,,,7,4,3,,,
"Jun 11, 2023 7:00 PM",48,25,23,81,33,48,139,57,82,76,32,44,,,,22,10,9,1,,,,11,15,73,36,37,44,2,,,,3,0,3,,,
"Jun 11, 2023 8:00 PM",39,20,19,62,28,34,95,33,62,46,21,25,,,,10,11,10,1,,,,10,8,56,13,43,23,4,,,,4,3,1,,,
"Jun 11, 2023 9:00 PM",17,8,9,30,11,19,52,18,34,29,11,18,,,,3,6,6,0,,,,5,12,17,8,9,15,2,,,,3,2,1,,,
"Jun 11, 2023 10:00 PM",18,5,13,32,14,18,24,6,18,12,3,9,,,,7,12,11,1,,,,11,3,13,1,12,14,0,,,,3,1,2,,,
"Jun 11, 2023 11:00 PM",19,0,19,7,2,5,15,1,14,12,3,9,,,,8,6,6,0,,,,5,4,7,2,5,11,1,,,,0,0,0,,,
"Jun 12, 2023 12:00 AM",6,1,5,0,0,0,1,1,0,6,4,2,,,,3,3,3,0,,,,3,4,2,1,1,0,1,,,,0,0,0,,,
"Jun 12, 2023 1:00 AM",4,1,3,0,0,0,2,0,2,0,0,0,,,,0,0,0,0,,,,0,0,0,0,0,4,0,,,,0,0,0,,,
"Jun 12, 2023 2:00 AM",1,0,1,1,1,0,1,1,0,0,0,0,,,,2,2,1,1,,,,1,1,1,1,0,1,0,,,,0,0,0,,,
"Jun 12, 2023 3:00 AM",3,2,1,0,0,0,0,0,0,0,0,0,,,,0,0,0,0,,,,0,0,0,0,0,0,0,,,,0,0,0,,,
"Jun 12, 2023 4:00 AM",2,0,2,0,0,0,1,1,0,0,0,0,,,,0,4,4,0,,,,4,0,1,1,0,0,0,,,,0,0,0,,,
"Jun 12, 2023 5:00 AM",9,6,3,2,2,0,6,3,3,5,3,2,,,,0,4,4,0,,,,4,4,2,1,1,5,0,,,,0,0,0,,,
"Jun 12, 2023 6:00 AM",51,33,18,22,9,13,34,13,21,22,10,12,,,,7,21,21,0,,,,19,13,7,3,4,40,4,,,,5,5,0,,,
"Jun 12, 2023 7:00 AM",118,82,36,55,16,39,88,33,55,41,12,29,,,,12,83,83,0,,,,78,29,38,16,22,134,3,,,,8,8,0,,,
"Jun 12, 2023 8:00 AM",229,169,60,80,19,61,135,47,88,83,33,50,,,,28,143,139,4,,,,133,54,64,18,46,206,9,,,,20,16,4,,,
"Jun 12, 2023 9:00 AM",112,81,31,59,18,41,113,51,62,76,39,37,,,,11,68,67,1,,,,56,27,58,23,35,75,2,,,,6,5,1,,,
"Jun 12, 2023 10:00 AM",36,28,8,36,18,18,50,24,26,40,25,15,,,,11,28,26,2,,,,24,12,30,18,12,30,3,,,,2,1,1,,,
"Jun 12, 2023 11:00 AM",43,27,16,30,16,14,50,25,25,35,21,14,,,,4,18,17,1,,,,12,8,23,11,12,20,1,,,,0,0,0,,,
"Jun 12, 2023 12:00 PM",55,33,22,23,12,11,37,18,19,24,12,12,,,,10,16,15,1,,,,11,10,20,11,9,20,1,,,,5,4,1,,,
"Jun 12, 2023 1:00 PM",55,26,29,17,10,7,45,22,23,28,8,20,,,,16,13,12,1,,,,14,16,16,9,7,20,3,,,,4,3,1,,,
"Jun 12, 2023 2:00 PM",59,30,29,19,15,4,21,13,8,23,17,6,,,,18,14,13,1,,,,12,14,16,14,2,22,4,,,,9,1,8,,,
"Jun 12, 2023 3:00 PM",53,24,29,26,8,18,33,23,10,25,16,9,,,,16,14,12,2,,,,10,21,13,12,1,17,3,,,,4,4,0,,,
"Jun 12, 2023 4:00 PM",123,22,101,54,34,20,86,57,29,52,34,18,,,,17,30,23,7,,,,19,54,45,33,12,29,3,,,,6,4,2,,,
"Jun 12, 2023 5:00 PM",152,6,146,101,64,37,129,85,44,101,68,33,,,,23,39,33,6,,,,33,117,72,56,16,56,10,,,,5,4,1,,,
"Jun 12, 2023 6:00 PM",157,35,122,99,68,31,187,128,59,118,78,40,,,,28,23,19,4,,,,18,117,84,67,17,50,7,,,,11,7,4,,,
"Jun 12, 2023 7:00 PM",102,27,75,102,61,41,179,113,66,106,64,42,,,,91,30,23,7,,,,24,61,94,69,25,28,4,,,,9,5,4,,,
"Jun 12, 2023 8:00 PM",77,26,51,77,43,34,149,76,73,74,35,39,,,,23,23,19,4,,,,13,24,83,42,41,39,3,,,,8,3,5,,,
"Jun 12, 2023 9:00 PM",57,14,43,55,23,32,81,22,59,61,16,45,,,,15,10,9,1,,,,10,18,22,8,14,34,5,,,,3,2,1,,,
"Jun 12, 2023 10:00 PM",29,7,22,24,8,16,44,9,35,19,4,15,,,,4,4,4,0,,,,3,16,13,5,8,15,2,,,,0,0,0,,,
"Jun 12, 2023 11:00 PM",9,2,7,8,7,1,7,1,6,5,2,3,,,,4,5,5,0,,,,4,4,6,3,3,4,0,,,,2,1,1,,,
"Jun 13, 2023 12:00 AM",6,0,6,0,0,0,3,2,1,5,2,3,,,,1,0,0,0,,,,0,3,5,3,2,0,0,,,,1,0,1,,,
"Jun 13, 2023 1:00 AM",0,0,0,1,1,0,3,3,0,0,0,0,,,,0,2,2,0,,,,0,3,1,1,0,0,0,,,,0,0,0,,,
"Jun 13, 2023 2:00 AM",2,1,1,0,0,0,1,0,1,0,0,0,,,,0,0,0,0,,,,0,1,0,0,0,0,0,,,,0,0,0,,,
"Jun 13, 2023 3:00 AM",0,0,0,0,0,0,0,0,0,0,0,0,,,,0,0,0,0,,,,0,0,0,0,0,0,0,,,,0,0,0,,,
"Jun 13, 2023 4:00 AM",1,1,0,1,1,0,3,3,0,3,3,0,,,,0,4,4,0,,,,4,0,1,1,0,1,0,,,,0,0,0,,,
"Jun 13, 2023 5:00 AM",10,6,4,1,0,1,5,4,1,1,1,0,,,,1,3,3,0,,,,3,3,1,0,1,3,0,,,,0,0,0,,,
"Jun 13, 2023 6:00 AM",53,36,17,18,4,14,23,8,15,15,6,9,,,,5,22,22,0,,,,22,11,10,4,6,42,2,,,,2,2,0,,,
"Jun 13, 2023 7:00 AM",161,106,55,66,16,50,107,30,77,66,21,45,,,,13,92,92,0,,,,90,39,46,16,30,159,6,,,,9,7,2,,,
"Jun 13, 2023 8:00 AM",266,205,61,129,37,92,75,36,39,126,52,74,,,,50,182,177,5,,,,171,59,102,23,79,282,6,,,,16,13,3,,,
"Jun 13, 2023 9:00 AM",127,102,25,74,27,47,131,60,71,52,25,27,,,,16,93,92,1,,,,80,25,68,25,43,93,5,,,,7,4,3,,,
"Jun 13, 2023 10:00 AM",53,32,21,82,38,44,83,48,35,67,37,30,,,,13,14,13,1,,,,45,5,33,15,18,45,3,,,,5,2,3,,,
"Jun 13, 2023 11:00 AM",51,28,23,64,33,31,86,48,38,58,36,22,,,,8,28,26,2,,,,25,0,42,24,18,32,3,,,,7,6,1,,,
"Jun 13, 2023 12:00 PM",63,39,24,65,35,30,96,41,55,64,35,29,,,,20,15,13,2,,,,13,0,29,9,20,31,2,,,,7,5,2,,,
"Jun 13, 2023 1:00 PM",87,41,46,69,42,27,72,45,27,64,36,28,,,,24,16,11,5,,,,6,3,44,29,15,28,7,,,,8,5,3,,,
"Jun 13, 2023 2:00 PM",61,30,31,2,0,2,103,62,41,80,55,25,,,,22,20,18,2,,,,15,24,43,29,14,20,11,,,,9,5,4,,,
"Jun 13, 2023 3:00 PM",90,41,49,84,35,49,95,48,47,95,38,57,,,,15,23,21,2,,,,22,56,47,27,20,37,2,,,,2,0,2,,,
"Jun 13, 2023 4:00 PM",156,42,114,128,73,55,163,101,62,119,72,47,,,,35,41,35,6,,,,34,79,74,44,30,55,12,,,,12,10,2,,,
"Jun 13, 2023 5:00 PM",266,59,207,172,102,70,247,161,86,176,108,68,,,,45,43,35,8,,,,31,159,125,96,29,72,17,,,,14,8,6,,,
"Jun 13, 2023 6:00 PM",221,67,154,222,149,73,394,288,106,208,143,65,,,,45,46,40,6,,,,37,205,205,165,40,62,10,,,,21,11,10,,,
"Jun 13, 2023 7:00 PM",128,32,96,201,115,86,391,252,139,190,115,75,,,,29,29,25,4,,,,24,86,182,143,39,67,7,,,,11,5,6,,,
"Jun 13, 2023 8:00 PM",100,27,73,199,107,92,406,178,228,192,92,100,,,,48,30,29,1,,,,29,54,120,54,66,79,14,,,,10,6,4,,,
"Jun 13, 2023 9:00 PM",68,24,44,121,46,75,240,60,180,113,35,78,,,,19,16,13,3,,,,12,27,111,25,86,82,5,,,,11,8,3,,,
"Jun 13, 2023 10:00 PM",36,11,25,64,25,39,107,11,96,72,21,51,,,,9,8,8,0,,,,8,17,48,8,40,49,2,,,,4,2,2,,,
"Jun 13, 2023 11:00 PM",17,5,12,9,4,5,19,4,15,11,3,8,,,,0,4,4,0,,,,5,5,6,1,5,8,2,,,,3,2,1,,,
"Jun 14, 2023 12:00 AM",9,4,5,0,0,0,1,1,0,2,0,2,,,,2,1,1,0,,,,0,2,4,2,2,2,0,,,,2,0,2,,,
"Jun 14, 2023 1:00 AM",3,0,3,1,0,1,1,0,1,0,0,0,,,,0,1,1,0,,,,1,0,1,0,1,0,0,,,,0,0,0,,,
"Jun 14, 2023 2:00 AM",8,5,3,0,0,0,1,0,1,1,0,1,,,,0,0,0,0,,,,0,0,1,0,1,1,0,,,,0,0,0,,,
"Jun 14, 2023 3:00 AM",2,1,1,0,0,0,0,0,0,0,0,0,,,,0,0,0,0,,,,0,0,0,0,0,0,0,,,,0,0,0,,,
"Jun 14, 2023 4:00 AM",3,2,1,2,2,0,3,3,0,2,2,0,,,,1,5,5,0,,,,5,2,1,1,0,0,0,,,,1,1,0,,,
"Jun 14, 2023 5:00 AM",13,10,3,8,6,2,7,6,1,11,9,2,,,,5,3,3,0,,,,4,4,1,1,0,10,0,,,,0,0,0,,,
"Jun 14, 2023 6:00 AM",62,43,19,43,12,31,52,19,33,38,13,25,,,,11,22,22,0,,,,21,24,15,11,4,60,2,,,,3,3,0,,,
"Jun 14, 2023 7:00 AM",139,100,39,106,37,69,135,53,82,103,36,67,,,,13,104,104,0,,,,103,48,54,26,28,139,4,,,,9,6,3,,,
"Jun 14, 2023 8:00 AM",293,223,70,150,46,104,222,72,150,133,51,82,,,,47,180,175,5,,,,164,79,112,25,87,241,5,,,,21,14,7,,,
"Jun 14, 2023 9:00 AM",134,105,29,73,35,38,135,69,66,87,52,35,,,,15,76,76,0,,,,70,26,74,29,45,112,8,,,,10,5,5,,,
"Jun 14, 2023 10:00 AM",55,38,17,91,42,49,123,68,55,87,53,34,,,,9,31,30,1,,,,23,32,61,31,30,30,2,,,,9,5,4,,,
"Jun 14, 2023 11:00 AM",57,33,24,101,52,49,110,63,47,68,38,30,,,,7,31,29,2,,,,27,17,37,19,18,26,5,,,,5,3,2,,,
"Jun 14, 2023 12:00 PM",57,23,34,83,42,41,127,61,66,65,35,30,,,,14,28,25,3,,,,22,29,39,17,22,32,4,,,,4,4,0,,,
"Jun 14, 2023 1:00 PM",91,49,42,83,38,45,133,68,65,80,43,37,,,,18,21,19,2,,,,13,31,60,37,23,40,6,,,,6,5,1,,,
"Jun 14, 2023 2:00 PM",80,38,42,90,49,41,84,48,36,73,45,28,,,,18,23,20,3,,,,18,26,44,20,24,35,6,,,,11,6,5,,,
"Jun 14, 2023 3:00 PM",72,26,46,106,58,48,111,58,53,75,47,28,,,,15,19,18,1,,,,15,30,44,29,15,36,7,,,,12,6,6,,,
"Jun 14, 2023 4:00 PM",141,41,100,114,73,41,153,93,60,119,67,52,,,,21,33,25,8,,,,27,54,70,49,21,63,9,,,,11,8,3,,,
"Jun 14, 2023 5:00 PM",233,64,169,172,103,69,257,162,95,162,109,53,,,,32,50,46,4,,,,48,166,130,101,29,82,10,,,,13,8,5,,,
"Jun 14, 2023 6:00 PM",215,49,166,193,131,62,354,251,103,184,122,62,,,,40,45,41,4,,,,45,147,170,128,42,61,15,,,,18,10,8,,,
"Jun 14, 2023 7:00 PM",130,41,89,179,86,93,360,228,132,164,105,59,,,,44,27,22,5,,,,25,95,125,88,37,62,8,,,,16,7,9,,,
"Jun 14, 2023 8:00 PM",75,24,51,154,62,92,274,94,180,153,58,95,,,,37,25,23,2,,,,16,37,118,53,65,66,8,,,,6,4,2,,,
"Jun 14, 2023 9:00 PM",62,17,45,80,39,41,151,47,104,75,28,47,,,,16,15,15,0,,,,17,21,58,20,38,52,3,,,,7,3,4,,,
"Jun 14, 2023 10:00 PM",42,13,29,42,21,21,60,13,47,42,10,32,,,,10,11,8,3,,,,9,21,40,15,25,37,1,,,,2,1,1,,,
"Jun 14, 2023 11:00 PM",20,6,14,13,8,5,27,9,18,13,6,7,,,,4,8,8,0,,,,6,5,11,6,5,12,1,,,,3,3,0,,,
"Jun 15, 2023 12:00 AM",16,6,10,0,0,0,4,1,3,6,2,4,,,,0,4,4,0,,,,3,3,2,1,1,6,1,,,,1,1,0,,,
"Jun 15, 2023 1:00 AM",3,0,3,0,0,0,2,1,1,0,0,0,,,,0,0,0,0,,,,0,5,2,1,1,1,0,,,,0,0,0,,,
"Jun 15, 2023 2:00 AM",3,3,0,1,0,1,3,1,2,1,0,1,,,,1,0,0,0,,,,0,3,1,1,0,0,0,,,,0,0,0,,,
"Jun 15, 2023 3:00 AM",4,2,2,0,0,0,0,0,0,0,0,0,,,,0,0,0,0,,,,0,0,0,0,0,0,0,,,,0,0,0,,,
"Jun 15, 2023 4:00 AM",3,0,3,0,0,0,1,1,0,0,0,0,,,,0,4,4,0,,,,3,3,0,0,0,3,0,,,,0,0,0,,,
"Jun 15, 2023 5:00 AM",12,8,4,4,1,3,6,4,2,5,3,2,,,,4,6,6,0,,,,6,2,1,0,1,7,0,,,,0,0,0,,,
"Jun 15, 2023 6:00 AM",61,40,21,33,16,17,45,27,18,32,21,11,,,,10,23,23,0,,,,21,9,17,11,6,39,2,,,,3,2,1,,,
"Jun 15, 2023 7:00 AM",155,101,54,102,29,73,141,48,93,90,27,63,,,,21,89,88,1,,,,89,14,55,29,26,154,4,,,,11,8,3,,,
"Jun 15, 2023 8:00 AM",252,182,70,109,37,72,199,81,118,125,50,75,,,,28,167,166,1,,,,156,20,104,29,75,240,3,,,,11,11,0,,,
"Jun 15, 2023 9:00 AM",143,108,35,114,36,78,173,80,93,101,52,49,,,,18,89,87,2,,,,75,7,82,36,46,95,6,,,,6,4,2,,,
"Jun 15, 2023 10:00 AM",58,39,19,101,53,48,119,74,45,69,36,33,,,,14,42,41,1,,,,39,16,39,27,12,54,4,,,,3,1,2,,,
"Jun 15, 2023 11:00 AM",43,27,16,79,41,38,117,61,56,72,42,30,,,,6,17,16,1,,,,15,9,48,26,22,32,4,,,,7,5,2,,,
"Jun 15, 2023 12:00 PM",59,30,29,115,63,52,141,77,64,78,45,33,,,,12,20,18,2,,,,18,7,67,37,30,44,3,,,,7,4,3,,,
"Jun 15, 2023 1:00 PM",90,52,38,107,55,52,154,77,77,75,41,34,,,,7,19,18,1,,,,18,33,56,31,25,36,7,,,,2,2,0,,,
"Jun 15, 2023 2:00 PM",76,35,41,85,50,35,101,51,50,65,36,29,,,,13,16,14,2,,,,14,28,40,19,21,49,6,,,,16,8,8,,,
"Jun 15, 2023 3:00 PM",100,46,54,81,40,41,109,58,51,71,40,31,,,,26,21,15,6,,,,13,41,58,38,20,37,3,,,,11,10,1,,,
"Jun 15, 2023 4:00 PM",137,40,97,101,50,51,136,87,49,106,61,45,,,,25,41,33,8,,,,23,57,74,54,20,55,9,,,,17,7,10,,,
"Jun 15, 2023 5:00 PM",242,70,172,169,92,77,233,147,86,197,137,60,,,,36,43,41,2,,,,44,178,113,78,35,71,6,,,,13,10,3,,,
"Jun 15, 2023 6:00 PM",208,59,149,179,116,63,241,168,73,196,138,58,,,,30,43,37,6,,,,37,139,112,85,27,74,11,,,,10,9,1,,,
"Jun 15, 2023 7:00 PM",125,46,79,167,96,71,239,155,84,155,99,56,,,,32,18,17,1,,,,13,75,106,69,37,44,11,,,,14,10,4,,,
"Jun 15, 2023 8:00 PM",96,37,59,129,58,71,181,81,100,122,50,72,,,,35,24,20,4,,,,20,55,64,31,33,55,6,,,,4,0,4,,,
"Jun 15, 2023 9:00 PM",71,21,50,101,51,50,147,39,108,92,25,67,,,,15,18,17,1,,,,16,19,51,14,37,46,6,,,,6,4,2,,,
"Jun 15, 2023 10:00 PM",54,16,38,41,23,18,67,10,57,38,3,35,,,,5,8,7,1,,,,7,15,24,6,18,26,1,,,,1,1,0,,,
"Jun 15, 2023 11:00 PM",31,9,22,13,7,6,13,3,10,14,5,9,,,,5,7,6,1,,,,6,6,5,2,3,13,1,,,,1,0,1,,,
"Jun 16, 2023 12:00 AM",11,4,7,0,0,0,1,0,1,7,3,4,,,,3,3,1,2,,,,1,10,14,9,5,7,2,,,,2,1,1,,,
"Jun 16, 2023 1:00 AM",10,4,6,3,0,3,8,6,2,0,0,0,,,,0,3,3,0,,,,3,2,3,2,1,2,0,,,,0,0,0,,,
"Jun 16, 2023 2:00 AM",10,4,6,1,1,0,3,2,1,3,2,1,,,,2,1,1,0,,,,1,4,1,1,0,2,0,,,,0,0,0,,,
"Jun 16, 2023 3:00 AM",0,0,0,1,0,1,0,0,0,0,0,0,,,,0,0,0,0,,,,0,1,2,2,0,1,0,,,,0,0,0,,,
"Jun 16, 2023 4:00 AM",3,1,2,0,0,0,2,0,2,4,3,1,,,,0,3,3,0,,,,3,0,1,1,0,3,0,,,,0,0,0,,,
"Jun 16, 2023 5:00 AM",10,5,5,4,3,1,3,2,1,3,2,1,,,,5,6,6,0,,,,5,5,1,1,0,5,0,,,,0,0,0,,,
"Jun 16, 2023 6:00 AM",49,29,20,42,20,22,53,32,21,42,22,20,,,,6,15,15,0,,,,16,7,17,12,5,40,0,,,,0,0,0,,,
"Jun 16, 2023 7:00 AM",95,60,35,109,39,70,103,35,68,88,33,55,,,,9,57,57,0,,,,53,12,48,21,27,93,4,,,,7,5,2,,,
"Jun 16, 2023 8:00 AM",184,130,54,106,34,72,163,59,104,103,52,51,,,,28,79,79,0,,,,72,15,71,22,49,135,9,,,,12,10,2,,,
"Jun 16, 2023 9:00 AM",106,74,32,91,45,46,134,76,58,96,52,44,,,,10,57,55,2,,,,49,4,66,36,30,87,4,,,,6,4,2,,,
"Jun 16, 2023 10:00 AM",55,44,11,98,53,45,138,78,60,74,47,27,,,,9,32,32,0,,,,27,10,39,23,16,33,4,,,,3,2,1,,,
"Jun 16, 2023 11:00 AM",58,29,29,109,47,62,136,71,65,92,51,41,,,,7,22,19,3,,,,19,24,73,38,35,31,6,,,,5,3,2,,,
"Jun 16, 2023 12:00 PM",57,24,33,86,38,48,98,41,57,64,29,35,,,,17,21,19,2,,,,15,23,35,12,23,43,3,,,,5,2,3,,,
"Jun 16, 2023 1:00 PM",75,30,45,49,27,22,85,34,51,46,23,23,,,,17,15,14,1,,,,16,19,45,20,25,26,5,,,,6,2,4,,,
"Jun 16, 2023 2:00 PM",58,26,32,42,22,20,56,32,24,41,21,20,,,,25,21,19,2,,,,17,23,33,14,19,35,6,,,,8,5,3,,,
"Jun 16, 2023 3:00 PM",86,33,53,50,37,13,56,34,22,60,39,21,,,,12,14,11,3,,,,13,45,25,18,7,27,3,,,,5,3,2,,,
"Jun 16, 2023 4:00 PM",105,30,75,44,27,17,54,28,26,48,27,21,,,,23,24,21,3,,,,19,31,23,17,6,27,5,,,,8,6,2,,,
"Jun 16, 2023 5:00 PM",137,44,93,64,41,23,90,50,40,84,43,41,,,,28,20,18,2,,,,18,86,47,32,15,39,11,,,,8,4,4,,,
"Jun 16, 2023 6:00 PM",119,45,74,74,49,25,89,66,23,76,56,20,,,,15,21,16,5,,,,13,61,42,33,9,23,6,,,,10,7,3,,,
"Jun 16, 2023 7:00 PM",56,15,41,25,17,8,60,35,25,44,25,19,,,,19,15,13,2,,,,14,19,14,10,4,26,4,,,,12,5,7,,,
"Jun 16, 2023 8:00 PM",44,16,28,21,14,7,30,17,13,28,15,13,,,,12,13,11,2,,,,13,15,14,8,6,21,5,,,,5,4,1,,,
"Jun 16, 2023 9:00 PM",40,11,29,15,10,5,18,7,11,11,8,3,,,,4,6,6,0,,,,6,12,6,3,3,16,2,,,,4,4,0,,,
"Jun 16, 2023 10:00 PM",37,19,18,8,4,4,12,2,10,11,1,10,,,,1,4,4,0,,,,4,5,8,6,2,14,1,,,,0,0,0,,,
"Jun 16, 2023 11:00 PM",18,11,7,8,2,6,9,5,4,10,4,6,,,,3,5,5,0,,,,5,4,4,1,3,3,0,,,,1,0,1,,,
"Jun 17, 2023 12:00 AM",6,3,3,0,0,0,1,1,0,3,2,1,,,,3,2,2,0,,,,2,2,4,3,1,3,0,,,,0,0,0,,,
"Jun 17, 2023 1:00 AM",7,0,7,1,1,0,3,2,1,3,2,1,,,,2,0,0,0,,,,0,3,3,3,0,2,0,,,,1,0,1,,,
"Jun 17, 2023 2:00 AM",4,4,0,1,1,0,5,3,2,3,2,1,,,,1,0,0,0,,,,0,0,2,2,0,4,0,,,,0,0,0,,,
"Jun 17, 2023 3:00 AM",3,0,3,0,0,0,1,0,1,0,0,0,,,,0,0,0,0,,,,1,3,1,0,1,1,0,,,,0,0,0,,,
"Jun 17, 2023 4:00 AM",3,1,2,0,0,0,2,2,0,0,0,0,,,,1,2,2,0,,,,2,2,1,1,0,1,0,,,,0,0,0,,,
"Jun 17, 2023 5:00 AM",1,0,1,0,0,0,3,1,2,1,0,1,,,,0,1,1,0,,,,1,4,0,0,0,2,1,,,,1,1,0,,,
"Jun 17, 2023 6:00 AM",10,7,3,0,0,0,4,3,1,1,1,0,,,,1,3,3,0,,,,3,2,1,1,0,8,2,,,,2,1,1,,,
"Jun 17, 2023 7:00 AM",15,7,8,35,21,14,20,13,7,22,13,9,,,,8,9,9,0,,,,10,5,6,3,3,9,0,,,,2,1,1,,,
"Jun 17, 2023 8:00 AM",26,12,14,48,28,20,42,26,16,38,26,12,,,,29,9,9,0,,,,10,19,21,13,8,13,3,,,,1,1,0,,,
"Jun 17, 2023 9:00 AM",39,29,10,88,54,34,78,53,25,77,55,22,,,,10,16,15,1,,,,15,19,20,13,7,18,5,,,,1,0,1,,,
"Jun 17, 2023 10:00 AM",35,18,17,48,17,31,44,18,26,50,24,26,,,,6,6,6,0,,,,6,18,9,4,5,18,1,,,,5,4,1,,,
"Jun 17, 2023 11:00 AM",34,21,13,27,6,21,38,15,23,27,5,22,,,,14,6,6,0,,,,7,16,12,7,5,12,8,,,,5,5,0,,,
"Jun 17, 2023 12:00 PM",53,34,19,63,15,48,64,42,22,60,38,22,,,,27,13,13,0,,,,12,25,26,19,7,19,4,,,,0,0,0,,,
"Jun 17, 2023 1:00 PM",45,21,24,74,38,36,85,53,32,75,48,27,,,,14,13,12,1,,,,10,18,25,15,10,21,2,,,,3,2,1,,,
"Jun 17, 2023 2:00 PM",52,26,26,82,46,36,91,47,44,79,50,29,,,,17,21,21,0,,,,18,18,48,34,14,34,2,,,,3,3,0,,,
"Jun 17, 2023 3:00 PM",58,30,28,88,52,36,102,71,31,89,62,27,,,,26,16,15,1,,,,14,17,51,31,20,26,7,,,,10,9,1,,,
"Jun 17, 2023 4:00 PM",65,37,28,93,39,54,111,41,70,96,42,54,,,,13,23,23,0,,,,23,21,61,24,37,28,7,,,,4,4,0,,,
"Jun 17, 2023 5:00 PM",44,20,24,95,59,36,102,47,55,91,32,59,,,,27,12,11,1,,,,13,14,52,23,29,34,6,,,,6,3,3,,,
"Jun 17, 2023 6:00 PM",47,23,24,72,42,30,68,23,45,61,25,36,,,,6,11,10,1,,,,10,18,21,12,9,20,5,,,,3,2,1,,,
"Jun 17, 2023 7:00 PM",50,25,25,36,14,22,48,14,34,36,10,26,,,,9,11,11,0,,,,8,16,22,6,16,18,4,,,,2,1,1,,,
"Jun 17, 2023 8:00 PM",44,22,22,23,14,9,30,12,18,22,7,15,,,,9,7,7,0,,,,11,7,22,7,15,9,1,,,,2,1,1,,,
"Jun 17, 2023 9:00 PM",38,11,27,18,5,13,24,8,16,17,5,12,,,,9,6,6,0,,,,8,5,14,8,6,12,1,,,,2,1,1,,,
"Jun 17, 2023 10:00 PM",16,10,6,15,7,8,20,6,14,13,4,9,,,,3,2,2,0,,,,2,5,8,6,2,9,0,,,,0,0,0,,,
"Jun 17, 2023 11:00 PM",18,5,13,11,7,4,20,9,11,19,10,9,,,,3,6,6,0,,,,7,11,6,4,2,8,2,,,,0,0,0,,,
"Jun 18, 2023 12:00 AM",10,3,7,0,0,0,4,2,2,2,1,1,,,,1,4,3,1,,,,3,5,3,3,0,7,0,,,,0,0,0,,,
"Jun 18, 2023 1:00 AM",11,4,7,2,0,2,8,4,4,3,0,3,,,,1,3,3,0,,,,3,2,4,3,1,6,0,,,,0,0,0,,,
"Jun 18, 2023 2:00 AM",4,1,3,3,3,0,2,2,0,0,0,0,,,,1,0,0,0,,,,0,3,0,0,0,1,1,,,,0,0,0,,,
"Jun 18, 2023 3:00 AM",2,1,1,1,1,0,0,0,0,0,0,0,,,,1,0,0,0,,,,1,3,0,0,0,0,0,,,,0,0,0,,,
"Jun 18, 2023 4:00 AM",1,0,1,3,3,0,4,3,1,2,2,0,,,,0,1,1,0,,,,1,1,1,1,0,1,0,,,,0,0,0,,,
"Jun 18, 2023 5:00 AM",1,0,1,1,0,1,1,1,0,0,0,0,,,,0,0,0,0,,,,0,1,0,0,0,3,0,,,,0,0,0,,,
"Jun 18, 2023 6:00 AM",7,5,2,8,5,3,16,9,7,12,6,6,,,,1,3,3,0,,,,3,8,4,3,1,14,1,,,,1,0,1,,,
"Jun 18, 2023 7:00 AM",15,6,9,50,25,25,39,25,14,45,29,16,,,,4,4,4,0,,,,4,14,7,4,3,15,0,,,,2,2,0,,,
"Jun 18, 2023 8:00 AM",32,17,15,98,60,38,86,50,36,83,49,34,,,,8,7,7,0,,,,7,23,24,19,5,57,3,,,,4,3,1,,,
"Jun 18, 2023 9:00 AM",39,16,23,106,61,45,85,50,35,93,58,35,,,,7,14,14,0,,,,19,22,41,30,11,25,5,,,,2,1,1,,,
"Jun 18, 2023 10:00 AM",49,29,20,154,92,62,139,98,41,129,85,44,,,,16,21,19,2,,,,18,34,57,35,22,36,3,,,,8,3,5,,,
"Jun 18, 2023 11:00 AM",64,40,24,154,77,77,171,95,76,129,70,59,,,,19,21,21,0,,,,16,43,60,41,19,46,4,,,,4,2,2,,,
"Jun 18, 2023 12:00 PM",65,41,24,169,78,91,249,142,107,149,76,73,,,,29,21,21,0,,,,20,51,116,79,37,56,11,,,,2,1,1,,,
"Jun 18, 2023 1:00 PM",73,26,47,172,98,74,226,120,106,157,99,58,,,,22,38,36,2,,,,27,53,112,76,36,46,11,,,,4,3,1,,,
"Jun 18, 2023 2:00 PM",53,30,23,154,74,80,191,109,82,126,76,50,,,,27,28,22,6,,,,20,29,100,52,48,52,4,,,,7,4,3,,,
"Jun 18, 2023 3:00 PM",73,45,28,172,69,103,194,82,112,163,76,87,,,,15,21,20,1,,,,21,35,91,46,45,45,7,,,,7,6,1,,,
"Jun 18, 2023 4:00 PM",55,18,37,150,74,76,159,65,94,116,54,62,,,,25,14,11,3,,,,12,37,93,40,53,35,3,,,,2,2,0,,,
"Jun 18, 2023 5:00 PM",57,29,28,153,57,96,154,61,93,130,59,71,,,,14,13,12,1,,,,12,21,70,28,42,43,6,,,,9,7,2,,,
"Jun 18, 2023 6:00 PM",65,26,39,64,28,36,98,26,72,69,20,49,,,,15,14,13,1,,,,13,19,29,11,18,45,2,,,,5,4,1,,,
"Jun 18, 2023 7:00 PM",51,26,25,45,24,21,39,16,23,33,16,17,,,,19,12,9,3,,,,10,15,32,17,15,25,7,,,,1,0,1,,,
"Jun 18, 2023 8:00 PM",46,19,27,45,16,29,44,13,31,37,17,20,,,,8,13,12,1,,,,9,11,22,7,15,21,2,,,,2,1,1,,,
"Jun 18, 2023 9:00 PM",23,8,15,28,11,17,43,17,26,29,10,19,,,,3,14,13,1,,,,15,14,16,5,11,18,0,,,,3,1,2,,,
"Jun 18, 2023 10:00 PM",26,12,14,9,7,2,14,7,7,7,6,1,,,,5,10,9,1,,,,6,4,2,1,1,4,1,,,,2,1,1,,,
"Jun 18, 2023 11:00 PM",15,4,11,7,4,3,6,5,1,8,4,4,,,,1,5,5,0,,,,5,5,4,3,1,3,0,,,,0,0,0,,,
"Jun 19, 2023 12:00 AM",4,1,3,0,0,0,3,1,2,6,3,3,,,,0,1,1,0,,,,1,7,5,2,3,7,1,,,,1,1,0,,,
"Jun 19, 2023 1:00 AM",5,3,2,0,0,0,3,2,1,0,0,0,,,,0,0,0,0,,,,0,1,2,1,1,3,0,,,,0,0,0,,,
"Jun 19, 2023 2:00 AM",2,0,2,0,0,0,1,1,0,0,0,0,,,,1,1,1,0,,,,1,0,1,1,0,0,0,,,,0,0,0,,,
"Jun 19, 2023 3:00 AM",6,3,3,0,0,0,2,2,0,1,1,0,,,,0,0,0,0,,,,0,0,2,2,0,0,0,,,,0,0,0,,,
"Jun 19, 2023 4:00 AM",1,0,1,1,0,1,0,0,0,3,2,1,,,,0,5,5,0,,,,5,1,1,0,1,2,0,,,,1,1,0,,,
"Jun 19, 2023 5:00 AM",15,13,2,2,1,1,7,1,6,5,2,3,,,,0,3,3,0,,,,3,5,3,0,3,6,0,,,,0,0,0,,,
"Jun 19, 2023 6:00 AM",53,34,19,13,7,6,24,10,14,14,7,7,,,,5,29,29,0,,,,29,13,8,4,4,27,1,,,,1,1,0,,,
"Jun 19, 2023 7:00 AM",109,84,25,75,22,53,96,36,60,70,26,44,,,,11,96,96,0,,,,91,39,43,17,26,124,4,,,,5,4,1,,,
"Jun 19, 2023 8:00 AM",232,168,64,112,26,86,156,48,108,116,50,66,,,,35,141,140,1,,,,138,50,78,20,58,195,11,,,,21,15,6,,,
"Jun 19, 2023 9:00 AM",113,92,21,75,29,46,111,58,53,97,56,41,,,,13,78,78,0,,,,69,29,54,17,37,90,1,,,,5,4,1,,,
"Jun 19, 2023 10:00 AM",61,43,18,76,32,44,79,39,40,50,26,24,,,,9,28,26,2,,,,26,13,29,14,15,30,1,,,,8,6,2,,,
"Jun 19, 2023 11:00 AM",53,40,13,53,28,25,93,58,35,53,30,23,,,,16,16,16,0,,,,11,20,33,17,16,23,1,,,,6,3,3,,,
"Jun 19, 2023 12:00 PM",69,36,33,59,35,24,105,50,55,54,30,24,,,,9,23,21,2,,,,21,17,43,26,17,33,4,,,,2,2,0,,,
"Jun 19, 2023 1:00 PM",69,32,37,57,27,30,93,46,47,46,24,22,,,,20,14,11,3,,,,10,36,41,19,22,15,3,,,,7,4,3,,,
"Jun 19, 2023 2:00 PM",70,34,36,42,25,17,71,29,42,42,17,25,,,,26,17,15,2,,,,12,22,46,19,27,40,3,,,,4,2,2,,,
"Jun 19, 2023 3:00 PM",67,25,42,46,16,30,59,29,30,36,20,16,,,,21,14,12,2,,,,11,16,27,17,10,23,4,,,,5,3,2,,,
"Jun 19, 2023 4:00 PM",128,41,87,39,24,15,63,36,27,55,36,19,,,,20,20,16,4,,,,15,59,41,24,17,31,2,,,,3,1,2,,,
"Jun 19, 2023 5:00 PM",226,59,167,75,47,28,128,78,50,99,64,35,,,,35,45,39,6,,,,42,123,62,44,18,60,4,,,,5,4,1,,,
"Jun 19, 2023 6:00 PM",189,63,126,86,66,20,142,104,38,98,68,30,,,,24,30,28,2,,,,29,117,87,74,13,38,4,,,,8,7,1,,,
"Jun 19, 2023 7:00 PM",115,48,67,104,61,43,111,70,41,94,58,36,,,,18,33,29,4,,,,31,52,56,38,18,36,2,,,,5,3,2,,,
"Jun 19, 2023 8:00 PM",71,20,51,98,50,48,118,56,62,90,43,47,,,,10,14,14,0,,,,14,27,47,26,21,22,6,,,,6,4,2,,,
"Jun 19, 2023 9:00 PM",46,13,33,75,42,33,61,26,35,55,23,32,,,,9,9,9,0,,,,9,20,30,12,18,19,4,,,,6,4,2,,,
"Jun 19, 2023 10:00 PM",48,10,38,19,5,14,31,7,24,23,6,17,,,,5,3,3,0,,,,4,24,22,9,13,14,4,,,,4,4,0,,,
"Jun 19, 2023 11:00 PM",24,4,20,2,2,0,10,7,3,14,6,8,,,,3,3,3,0,,,,3,6,5,5,0,4,1,,,,3,2,1,,,
"Jun 20, 2023 12:00 AM",8,4,4,0,0,0,2,1,1,3,1,2,,,,0,3,3,0,,,,3,6,2,2,0,3,2,,,,2,2,0,,,
"Jun 20, 2023 1:00 AM",4,1,3,0,0,0,1,0,1,0,0,0,,,,0,1,1,0,,,,1,0,0,0,0,0,0,,,,0,0,0,,,
"Jun 20, 2023 2:00 AM",4,4,0,0,0,0,1,0,1,0,0,0,,,,0,0,0,0,,,,0,0,0,0,0,0,0,,,,0,0,0,,,
"Jun 20, 2023 3:00 AM",1,1,0,1,1,0,0,0,0,0,0,0,,,,0,0,0,0,,,,0,0,0,0,0,1,0,,,,0,0,0,,,
"Jun 20, 2023 4:00 AM",3,2,1,2,0,2,4,3,1,3,2,1,,,,1,3,3,0,,,,4,0,1,1,0,1,0,,,,0,0,0,,,
"Jun 20, 2023 5:00 AM",11,8,3,5,1,4,8,3,5,8,3,5,,,,0,7,7,0,,,,5,4,3,1,2,6,0,,,,0,0,0,,,
"Jun 20, 2023 6:00 AM",55,33,22,29,11,18,38,16,22,33,19,14,,,,6,29,29,0,,,,29,17,12,5,7,38,0,,,,1,1,0,,,
"Jun 20, 2023 7:00 AM",162,123,39,74,24,50,90,23,67,60,15,45,,,,19,94,94,0,,,,89,42,45,14,31,151,0,,,,4,4,0,,,
"Jun 20, 2023 8:00 AM",283,223,60,130,24,106,180,54,126,136,45,91,,,,46,199,197,2,,,,195,59,82,20,62,251,7,,,,17,14,3,,,
"Jun 20, 2023 9:00 AM",109,88,21,89,30,59,115,52,63,73,46,27,,,,12,82,80,2,,,,70,31,56,16,40,94,6,,,,5,3,2,,,
"Jun 20, 2023 10:00 AM",42,29,13,57,24,33,53,28,25,44,28,16,,,,5,23,23,0,,,,29,18,17,8,9,26,4,,,,5,5,0,,,
"Jun 20, 2023 11:00 AM",32,22,10,51,20,31,25,9,16,25,6,19,,,,9,11,10,1,,,,11,13,15,10,5,20,4,,,,7,6,1,,,
"Jun 20, 2023 12:00 PM",43,22,21,39,20,19,42,21,21,31,13,18,,,,10,11,11,0,,,,10,8,9,4,5,23,1,,,,7,4,3,,,
"Jun 20, 2023 1:00 PM",52,17,35,17,13,4,24,13,11,22,16,6,,,,6,14,9,5,,,,7,17,8,7,1,10,2,,,,3,2,1,,,
"Jun 20, 2023 2:00 PM",50,23,27,22,17,5,27,21,6,18,14,4,,,,16,13,10,3,,,,10,24,31,22,9,21,3,,,,4,2,2,,,
"Jun 20, 2023 3:00 PM",62,22,40,27,14,13,55,30,25,28,19,9,,,,24,14,13,1,,,,13,18,30,18,12,24,3,,,,4,2,2,,,
"Jun 20, 2023 4:00 PM",116,29,87,28,20,8,64,34,30,49,28,21,,,,14,27,21,6,,,,22,65,31,25,6,35,6,,,,7,5,2,,,
"Jun 20, 2023 5:00 PM",197,47,150,79,51,28,117,75,42,84,56,28,,,,17,33,31,2,,,,32,131,80,60,20,59,8,,,,8,3,5,,,
"Jun 20, 2023 6:00 PM",174,41,133,74,66,8,108,80,28,85,59,26,,,,22,26,23,3,,,,21,115,65,59,6,34,8,,,,9,8,1,,,
"Jun 20, 2023 7:00 PM",115,30,85,70,49,21,88,67,21,69,50,19,,,,14,20,18,2,,,,18,59,48,40,8,26,3,,,,9,5,4,,,
"Jun 20, 2023 8:00 PM",82,25,57,69,43,26,75,42,33,49,26,23,,,,17,11,11,0,,,,11,37,33,21,12,18,5,,,,2,1,1,,,
"Jun 20, 2023 9:00 PM",57,12,45,55,24,31,56,20,36,45,20,25,,,,10,11,11,0,,,,6,18,25,12,13,21,6,,,,6,6,0,,,
"Jun 20, 2023 10:00 PM",42,12,30,19,8,11,20,6,14,11,4,7,,,,7,8,6,2,,,,5,14,8,2,6,11,3,,,,3,0,3,,,
"Jun 20, 2023 11:00 PM",14,5,9,4,2,2,15,5,10,9,3,6,,,,2,0,0,0,,,,0,6,4,1,3,2,0,,,,0,0,0,,,
"Jun 21, 2023 12:00 AM",9,3,6,1,1,0,5,3,2,2,2,0,,,,2,2,2,0,,,,3,3,1,1,0,4,2,,,,1,1,0,,,
"Jun 21, 2023 1:00 AM",3,1,2,0,0,0,1,1,0,2,2,0,,,,0,0,0,0,,,,1,1,2,2,0,1,0,,,,1,1,0,,,
"Jun 21, 2023 2:00 AM",3,3,0,0,0,0,0,0,0,0,0,0,,,,0,0,0,0,,,,0,0,0,0,0,2,0,,,,0,0,0,,,
"Jun 21, 2023 3:00 AM",2,1,1,0,0,0,0,0,0,0,0,0,,,,1,1,1,0,,,,1,0,0,0,0,0,0,,,,0,0,0,,,
"Jun 21, 2023 4:00 AM",2,1,1,4,3,1,4,4,0,4,4,0,,,,0,4,4,0,,,,4,2,0,0,0,1,0,,,,0,0,0,,,
"Jun 21, 2023 5:00 AM",10,8,2,9,5,4,11,7,4,8,4,4,,,,0,6,6,0,,,,6,4,3,2,1,9,0,,,,0,0,0,,,
"Jun 21, 2023 6:00 AM",63,36,27,26,12,14,33,11,22,22,12,10,,,,8,24,24,0,,,,22,18,7,3,4,43,0,,,,1,1,0,,,
"Jun 21, 2023 7:00 AM",146,108,38,66,21,45,93,29,64,75,22,53,,,,16,92,92,0,,,,85,39,48,22,26,129,7,,,,6,4,2,,,
"Jun 21, 2023 8:00 AM",291,227,64,119,34,85,171,55,116,125,55,70,,,,39,183,182,1,,,,179,58,90,23,67,228,5,,,,8,4,4,,,
"Jun 21, 2023 9:00 AM",122,97,25,76,29,47,98,45,53,88,52,36,,,,11,78,78,0,,,,69,26,63,23,40,91,2,,,,8,3,5,,,
"Jun 21, 2023 10:00 AM",57,36,21,80,37,43,76,40,36,66,34,32,,,,9,30,29,1,,,,29,16,53,22,31,43,1,,,,7,4,3,,,
"Jun 21, 2023 11:00 AM",74,45,29,65,30,35,71,30,41,56,30,26,,,,8,22,22,0,,,,19,19,37,20,17,36,5,,,,8,6,2,,,
"Jun 21, 2023 12:00 PM",63,45,18,55,24,31,78,48,30,46,27,19,,,,14,18,16,2,,,,13,29,29,18,11,23,4,,,,7,5,2,,,
"Jun 21, 2023 1:00 PM",81,30,51,67,38,29,99,47,52,52,27,25,,,,23,25,23,2,,,,22,31,52,28,24,24,3,,,,11,7,4,,,
"Jun 21, 2023 2:00 PM",62,29,33,59,35,24,71,46,25,53,31,22,,,,23,16,13,3,,,,16,27,46,30,16,21,3,,,,7,5,2,,,
"Jun 21, 2023 3:00 PM",85,41,44,62,28,34,108,55,53,67,42,25,,,,21,26,24,2,,,,17,42,44,23,21,30,4,,,,16,7,9,,,
"Jun 21, 2023 4:00 PM",146,39,107,89,60,29,129,78,51,99,58,41,,,,32,34,28,6,,,,28,66,67,40,27,47,5,,,,10,3,7,,,
"Jun 21, 2023 5:00 PM",257,61,196,126,81,45,219,130,89,131,83,48,,,,40,54,51,3,,,,48,147,102,73,29,61,8,,,,13,9,4,,,
"Jun 21, 2023 6:00 PM",220,53,167,150,103,47,227,139,88,171,107,64,,,,44,40,32,8,,,,35,128,97,79,18,52,9,,,,20,14,6,,,
"Jun 21, 2023 7:00 PM",123,38,85,171,105,66,185,125,60,162,112,50,,,,48,27,24,3,,,,23,97,93,56,37,38,2,,,,11,6,5,,,
"Jun 21, 2023 8:00 PM",87,23,64,131,75,56,153,72,81,129,60,69,,,,19,19,16,3,,,,15,47,65,39,26,42,8,,,,6,2,4,,,
"Jun 21, 2023 9:00 PM",69,24,45,87,44,43,122,54,68,81,34,47,,,,28,14,14,0,,,,15,19,42,18,24,38,7,,,,10,6,4,,,
"Jun 21, 2023 10:00 PM",46,8,38,46,13,33,47,8,39,38,8,30,,,,8,11,11,0,,,,9,16,25,9,16,31,1,,,,3,2,1,,,
"Jun 21, 2023 11:00 PM",27,6,21,14,8,6,26,6,20,22,5,17,,,,4,4,3,1,,,,2,9,13,2,11,10,2,,,,7,2,5,,,
"Jun 22, 2023 12:00 AM",12,6,6,0,0,0,7,3,4,6,5,1,,,,2,4,4,0,,,,5,6,4,4,0,6,1,,,,2,2,0,,,
"Jun 22, 2023 1:00 AM",3,2,1,2,2,0,4,2,2,1,1,0,,,,1,2,2,0,,,,2,2,2,1,1,4,0,,,,0,0,0,,,
"Jun 22, 2023 2:00 AM",5,4,1,0,0,0,0,0,0,0,0,0,,,,0,0,0,0,,,,0,4,0,0,0,0,0,,,,0,0,0,,,
"Jun 22, 2023 3:00 AM",4,1,3,0,0,0,0,0,0,0,0,0,,,,1,0,0,0,,,,0,0,0,0,0,0,0,,,,0,0,0,,,
"Jun 22, 2023 4:00 AM",4,1,3,0,0,0,0,0,0,1,1,0,,,,0,3,3,0,,,,3,1,0,0,0,1,0,,,,0,0,0,,,
"Jun 22, 2023 5:00 AM",12,8,4,4,0,4,5,4,1,3,3,0,,,,1,8,8,0,,,,7,3,2,1,1,3,1,,,,0,0,0,,,
"Jun 22, 2023 6:00 AM",57,37,20,32,14,18,32,10,22,27,12,15,,,,10,25,25,0,,,,23,13,11,2,9,32,0,,,,0,0,0,,,
"Jun 22, 2023 7:00 AM",144,99,45,60,17,43,89,25,64,59,18,41,,,,17,94,94,0,,,,92,36,39,19,20,128,7,,,,10,8,2,,,
"Jun 22, 2023 8:00 AM",245,177,68,122,31,91,159,59,100,115,48,67,,,,26,150,149,1,,,,148,54,73,21,52,231,5,,,,10,7,3,,,
"Jun 22, 2023 9:00 AM",131,109,22,82,26,56,111,48,63,99,54,45,,,,18,84,83,1,,,,78,30,73,21,52,99,4,,,,2,2,0,,,
"Jun 22, 2023 10:00 AM",62,48,14,80,29,51,73,44,29,74,41,33,,,,16,34,33,1,,,,29,26,33,18,15,33,3,,,,2,1,1,,,
"Jun 22, 2023 11:00 AM",57,38,19,83,42,41,80,39,41,63,30,33,,,,6,36,34,2,,,,32,17,45,22,23,38,6,,,,9,8,1,,,
"Jun 22, 2023 12:00 PM",52,26,26,85,47,38,118,60,58,79,46,33,,,,17,28,27,1,,,,22,25,44,18,26,30,2,,,,8,6,2,,,
"Jun 22, 2023 1:00 PM",83,49,34,82,40,42,120,59,61,69,43,26,,,,17,25,21,4,,,,16,33,56,34,22,35,4,,,,8,5,3,,,
"Jun 22, 2023 2:00 PM",63,27,36,105,51,54,121,65,56,94,50,44,,,,15,21,20,1,,,,21,37,73,40,33,28,1,,,,10,4,6,,,
"Jun 22, 2023 3:00 PM",89,36,53,60,42,18,111,70,41,65,41,24,,,,24,16,16,0,,,,16,44,52,31,21,29,6,,,,12,9,3,,,
"Jun 22, 2023 4:00 PM",131,39,92,86,43,43,151,83,68,89,53,36,,,,20,36,30,6,,,,28,66,65,39,26,45,6,,,,8,4,4,,,
"Jun 22, 2023 5:00 PM",244,70,174,151,64,87,202,115,87,146,91,55,,,,29,49,41,8,,,,42,137,109,76,33,87,7,,,,5,3,2,,,
"Jun 22, 2023 6:00 PM",200,60,140,117,84,33,211,127,84,132,95,37,,,,30,50,44,6,,,,39,128,97,69,28,69,2,,,,11,8,3,,,
"Jun 22, 2023 7:00 PM",119,50,69,125,87,38,157,86,71,117,70,47,,,,30,21,19,2,,,,18,66,55,36,19,27,4,,,,10,5,5,,,
"Jun 22, 2023 8:00 PM",99,35,64,93,57,36,92,45,47,66,33,33,,,,16,22,19,3,,,,15,34,36,22,14,36,6,,,,8,5,3,,,
"Jun 22, 2023 9:00 PM",57,16,41,55,30,25,66,24,42,59,21,38,,,,11,11,10,1,,,,11,24,21,13,8,21,7,,,,4,2,2,,,
"Jun 22, 2023 10:00 PM",44,10,34,33,24,9,25,10,15,19,9,10,,,,7,5,5,0,,,,7,16,9,5,4,25,2,,,,3,2,1,,,
"Jun 22, 2023 11:00 PM",21,3,18,15,9,6,19,10,9,5,1,4,,,,8,9,9,0,,,,8,4,1,1,0,10,0,,,,3,2,1,,,
"Jun 23, 2023 12:00 AM",15,5,10,0,0,0,1,1,0,4,1,3,,,,0,8,6,2,,,,5,9,2,2,0,6,1,,,,1,1,0,,,
"Jun 23, 2023 1:00 AM",7,1,6,2,2,0,3,1,2,3,2,1,,,,1,2,2,0,,,,1,1,0,0,0,5,1,,,,1,1,0,,,
"Jun 23, 2023 2:00 AM",5,4,1,0,0,0,0,0,0,0,0,0,,,,0,0,0,0,,,,0,2,1,1,0,2,0,,,,0,0,0,,,
"Jun 23, 2023 3:00 AM",3,1,2,0,0,0,0,0,0,1,1,0,,,,0,0,0,0,,,,1,1,0,0,0,1,0,,,,0,0,0,,,
"Jun 23, 2023 4:00 AM",3,2,1,0,0,0,0,0,0,0,0,0,,,,1,2,2,0,,,,3,1,0,0,0,2,0,,,,0,0,0,,,
"Jun 23, 2023 5:00 AM",12,10,2,5,3,2,4,4,0,4,4,0,,,,1,6,6,0,,,,6,4,0,0,0,5,0,,,,0,0,0,,,
"Jun 23, 2023 6:00 AM",37,21,16,15,6,9,19,5,14,19,7,12,,,,7,15,15,0,,,,13,11,5,2,3,26,0,,,,0,0,0,,,
"Jun 23, 2023 7:00 AM",77,50,27,14,3,11,29,6,23,15,5,10,,,,12,43,43,0,,,,43,21,13,8,5,54,1,,,,3,3,0,,,
"Jun 23, 2023 8:00 AM",132,100,32,44,9,35,75,34,41,53,28,25,,,,25,64,63,1,,,,73,41,40,9,31,78,8,,,,10,7,3,,,
"Jun 23, 2023 9:00 AM",88,60,28,33,10,23,44,23,21,50,29,21,,,,13,43,43,0,,,,37,9,17,5,12,50,0,,,,1,0,1,,,
"Jun 23, 2023 10:00 AM",34,28,6,22,12,10,39,20,19,30,20,10,,,,13,19,19,0,,,,18,15,13,7,6,19,1,,,,5,5,0,,,
"Jun 23, 2023 11:00 AM",40,20,20,43,20,23,41,26,15,37,23,14,,,,14,21,21,0,,,,19,16,11,10,1,16,2,,,,7,3,4,,,
"Jun 23, 2023 12:00 PM",53,27,26,36,18,18,54,31,23,37,20,17,,,,9,9,9,0,,,,9,19,19,14,5,19,2,,,,5,3,2,,,
"Jun 23, 2023 1:00 PM",76,28,48,45,25,20,47,26,21,49,27,22,,,,12,13,10,3,,,,8,23,24,15,9,31,4,,,,4,3,1,,,
"Jun 23, 2023 2:00 PM",81,39,42,42,24,18,64,42,22,53,29,24,,,,35,10,10,0,,,,9,19,19,11,8,20,4,,,,6,3,3,,,
"Jun 23, 2023 3:00 PM",73,33,40,42,22,20,70,40,30,52,29,23,,,,22,14,13,1,,,,16,46,29,14,15,12,6,,,,4,4,0,,,
"Jun 23, 2023 4:00 PM",96,32,64,71,47,24,94,52,42,74,47,27,,,,13,27,24,3,,,,24,31,50,34,16,38,5,,,,6,5,1,,,
"Jun 23, 2023 5:00 PM",150,48,102,72,39,33,94,46,48,67,36,31,,,,28,25,21,4,,,,24,64,40,27,13,44,3,,,,5,3,2,,,
"Jun 23, 2023 6:00 PM",122,44,78,66,44,22,91,50,41,68,38,30,,,,37,23,20,3,,,,18,37,53,35,18,28,4,,,,5,3,2,,,
"Jun 23, 2023 7:00 PM",84,36,48,43,28,15,60,35,25,43,24,19,,,,27,14,12,2,,,,9,20,34,19,15,18,10,,,,17,15,2,,,
"Jun 23, 2023 8:00 PM",61,24,37,49,18,31,66,28,38,54,24,30,,,,9,11,10,1,,,,14,16,34,20,14,29,2,,,,2,1,1,,,
"Jun 23, 2023 9:00 PM",54,16,38,25,16,9,36,20,16,30,15,15,,,,9,10,10,0,,,,11,15,17,11,6,17,1,,,,1,1,0,,,
"Jun 23, 2023 10:00 PM",33,14,19,17,8,9,21,7,14,20,5,15,,,,9,4,4,0,,,,4,10,8,5,3,10,1,,,,2,1,1,,,
"Jun 23, 2023 11:00 PM",22,9,13,9,7,2,12,5,7,8,4,4,,,,10,7,7,0,,,,6,7,4,2,2,5,0,,,,0,0,0,,,
"Jun 24, 2023 12:00 AM",18,10,8,0,0,0,4,2,2,10,3,7,,,,5,2,2,0,,,,2,8,5,3,2,9,2,,,,2,2,0,,,
"Jun 24, 2023 1:00 AM",9,3,6,3,1,2,2,1,1,2,0,2,,,,3,4,4,0,,,,3,4,1,0,1,3,0,,,,0,0,0,,,
"Jun 24, 2023 2:00 AM",8,3,5,1,0,1,3,1,2,2,0,2,,,,2,0,0,0,,,,0,1,3,3,0,5,1,,,,0,0,0,,,
"Jun 24, 2023 3:00 AM",4,2,2,0,0,0,1,1,0,1,1,0,,,,1,1,1,0,,,,1,0,1,1,0,0,0,,,,0,0,0,,,
"Jun 24, 2023 4:00 AM",3,0,3,0,0,0,5,4,1,1,0,1,,,,0,6,5,1,,,,5,0,0,0,0,1,0,,,,0,0,0,,,
"Jun 24, 2023 5:00 AM",7,4,3,3,3,0,4,2,2,4,3,1,,,,1,2,2,0,,,,0,2,5,4,1,5,0,,,,0,0,0,,,
"Jun 24, 2023 6:00 AM",12,10,2,9,2,7,12,7,5,7,1,6,,,,3,6,6,0,,,,5,6,9,4,5,7,0,,,,1,1,0,,,
"Jun 24, 2023 7:00 AM",23,10,13,40,30,10,54,36,18,37,32,5,,,,9,9,9,0,,,,11,25,15,11,4,19,1,,,,0,0,0,,,
"Jun 24, 2023 8:00 AM",39,21,18,72,39,33,89,54,35,72,45,27,,,,12,12,11,1,,,,12,22,22,14,8,20,4,,,,3,3,0,,,
"Jun 24, 2023 9:00 AM",43,26,17,116,67,49,98,56,42,99,70,29,,,,11,22,20,2,,,,17,36,37,23,14,32,2,,,,5,3,2,,,
"Jun 24, 2023 10:00 AM",62,37,25,141,69,72,137,69,68,115,61,54,,,,20,21,19,2,,,,18,42,46,25,21,49,6,,,,7,4,3,,,
"Jun 24, 2023 11:00 AM",49,28,21,168,90,78,162,93,69,134,89,45,,,,18,23,22,1,,,,20,35,77,56,21,32,8,,,,17,13,4,,,
"Jun 24, 2023 12:00 PM",73,45,28,250,130,120,242,173,69,197,137,60,,,,24,23,20,3,,,,15,61,100,76,24,50,7,,,,13,9,4,,,
"Jun 24, 2023 1:00 PM",83,40,43,189,101,88,202,106,96,167,91,76,,,,28,27,26,1,,,,22,34,83,44,39,50,8,,,,13,6,7,,,
"Jun 24, 2023 2:00 PM",56,24,32,222,126,96,228,133,95,148,82,66,,,,18,21,21,0,,,,19,42,121,82,39,40,5,,,,6,5,1,,,
"Jun 24, 2023 3:00 PM",63,30,33,208,109,99,290,166,124,167,90,77,,,,17,20,18,2,,,,19,44,142,86,56,54,4,,,,10,3,7,,,
"Jun 24, 2023 4:00 PM",58,34,24,237,114,123,347,173,174,220,122,98,,,,17,18,18,0,,,,15,56,139,75,64,58,2,,,,11,9,2,,,
"Jun 24, 2023 5:00 PM",52,21,31,168,83,85,298,103,195,151,50,101,,,,22,30,28,2,,,,24,23,124,42,82,81,1,,,,2,1,1,,,
"Jun 24, 2023 6:00 PM",55,23,32,118,45,73,170,52,118,120,38,82,,,,26,25,23,2,,,,19,20,85,26,59,72,3,,,,6,2,4,,,
"Jun 24, 2023 7:00 PM",40,20,20,67,32,35,111,34,77,79,30,49,,,,7,11,11,0,,,,11,17,61,19,42,50,2,,,,8,5,3,,,
"Jun 24, 2023 8:00 PM",39,16,23,44,20,24,48,16,32,40,13,27,,,,11,21,17,4,,,,17,14,35,14,21,21,5,,,,1,0,1,,,
"Jun 24, 2023 9:00 PM",28,15,13,25,15,10,39,14,25,23,10,13,,,,9,12,10,2,,,,10,5,15,6,9,16,0,,,,0,0,0,,,
"Jun 24, 2023 10:00 PM",32,13,19,12,6,6,16,6,10,15,6,9,,,,4,7,5,2,,,,5,4,13,1,12,9,1,,,,6,3,3,,,
"Jun 24, 2023 11:00 PM",26,11,15,7,3,4,7,4,3,7,1,6,,,,10,9,8,1,,,,5,5,6,4,2,9,0,,,,0,0,0,,,
"Jun 25, 2023 12:00 AM",14,5,9,1,0,1,4,2,2,11,6,5,,,,0,4,3,1,,,,1,8,5,2,3,9,1,,,,1,1,0,,,
"Jun 25, 2023 1:00 AM",8,4,4,2,1,1,11,1,10,3,0,3,,,,0,2,2,0,,,,1,2,2,1,1,9,1,,,,1,1,0,,,
"Jun 25, 2023 2:00 AM",7,1,6,0,0,0,4,3,1,2,1,1,,,,0,1,0,1,,,,0,6,1,1,0,3,0,,,,0,0,0,,,
"Jun 25, 2023 3:00 AM",6,2,4,1,1,0,2,0,2,2,1,1,,,,0,0,0,0,,,,0,1,1,0,1,1,0,,,,0,0,0,,,
"Jun 25, 2023 4:00 AM",2,0,2,1,0,1,3,2,1,2,1,1,,,,0,1,1,0,,,,1,1,2,2,0,0,1,,,,0,0,0,,,
"Jun 25, 2023 5:00 AM",8,3,5,3,1,2,4,4,0,3,2,1,,,,1,0,0,0,,,,0,1,1,1,0,1,0,,,,0,0,0,,,
"Jun 25, 2023 6:00 AM",8,6,2,3,2,1,6,3,3,3,2,1,,,,2,4,4,0,,,,4,3,1,1,0,4,1,,,,1,1,0,,,
"Jun 25, 2023 7:00 AM",10,6,4,16,8,8,25,13,12,15,8,7,,,,2,6,6,0,,,,6,5,4,1,3,13,0,,,,0,0,0,,,
"Jun 25, 2023 8:00 AM",22,12,10,18,9,9,20,13,7,20,14,6,,,,3,4,4,0,,,,4,10,5,3,2,6,1,,,,2,1,1,,,
"Jun 25, 2023 9:00 AM",9,2,7,23,12,11,21,18,3,21,16,5,,,,1,3,3,0,,,,3,3,2,2,0,13,2,,,,2,1,1,,,
"Jun 25, 2023 10:00 AM",26,13,13,25,11,14,25,13,12,19,10,9,,,,7,13,12,1,,,,11,8,6,3,3,11,4,,,,3,2,1,,,
"Jun 25, 2023 11:00 AM",37,26,11,61,30,31,48,29,19,52,35,17,,,,4,6,6,0,,,,5,16,15,12,3,21,1,,,,8,6,2,,,
"Jun 25, 2023 12:00 PM",48,20,28,78,27,51,68,31,37,72,33,39,,,,4,10,10,0,,,,8,19,21,14,7,28,1,,,,7,5,2,,,
"Jun 25, 2023 1:00 PM",57,23,34,98,46,52,87,44,43,61,35,26,,,,14,12,12,0,,,,10,35,24,16,8,28,5,,,,1,1,0,,,
"Jun 25, 2023 2:00 PM",50,31,19,130,75,55,103,63,40,105,66,39,,,,9,16,15,1,,,,15,22,47,27,20,22,4,,,,9,7,2,,,
"Jun 25, 2023 3:00 PM",43,20,23,106,57,49,103,63,40,82,53,29,,,,19,19,18,1,,,,16,22,46,28,18,28,2,,,,8,1,7,,,
"Jun 25, 2023 4:00 PM",29,16,13,73,41,32,99,40,59,69,34,35,,,,9,10,9,1,,,,7,17,18,13,5,18,8,,,,6,2,4,,,
"Jun 25, 2023 5:00 PM",36,12,24,51,34,17,66,38,28,50,28,22,,,,7,21,21,0,,,,23,19,48,21,27,22,2,,,,5,4,1,,,
"Jun 25, 2023 6:00 PM",44,20,24,45,22,23,64,24,40,33,14,19,,,,26,6,6,0,,,,8,12,23,5,18,22,4,,,,9,7,2,,,
"Jun 25, 2023 7:00 PM",38,19,19,38,18,20,47,26,21,28,16,12,,,,9,12,12,0,,,,14,4,19,14,5,19,4,,,,6,4,2,,,
"Jun 25, 2023 8:00 PM",38,18,20,28,16,12,24,8,16,25,11,14,,,,3,5,5,0,,,,5,6,11,6,5,19,1,,,,4,1,3,,,
"Jun 25, 2023 9:00 PM",38,10,28,25,10,15,21,8,13,13,7,6,,,,6,8,8,0,,,,7,6,14,5,9,10,0,,,,0,0,0,,,
"Jun 25, 2023 10:00 PM",22,10,12,9,4,5,11,3,8,10,3,7,,,,2,8,8,0,,,,7,3,3,2,1,11,1,,,,2,0,2,,,
"Jun 25, 2023 11:00 PM",10,3,7,7,5,2,13,4,9,9,3,6,,,,3,4,4,0,,,,4,3,2,1,1,7,0,,,,0,0,0,,,
"Jun 26, 2023 12:00 AM",8,3,5,0,0,0,2,1,1,2,1,1,,,,4,3,3,0,,,,3,5,2,1,1,3,1,,,,3,2,1,,,
"Jun 26, 2023 1:00 AM",2,0,2,0,0,0,0,0,0,0,0,0,,,,1,2,1,1,,,,1,2,6,0,6,0,0,,,,2,1,1,,,
"Jun 26, 2023 2:00 AM",3,2,1,0,0,0,0,0,0,0,0,0,,,,1,0,0,0,,,,0,0,0,0,0,0,0,,,,0,0,0,,,
"Jun 26, 2023 3:00 AM",2,0,2,1,0,1,2,1,1,1,0,1,,,,0,0,0,0,,,,0,1,1,1,0,0,0,,,,0,0,0,,,
"Jun 26, 2023 4:00 AM",2,0,2,1,1,0,1,1,0,3,2,1,,,,0,5,5,0,,,,4,0,5,4,1,3,0,,,,0,0,0,,,
"Jun 26, 2023 5:00 AM",6,5,1,3,1,2,5,1,4,4,1,3,,,,4,5,5,0,,,,6,1,2,2,0,9,0,,,,0,0,0,,,
"Jun 26, 2023 6:00 AM",48,32,16,27,14,13,25,12,13,18,12,6,,,,6,25,25,0,,,,24,11,13,8,5,34,2,,,,4,3,1,,,
"Jun 26, 2023 7:00 AM",118,82,36,60,23,37,84,30,54,62,24,38,,,,12,87,87,0,,,,84,34,40,15,25,87,4,,,,5,5,0,,,
"Jun 26, 2023 8:00 AM",226,174,52,91,29,62,130,53,77,81,43,38,,,,21,128,127,1,,,,130,53,65,15,50,188,6,,,,16,10,6,,,
"Jun 26, 2023 9:00 AM",126,103,23,51,22,29,100,48,52,82,46,36,,,,8,87,84,3,,,,78,17,47,21,26,86,2,,,,3,3,0,,,
"Jun 26, 2023 10:00 AM",51,35,16,47,27,20,52,22,30,42,21,21,,,,12,23,21,2,,,,19,15,24,10,14,31,2,,,,7,2,5,,,
"Jun 26, 2023 11:00 AM",41,31,10,65,29,36,54,33,21,47,26,21,,,,5,18,17,1,,,,19,21,22,12,10,19,4,,,,2,2,0,,,
"Jun 26, 2023 12:00 PM",52,26,26,48,20,28,49,20,29,45,23,22,,,,9,15,14,1,,,,10,13,32,15,17,26,1,,,,3,1,2,,,
"Jun 26, 2023 1:00 PM",69,32,37,40,21,19,52,23,29,47,25,22,,,,13,14,12,2,,,,12,18,17,13,4,24,0,,,,7,3,4,,,
"Jun 26, 2023 2:00 PM",65,30,35,41,24,17,51,32,19,35,22,13,,,,13,15,14,1,,,,14,17,26,12,14,30,4,,,,6,2,4,,,
"Jun 26, 2023 3:00 PM",68,33,35,60,34,26,82,49,33,61,38,23,,,,19,19,16,3,,,,17,33,47,30,17,27,4,,,,7,4,3,,,
"Jun 26, 2023 4:00 PM",129,31,98,86,42,44,107,59,48,91,44,47,,,,11,29,26,3,,,,24,56,53,37,16,40,2,,,,3,1,2,,,
"Jun 26, 2023 5:00 PM",224,57,167,94,60,34,135,80,55,109,69,40,,,,32,41,37,4,,,,38,125,63,39,24,69,9,,,,11,7,4,,,
"Jun 26, 2023 6:00 PM",169,49,120,113,73,40,182,132,50,122,76,46,,,,27,36,28,8,,,,30,131,108,79,29,49,4,,,,16,9,7,,,
"Jun 26, 2023 7:00 PM",118,36,82,87,47,40,175,97,78,88,51,37,,,,16,38,31,7,,,,29,57,66,46,20,39,4,,,,9,7,2,,,
"Jun 26, 2023 8:00 PM",80,22,58,61,41,20,101,45,56,53,27,26,,,,20,16,12,4,,,,13,26,38,22,16,31,8,,,,7,4,3,,,
"Jun 26, 2023 9:00 PM",45,13,32,39,16,23,39,9,30,30,12,18,,,,10,16,13,3,,,,14,16,17,6,11,32,5,,,,9,5,4,,,
"Jun 26, 2023 10:00 PM",28,8,20,22,15,7,21,13,8,19,15,4,,,,3,7,5,2,,,,6,12,10,6,4,16,1,,,,3,3,0,,,
"Jun 26, 2023 11:00 PM",13,2,11,4,2,2,14,9,5,3,1,2,,,,1,4,4,0,,,,5,5,8,6,2,1,1,,,,0,0,0,,,
"Jun 27, 2023 12:00 AM",5,3,2,1,1,0,0,0,0,3,1,2,,,,1,3,3,0,,,,0,5,2,1,1,2,1,,,,1,0,1,,,
"Jun 27, 2023 1:00 AM",3,1,2,0,0,0,0,0,0,1,1,0,,,,0,0,0,0,,,,1,2,0,0,0,1,1,,,,0,0,0,,,
"Jun 27, 2023 2:00 AM",4,4,0,0,0,0,0,0,0,0,0,0,,,,0,0,0,0,,,,0,1,0,0,0,1,0,,,,0,0,0,,,
"Jun 27, 2023 3:00 AM",1,0,1,1,0,1,1,0,1,1,0,1,,,,1,0,0,0,,,,0,1,0,0,0,1,0,,,,0,0,0,,,
"Jun 27, 2023 4:00 AM",2,0,2,2,2,0,4,4,0,3,3,0,,,,0,3,3,0,,,,3,0,4,3,1,2,0,,,,0,0,0,,,
"Jun 27, 2023 5:00 AM",8,6,2,1,1,0,6,3,3,3,2,1,,,,0,5,5,0,,,,6,3,2,0,2,5,0,,,,0,0,0,,,
"Jun 27, 2023 6:00 AM",62,36,26,21,10,11,32,13,19,18,10,8,,,,12,27,27,0,,,,26,20,9,5,4,31,1,,,,5,3,2,,,
"Jun 27, 2023 7:00 AM",130,91,39,44,14,30,85,33,52,48,14,34,,,,14,80,80,0,,,,82,44,42,18,24,130,2,,,,7,6,1,,,
"Jun 27, 2023 8:00 AM",249,199,50,100,21,79,150,43,107,99,38,61,,,,36,176,175,1,,,,181,62,84,17,67,248,9,,,,9,8,1,,,
"Jun 27, 2023 9:00 AM",110,92,18,51,14,37,91,40,51,80,38,42,,,,14,72,69,3,,,,59,19,57,15,42,93,2,,,,6,3,3,,,
"Jun 27, 2023 10:00 AM",50,35,15,59,18,41,61,31,30,42,20,22,,,,11,35,34,1,,,,30,6,43,26,17,28,3,,,,7,4,3,,,
"Jun 27, 2023 11:00 AM",49,25,24,50,23,27,61,31,30,45,25,20,,,,5,13,13,0,,,,15,0,29,11,18,20,1,,,,2,1,1,,,
"Jun 27, 2023 12:00 PM",68,39,29,43,29,14,55,30,25,45,27,18,,,,13,18,17,1,,,,13,0,31,17,14,23,5,,,,4,3,1,,,
"Jun 27, 2023 1:00 PM",68,33,35,51,26,25,65,29,36,53,22,31,,,,13,26,25,1,,,,18,14,30,17,13,24,3,,,,9,4,5,,,
"Jun 27, 2023 2:00 PM",58,32,26,52,28,24,42,16,26,35,19,16,,,,23,14,14,0,,,,10,17,35,25,10,23,5,,,,15,8,7,,,
"Jun 27, 2023 3:00 PM",84,39,45,60,35,25,62,39,23,54,32,22,,,,15,18,16,2,,,,16,29,23,14,9,32,2,,,,10,4,6,,,
"Jun 27, 2023 4:00 PM",136,45,91,73,45,28,100,65,35,84,49,35,,,,24,35,24,11,,,,24,64,48,33,15,38,10,,,,9,8,1,,,
"Jun 27, 2023 5:00 PM",253,64,189,113,67,46,191,120,71,140,92,48,,,,29,25,19,6,,,,23,132,79,63,16,87,8,,,,8,4,4,,,
"Jun 27, 2023 6:00 PM",213,52,161,119,81,38,192,133,59,124,86,38,,,,26,42,38,4,,,,38,128,108,82,26,51,9,,,,20,14,6,,,
"Jun 27, 2023 7:00 PM",111,30,81,87,56,31,156,104,52,99,69,30,,,,19,34,29,5,,,,27,65,91,57,34,38,2,,,,10,6,4,,,
"Jun 27, 2023 8:00 PM",79,24,55,80,41,39,122,41,81,72,32,40,,,,12,11,9,2,,,,15,27,50,14,36,31,3,,,,14,9,5,,,
"Jun 27, 2023 9:00 PM",64,10,54,43,24,19,59,21,38,37,12,25,,,,6,13,12,1,,,,11,19,33,18,15,28,2,,,,6,1,5,,,
"Jun 27, 2023 10:00 PM",40,12,28,29,21,8,40,18,22,25,12,13,,,,4,4,3,1,,,,5,10,12,7,5,10,3,,,,0,0,0,,,
"Jun 27, 2023 11:00 PM",17,4,13,12,11,1,10,3,7,14,7,7,,,,1,2,2,0,,,,1,5,6,4,2,4,1,,,,2,2,0,,,
"Jun 28, 2023 12:00 AM",8,1,7,0,0,0,2,2,0,3,0,3,,,,0,1,1,0,,,,1,6,3,2,1,3,0,,,,2,1,1,,,
"Jun 28, 2023 1:00 AM",4,0,4,1,1,0,4,4,0,0,0,0,,,,0,0,0,0,,,,0,2,1,1,0,0,1,,,,0,0,0,,,
"Jun 28, 2023 2:00 AM",6,6,0,0,0,0,2,1,1,0,0,0,,,,0,0,0,0,,,,1,0,1,0,1,2,0,,,,0,0,0,,,
"Jun 28, 2023 3:00 AM",3,1,2,1,0,1,2,1,1,2,1,1,,,,0,0,0,0,,,,0,1,7,7,0,1,0,,,,0,0,0,,,
"Jun 28, 2023 4:00 AM",4,1,3,2,2,0,6,6,0,2,2,0,,,,0,4,4,0,,,,4,3,1,0,1,1,0,,,,0,0,0,,,
"Jun 28, 2023 5:00 AM",13,9,4,5,2,3,4,3,1,4,3,1,,,,2,6,6,0,,,,6,3,3,1,2,11,0,,,,0,0,0,,,
"Jun 28, 2023 6:00 AM",58,32,26,20,8,12,28,9,19,19,10,9,,,,9,20,20,0,,,,24,22,9,6,3,33,1,,,,0,0,0,,,
"Jun 28, 2023 7:00 AM",111,69,42,63,23,40,97,30,67,71,28,43,,,,12,101,101,0,,,,100,29,39,12,27,129,4,,,,12,10,2,,,
"Jun 28, 2023 8:00 AM",236,180,56,88,14,74,141,47,94,91,35,56,,,,26,165,164,1,,,,166,69,74,21,53,208,2,,,,10,7,3,,,
"Jun 28, 2023 9:00 AM",103,78,25,51,23,28,73,31,42,51,27,24,,,,5,52,50,2,,,,45,17,38,8,30,74,1,,,,6,4,2,,,
"Jun 28, 2023 10:00 AM",36,24,12,20,7,13,27,9,18,23,10,13,,,,5,19,19,0,,,,22,11,20,8,12,22,1,,,,1,0,1,,,
"Jun 28, 2023 11:00 AM",36,17,19,16,10,6,17,9,8,13,12,1,,,,2,18,18,0,,,,13,10,12,7,5,15,5,,,,2,2,0,,,
"Jun 28, 2023 12:00 PM",51,22,29,17,7,10,27,16,11,19,11,8,,,,5,8,8,0,,,,10,11,7,6,1,19,2,,,,2,0,2,,,
"Jun 28, 2023 1:00 PM",55,28,27,28,17,11,25,12,13,24,17,7,,,,6,18,17,1,,,,14,16,18,13,5,13,1,,,,2,1,1,,,
"Jun 28, 2023 2:00 PM",71,34,37,35,14,21,37,22,15,30,17,13,,,,12,12,11,1,,,,7,24,36,22,14,17,4,,,,5,4,1,,,
"Jun 28, 2023 3:00 PM",77,33,44,40,20,20,51,29,22,36,28,8,,,,18,22,19,3,,,,22,18,29,22,7,25,4,,,,8,4,4,,,
"Jun 28, 2023 4:00 PM",110,29,81,68,35,33,96,50,46,84,43,41,,,,29,29,26,3,,,,27,48,48,41,7,45,3,,,,8,3,5,,,
"Jun 28, 2023 5:00 PM",227,59,168,104,68,36,174,110,64,124,73,51,,,,46,40,37,3,,,,40,111,93,57,36,66,6,,,,12,7,5,,,
"Jun 28, 2023 6:00 PM",184,44,140,88,56,32,175,125,50,114,71,43,,,,29,34,33,1,,,,38,137,92,68,24,43,8,,,,11,7,4,,,
"Jun 28, 2023 7:00 PM",93,24,69,55,33,22,112,64,48,56,34,22,,,,14,23,21,2,,,,18,54,43,26,17,26,2,,,,13,8,5,,,
"Jun 28, 2023 8:00 PM",75,28,47,53,26,27,108,56,52,49,22,27,,,,15,14,13,1,,,,11,26,36,23,13,27,9,,,,9,6,3,,,
"Jun 28, 2023 9:00 PM",53,17,36,29,17,12,81,29,52,38,15,23,,,,7,8,7,1,,,,8,25,34,12,22,23,3,,,,10,5,5,,,
"Jun 28, 2023 10:00 PM",28,8,20,16,14,2,22,10,12,16,7,9,,,,9,6,6,0,,,,7,16,8,5,3,10,1,,,,2,2,0,,,
"Jun 28, 2023 11:00 PM",22,3,19,9,8,1,12,5,7,10,4,6,,,,7,3,2,1,,,,3,10,7,5,2,9,1,,,,1,1,0,,,
"Jun 29, 2023 12:00 AM",14,7,7,0,0,0,1,0,1,5,3,2,,,,2,6,6,0,,,,4,4,7,5,2,5,1,,,,1,1,0,,,
"Jun 29, 2023 1:00 AM",8,2,6,4,4,0,4,2,2,2,2,0,,,,0,1,1,0,,,,2,2,1,0,1,2,0,,,,2,1,1,,,
"Jun 29, 2023 2:00 AM",5,5,0,1,1,0,2,1,1,2,1,1,,,,0,1,1,0,,,,1,1,1,1,0,2,0,,,,0,0,0,,,
"Jun 29, 2023 3:00 AM",2,1,1,1,0,1,1,0,1,1,0,1,,,,0,0,0,0,,,,0,1,0,0,0,1,0,,,,0,0,0,,,
"Jun 29, 2023 4:00 AM",1,0,1,7,7,0,5,4,1,10,9,1,,,,0,4,4,0,,,,4,0,11,10,1,2,0,,,,0,0,0,,,
"Jun 29, 2023 5:00 AM",11,9,2,2,1,1,8,6,2,5,3,2,,,,1,10,10,0,,,,9,5,5,3,2,7,1,,,,0,0,0,,,
"Jun 29, 2023 6:00 AM",37,24,13,30,16,14,38,21,17,23,11,12,,,,8,27,27,0,,,,29,21,9,6,3,37,0,,,,2,1,1,,,
"Jun 29, 2023 7:00 AM",128,89,39,60,18,42,110,34,76,56,17,39,,,,14,80,80,0,,,,73,41,64,28,36,130,6,,,,6,5,1,,,
"Jun 29, 2023 8:00 AM",272,213,59,104,26,78,166,61,105,102,43,59,,,,26,163,161,2,,,,162,69,85,19,66,213,3,,,,6,5,1,,,
"Jun 29, 2023 9:00 AM",122,99,23,85,33,52,119,55,64,76,39,37,,,,17,60,57,3,,,,50,26,68,26,42,89,3,,,,3,3,0,,,
"Jun 29, 2023 10:00 AM",56,42,14,57,22,35,92,52,40,48,27,21,,,,4,35,32,3,,,,26,25,47,29,18,56,8,,,,8,6,2,,,
"Jun 29, 2023 11:00 AM",33,19,14,84,29,55,104,40,64,74,31,43,,,,13,23,22,1,,,,18,13,43,22,21,30,4,,,,4,3,1,,,
"Jun 29, 2023 12:00 PM",64,31,33,70,31,39,62,20,42,47,24,23,,,,10,26,26,0,,,,25,17,35,14,21,29,3,,,,3,2,1,,,
"Jun 29, 2023 1:00 PM",80,31,49,45,21,24,60,27,33,55,25,30,,,,8,23,22,1,,,,24,36,41,18,23,27,4,,,,8,3,5,,,
"Jun 29, 2023 2:00 PM",56,24,32,63,31,32,61,40,21,43,24,19,,,,19,12,11,1,,,,12,28,34,20,14,23,4,,,,4,1,3,,,
"Jun 29, 2023 3:00 PM",83,41,42,48,31,17,62,37,25,59,41,18,,,,30,15,15,0,,,,15,29,40,24,16,21,5,,,,10,8,2,,,
"Jun 29, 2023 4:00 PM",120,33,87,66,42,24,96,54,42,84,46,38,,,,11,29,26,3,,,,26,58,55,32,23,46,8,,,,7,2,5,,,
"Jun 29, 2023 5:00 PM",228,61,167,111,55,56,158,111,47,134,89,45,,,,20,37,30,7,,,,34,127,89,65,24,80,10,,,,9,4,5,,,
"Jun 29, 2023 6:00 PM",196,50,146,114,74,40,168,126,42,119,88,31,,,,25,22,21,1,,,,20,131,99,68,31,52,11,,,,12,8,4,,,
"Jun 29, 2023 7:00 PM",116,30,86,107,74,33,127,77,50,92,60,32,,,,22,24,22,2,,,,18,59,52,41,11,30,3,,,,18,8,10,,,
"Jun 29, 2023 8:00 PM",78,27,51,78,47,31,83,42,41,57,27,30,,,,21,14,12,2,,,,14,37,45,27,18,28,3,,,,10,6,4,,,
"Jun 29, 2023 9:00 PM",59,22,37,62,35,27,62,27,35,52,19,33,,,,14,8,8,0,,,,7,25,32,18,14,25,2,,,,3,2,1,,,
"Jun 29, 2023 10:00 PM",39,9,30,33,24,9,53,14,39,35,6,29,,,,5,6,6,0,,,,4,12,17,10,7,13,1,,,,3,3,0,,,
"Jun 29, 2023 11:00 PM",18,5,13,18,15,3,19,9,10,14,4,10,,,,4,7,7,0,,,,5,9,15,10,5,7,0,,,,1,0,1,,,
"Jun 30, 2023 12:00 AM",9,0,9,0,0,0,3,3,0,5,2,3,,,,1,2,2,0,,,,2,8,,,,3,0,,,,0,0,0,,,
"Jun 30, 2023 1:00 AM",9,2,7,5,3,2,1,1,0,2,2,0,,,,0,2,1,1,,,,1,5,,,,1,0,,,,0,0,0,,,
"Jun 30, 2023 2:00 AM",7,5,2,1,0,1,3,3,0,2,2,0,,,,1,2,2,0,,,,2,1,,,,3,1,,,,1,0,1,,,
"Jun 30, 2023 3:00 AM",2,1,1,1,0,1,3,1,2,4,0,4,,,,0,0,0,0,,,,0,0,,,,2,0,,,,1,0,1,,,
"Jun 30, 2023 4:00 AM",2,0,2,0,0,0,3,1,2,1,0,1,,,,0,1,1,0,,,,2,0,,,,3,0,,,,1,1,0,,,
"Jun 30, 2023 5:00 AM",6,6,0,5,4,1,8,4,4,4,4,0,,,,1,6,6,0,,,,5,2,,,,5,0,,,,0,0,0,,,
"Jun 30, 2023 6:00 AM",38,21,17,13,5,8,25,11,14,13,6,7,,,,6,16,16,0,,,,14,12,,,,29,2,,,,2,1,1,,,
"Jun 30, 2023 7:00 AM",84,53,31,53,26,27,58,26,32,49,25,24,,,,10,46,46,0,,,,49,28,,,,64,3,,,,9,6,3,,,
"Jun 30, 2023 8:00 AM",139,102,37,62,12,50,109,32,77,62,30,32,,,,16,65,63,2,,,,59,40,,,,118,11,,,,7,6,1,,,
"Jun 30, 2023 9:00 AM",82,60,22,51,21,30,74,41,33,51,27,24,,,,12,42,42,0,,,,47,34,,,,66,1,,,,4,4,0,,,
"Jun 30, 2023 10:00 AM",54,40,14,49,27,22,71,38,33,50,32,18,,,,7,19,19,0,,,,19,19,,,,38,4,,,,5,3,2,,,
"Jun 30, 2023 11:00 AM",29,20,9,74,28,46,76,38,38,49,29,20,,,,11,10,10,0,,,,12,14,,,,31,1,,,,6,5,1,,,
"Jun 30, 2023 12:00 PM",53,25,28,56,32,24,78,31,47,54,27,27,,,,31,12,12,0,,,,11,21,,,,29,3,,,,8,4,4,,,
"Jun 30, 2023 1:00 PM",71,24,47,45,18,27,57,29,28,42,20,22,,,,15,21,20,1,,,,16,26,,,,24,3,,,,7,5,2,,,
"Jun 30, 2023 2:00 PM",59,28,31,35,23,12,45,25,20,35,21,14,,,,11,19,18,1,,,,17,21,,,,29,3,,,,5,2,3,,,
"Jun 30, 2023 3:00 PM",73,32,41,37,18,19,45,29,16,42,22,20,,,,15,11,8,3,,,,8,26,,,,25,8,,,,8,6,2,,,
"Jun 30, 2023 4:00 PM",111,36,75,58,36,22,48,29,19,38,28,10,,,,73,14,13,1,,,,13,39,,,,31,10,,,,7,5,2,,,
"Jun 30, 2023 5:00 PM",144,35,109,56,38,18,77,46,31,60,31,29,,,,16,29,26,3,,,,29,49,,,,40,3,,,,9,4,5,,,
"Jun 30, 2023 6:00 PM",114,36,78,61,37,24,83,56,27,57,33,24,,,,12,14,13,1,,,,10,66,,,,24,6,,,,6,5,1,,,
"Jun 30, 2023 7:00 PM",68,26,42,26,15,11,43,29,14,27,18,9,,,,11,12,10,2,,,,9,30,,,,14,3,,,,7,3,4,,,
"Jun 30, 2023 8:00 PM",61,21,40,21,10,11,25,11,14,26,11,15,,,,8,16,15,1,,,,15,23,,,,16,2,,,,4,2,2,,,
"Jun 30, 2023 9:00 PM",36,11,25,29,18,11,33,15,18,16,8,8,,,,4,5,5,0,,,,5,17,,,,16,3,,,,2,2,0,,,
"Jun 30, 2023 10:00 PM",33,13,20,9,5,4,7,3,4,6,3,3,,,,3,8,7,1,,,,8,9,,,,7,0,,,,1,0,1,,,
"Jun 30, 2023 11:00 PM",20,7,13,8,8,0,5,2,3,6,1,5,,,,3,3,3,0,,,,4,7,,,,6,3,,,,1,1,0,,,
"Jul 1, 2023 12:00 AM",10,3,7,0,0,0,2,1,1,1,0,1,,,,1,1,1,0,,,,1,4,4,4,0,7,1,,,,3,1,2,,,
"Jul 1, 2023 1:00 AM",9,3,6,2,2,0,6,3,3,1,1,0,,,,0,0,0,0,,,,0,5,4,0,4,0,0,,,,0,0,0,,,
"Jul 1, 2023 2:00 AM",6,6,0,2,1,1,1,0,1,1,0,1,,,,1,2,1,1,,,,1,0,2,2,0,3,0,,,,0,0,0,,,
"Jul 1, 2023 3:00 AM",5,1,4,0,0,0,1,1,0,1,1,0,,,,0,0,0,0,,,,1,0,0,0,0,1,0,,,,0,0,0,,,
"Jul 1, 2023 4:00 AM",2,0,2,0,0,0,2,1,1,3,3,0,,,,0,1,1,0,,,,1,2,1,1,0,1,0,,,,0,0,0,,,
"Jul 1, 2023 5:00 AM",5,3,2,1,0,1,1,1,0,0,0,0,,,,1,2,2,0,,,,2,0,0,0,0,2,0,,,,0,0,0,,,
"Jul 1, 2023 6:00 AM",9,5,4,7,2,5,10,4,6,9,1,8,,,,3,2,2,0,,,,2,3,4,4,0,10,1,,,,0,0,0,,,
"Jul 1, 2023 7:00 AM",22,2,20,20,14,6,29,20,9,22,15,7,,,,8,7,7,0,,,,8,8,16,12,4,16,1,,,,0,0,0,,,
"Jul 1, 2023 8:00 AM",29,17,12,34,24,10,49,36,13,42,34,8,,,,23,7,7,0,,,,9,16,26,19,7,14,3,,,,5,3,2,,,
"Jul 1, 2023 9:00 AM",49,28,21,61,37,24,80,50,30,56,39,17,,,,14,20,20,0,,,,15,20,24,17,7,20,4,,,,3,2,1,,,
"Jul 1, 2023 10:00 AM",42,23,19,112,50,62,110,66,44,82,47,35,,,,12,12,12,0,,,,8,23,66,47,19,29,10,,,,7,6,1,,,
"Jul 1, 2023 11:00 AM",57,34,23,109,50,59,125,70,55,113,66,47,,,,18,20,20,0,,,,20,32,60,36,24,31,1,,,,5,2,3,,,
"Jul 1, 2023 12:00 PM",44,25,19,105,49,56,124,83,41,86,48,38,,,,13,14,14,0,,,,11,32,54,31,23,32,4,,,,6,3,3,,,
"Jul 1, 2023 1:00 PM",44,20,24,120,67,53,109,58,51,95,63,32,,,,16,12,10,2,,,,9,27,50,24,26,31,5,,,,7,5,2,,,
"Jul 1, 2023 2:00 PM",55,35,20,128,72,56,100,57,43,119,71,48,,,,28,16,15,1,,,,15,28,68,46,22,36,9,,,,6,3,3,,,
"Jul 1, 2023 3:00 PM",29,12,17,149,64,85,107,42,65,120,53,67,,,,32,18,17,1,,,,19,21,70,36,34,37,2,,,,3,2,1,,,
"Jul 1, 2023 4:00 PM",57,27,30,123,69,54,123,44,79,108,42,66,,,,29,8,5,3,,,,6,23,71,28,43,40,4,,,,4,2,2,,,
"Jul 1, 2023 5:00 PM",49,20,29,108,55,53,78,42,36,65,34,31,,,,39,17,16,1,,,,12,23,49,24,25,24,3,,,,7,4,3,,,
"Jul 1, 2023 6:00 PM",51,19,32,72,27,45,57,20,37,61,30,31,,,,9,11,10,1,,,,12,14,26,8,18,20,2,,,,6,2,4,,,
"Jul 1, 2023 7:00 PM",54,23,31,38,20,18,46,24,22,43,16,27,,,,15,8,6,2,,,,9,11,33,17,16,20,3,,,,4,3,1,,,
"Jul 1, 2023 8:00 PM",26,12,14,52,29,23,38,20,18,26,13,13,,,,8,4,4,0,,,,3,11,18,9,9,11,3,,,,6,4,2,,,
"Jul 1, 2023 9:00 PM",25,12,13,36,16,20,25,9,16,23,6,17,,,,7,9,9,0,,,,9,9,21,9,12,11,2,,,,4,1,3,,,
"Jul 1, 2023 10:00 PM",22,7,15,11,4,7,19,5,14,14,2,12,,,,2,3,3,0,,,,5,8,9,4,5,8,1,,,,1,0,1,,,
"Jul 1, 2023 11:00 PM",11,2,9,5,5,0,9,3,6,6,1,5,,,,2,7,7,0,,,,6,2,3,3,0,4,1,,,,2,2,0,,,
"Jul 2, 2023 12:00 AM",16,6,10,0,0,0,3,1,2,5,2,3,,,,11,3,3,0,,,,4,5,0,0,0,7,2,,,,8,6,2,,,
"Jul 2, 2023 1:00 AM",10,5,5,2,2,0,3,1,2,3,0,3,,,,2,3,3,0,,,,5,3,4,1,3,0,0,,,,0,0,0,,,
"Jul 2, 2023 2:00 AM",6,2,4,0,0,0,2,1,1,0,0,0,,,,0,1,1,0,,,,1,2,1,1,0,4,0,,,,1,0,1,,,
"Jul 2, 2023 3:00 AM",5,1,4,2,2,0,0,0,0,2,1,1,,,,0,0,0,0,,,,0,1,0,0,0,1,0,,,,0,0,0,,,
"Jul 2, 2023 4:00 AM",1,0,1,1,0,1,3,1,2,2,1,1,,,,0,1,1,0,,,,1,1,0,0,0,1,0,,,,0,0,0,,,
"Jul 2, 2023 5:00 AM",6,3,3,2,0,2,3,3,0,1,1,0,,,,0,0,0,0,,,,0,3,3,2,1,2,0,,,,0,0,0,,,
"Jul 2, 2023 6:00 AM",13,9,4,4,1,3,11,4,7,7,2,5,,,,3,4,4,0,,,,2,5,3,2,1,8,0,,,,1,1,0,,,
"Jul 2, 2023 7:00 AM",16,8,8,14,8,6,25,19,6,19,14,5,,,,4,11,10,1,,,,10,11,3,3,0,16,0,,,,3,0,3,,,
"Jul 2, 2023 8:00 AM",35,14,21,59,38,21,63,43,20,66,44,22,,,,4,7,7,0,,,,8,27,18,10,8,17,2,,,,1,1,0,,,
"Jul 2, 2023 9:00 AM",36,12,24,136,83,53,120,81,39,93,67,26,,,,10,15,15,0,,,,14,36,33,18,15,28,6,,,,4,1,3,,,
"Jul 2, 2023 10:00 AM",46,26,20,120,55,65,119,67,52,99,52,47,,,,14,20,17,3,,,,14,30,36,23,13,39,7,,,,2,1,1,,,
"Jul 2, 2023 11:00 AM",48,27,21,113,55,58,131,71,60,91,50,41,,,,13,17,15,2,,,,15,29,66,37,29,33,5,,,,2,1,1,,,
"Jul 2, 2023 12:00 PM",68,38,30,158,75,83,191,104,87,117,70,47,,,,35,15,15,0,,,,15,40,77,41,36,44,1,,,,6,0,6,,,
"Jul 2, 2023 1:00 PM",67,34,33,160,81,79,131,66,65,113,65,48,,,,11,20,19,1,,,,13,32,59,42,17,44,4,,,,6,4,2,,,
"Jul 2, 2023 2:00 PM",57,32,25,112,57,55,117,43,74,96,52,44,,,,9,19,16,3,,,,16,20,38,15,23,47,6,,,,7,5,2,,,
"Jul 2, 2023 3:00 PM",47,25,22,113,47,66,80,46,34,92,52,40,,,,27,21,20,1,,,,17,18,57,33,24,26,3,,,,6,5,1,,,
"Jul 2, 2023 4:00 PM",45,27,18,106,56,50,96,33,63,75,28,47,,,,24,16,13,3,,,,9,16,28,12,16,33,5,,,,9,4,5,,,
"Jul 2, 2023 5:00 PM",37,15,22,71,35,36,69,19,50,77,23,54,,,,16,9,8,1,,,,7,20,42,13,29,37,5,,,,5,4,1,,,
"Jul 2, 2023 6:00 PM",67,28,39,49,27,22,65,27,38,32,12,20,,,,13,14,13,1,,,,12,17,30,18,12,25,1,,,,2,1,1,,,
"Jul 2, 2023 7:00 PM",39,15,24,34,15,19,36,16,20,27,10,17,,,,7,12,9,3,,,,11,11,16,9,7,25,4,,,,6,4,2,,,
"Jul 2, 2023 8:00 PM",26,17,9,30,20,10,38,16,22,26,14,12,,,,7,3,3,0,,,,5,9,15,4,11,15,2,,,,5,4,1,,,
"Jul 2, 2023 9:00 PM",25,8,17,13,5,8,23,10,13,16,7,9,,,,6,10,8,2,,,,9,11,13,5,8,11,2,,,,3,2,1,,,
"Jul 2, 2023 10:00 PM",13,5,8,7,1,6,15,6,9,9,2,7,,,,2,10,10,0,,,,9,2,3,1,2,6,3,,,,2,0,2,,,
"Jul 2, 2023 11:00 PM",19,6,13,3,3,0,10,2,8,9,3,6,,,,5,2,2,0,,,,2,6,0,0,0,9,1,,,,1,1,0,,,
"Jul 3, 2023 12:00 AM",4,1,3,0,0,0,0,0,0,0,0,0,,,,1,1,1,0,,,,0,5,1,1,0,2,0,,,,1,1,0,,,
"Jul 3, 2023 1:00 AM",4,2,2,0,0,0,0,0,0,0,0,0,,,,0,0,0,0,,,,0,0,1,1,0,0,0,,,,0,0,0,,,
"Jul 3, 2023 2:00 AM",2,2,0,0,0,0,1,1,0,0,0,0,,,,0,1,1,0,,,,1,1,1,1,0,0,0,,,,0,0,0,,,
"Jul 3, 2023 3:00 AM",0,0,0,0,0,0,0,0,0,0,0,0,,,,0,0,0,0,,,,0,0,0,0,0,0,0,,,,0,0,0,,,
"Jul 3, 2023 4:00 AM",2,0,2,2,2,0,0,0,0,1,1,0,,,,0,3,3,0,,,,3,2,1,1,0,0,0,,,,1,1,0,,,
"Jul 3, 2023 5:00 AM",14,11,3,1,1,0,4,2,2,2,2,0,,,,1,7,7,0,,,,6,1,2,1,1,10,0,,,,0,0,0,,,
"Jul 3, 2023 6:00 AM",37,20,17,9,4,5,11,2,9,12,6,6,,,,6,17,16,1,,,,14,12,3,1,2,21,1,,,,1,1,0,,,
"Jul 3, 2023 7:00 AM",66,46,20,23,5,18,26,7,19,18,7,11,,,,7,58,58,0,,,,55,21,15,4,11,74,2,,,,9,7,2,,,
"Jul 3, 2023 8:00 AM",126,99,27,24,3,21,41,9,32,33,14,19,,,,13,70,70,0,,,,71,26,27,5,22,98,1,,,,6,2,4,,,
"Jul 3, 2023 9:00 AM",77,66,11,28,10,18,45,22,23,28,18,10,,,,10,43,42,1,,,,38,11,22,8,14,49,1,,,,3,2,1,,,
"Jul 3, 2023 10:00 AM",35,28,7,24,11,13,48,22,26,22,13,9,,,,9,21,21,0,,,,18,14,17,6,11,30,1,,,,7,4,3,,,
"Jul 3, 2023 11:00 AM",25,12,13,40,20,20,40,21,19,30,17,13,,,,5,21,19,2,,,,14,9,18,11,7,12,2,,,,2,0,2,,,
"Jul 3, 2023 12:00 PM",34,23,11,47,24,23,49,30,19,37,23,14,,,,10,16,16,0,,,,8,5,26,17,9,18,2,,,,7,6,1,,,
"Jul 3, 2023 1:00 PM",36,16,20,33,16,17,47,20,27,33,15,18,,,,12,9,7,2,,,,8,6,25,10,15,9,0,,,,7,3,4,,,
"Jul 3, 2023 2:00 PM",39,16,23,27,16,11,34,16,18,25,14,11,,,,22,12,8,4,,,,8,6,19,12,7,18,2,,,,6,4,2,,,
"Jul 3, 2023 3:00 PM",55,19,36,28,16,12,34,18,16,21,11,10,,,,21,11,9,2,,,,10,13,21,11,10,25,4,,,,2,1,1,,,
"Jul 3, 2023 4:00 PM",85,26,59,59,38,21,66,42,24,61,40,21,,,,20,20,18,2,,,,17,24,25,22,3,32,3,,,,3,1,2,,,
"Jul 3, 2023 5:00 PM",153,44,109,59,35,24,97,51,46,75,39,36,,,,26,28,26,2,,,,21,82,36,32,4,49,4,,,,4,2,2,,,
"Jul 3, 2023 6:00 PM",128,33,95,77,40,37,77,56,21,67,36,31,,,,20,17,14,3,,,,15,80,56,46,10,27,2,,,,9,8,1,,,
"Jul 3, 2023 7:00 PM",76,24,52,40,27,13,49,35,14,37,21,16,,,,13,21,14,7,,,,13,30,21,16,5,17,4,,,,9,5,4,,,
"Jul 3, 2023 8:00 PM",47,13,34,39,23,16,31,11,20,23,10,13,,,,5,12,12,0,,,,11,16,13,8,5,15,2,,,,9,4,5,,,
"Jul 3, 2023 9:00 PM",23,5,18,24,12,12,20,8,12,10,3,7,,,,5,12,11,1,,,,10,15,9,4,5,10,3,,,,8,7,1,,,
"Jul 3, 2023 10:00 PM",18,2,16,5,2,3,12,4,8,8,1,7,,,,0,3,2,1,,,,4,5,4,4,0,6,1,,,,4,2,2,,,
"Jul 3, 2023 11:00 PM",8,2,6,3,2,1,9,5,4,5,4,1,,,,1,1,1,0,,,,1,4,0,0,0,1,2,,,,1,1,0,,,
"Jul 4, 2023 12:00 AM",5,1,4,0,0,0,1,1,0,1,0,1,,,,0,3,3,0,,,,3,2,4,1,3,2,1,,,,0,0,0,,,
"Jul 4, 2023 1:00 AM",1,0,1,0,0,0,1,1,0,0,0,0,,,,0,0,0,0,,,,0,1,1,1,0,0,0,,,,0,0,0,,,
"Jul 4, 2023 2:00 AM",3,2,1,0,0,0,1,0,1,0,0,0,,,,0,0,0,0,,,,0,1,0,0,0,0,0,,,,0,0,0,,,
"Jul 4, 2023 3:00 AM",2,2,0,0,0,0,1,1,0,0,0,0,,,,0,0,0,0,,,,0,1,2,2,0,0,0,,,,0,0,0,,,
"Jul 4, 2023 4:00 AM",5,2,3,2,2,0,0,0,0,1,0,1,,,,0,2,2,0,,,,2,2,1,1,0,1,0,,,,2,1,1,,,
"Jul 4, 2023 5:00 AM",12,10,2,7,4,3,9,6,3,8,6,2,,,,2,9,9,0,,,,8,3,6,3,3,6,0,,,,0,0,0,,,
"Jul 4, 2023 6:00 AM",50,28,22,24,10,14,26,10,16,20,12,8,,,,10,20,20,0,,,,22,16,4,3,1,38,2,,,,4,3,1,,,
"Jul 4, 2023 7:00 AM",118,86,32,73,22,51,84,26,58,73,26,47,,,,17,81,80,1,,,,77,28,41,16,25,118,3,,,,9,8,1,,,
"Jul 4, 2023 8:00 AM",243,192,51,72,19,53,136,41,95,100,37,63,,,,30,170,168,2,,,,158,56,83,23,60,221,6,,,,9,6,3,,,
"Jul 4, 2023 9:00 AM",123,104,19,70,26,44,83,38,45,65,36,29,,,,19,66,65,1,,,,59,15,48,13,35,82,5,,,,7,7,0,,,
"Jul 4, 2023 10:00 AM",53,39,14,42,18,24,55,36,19,36,25,11,,,,14,32,31,1,,,,27,25,19,14,5,36,1,,,,5,3,2,,,
"Jul 4, 2023 11:00 AM",32,19,13,80,40,40,72,32,40,56,28,28,,,,11,19,16,3,,,,14,21,36,16,20,31,2,,,,5,3,2,,,
"Jul 4, 2023 12:00 PM",59,38,21,84,36,48,93,50,43,54,34,20,,,,11,21,17,4,,,,13,18,39,25,14,25,1,,,,7,0,7,,,
"Jul 4, 2023 1:00 PM",68,23,45,77,39,38,85,43,42,65,34,31,,,,21,16,16,0,,,,13,22,44,19,25,22,7,,,,2,2,0,,,
"Jul 4, 2023 2:00 PM",49,19,30,43,27,16,62,33,29,27,13,14,,,,12,8,7,1,,,,8,19,31,17,14,35,6,,,,6,3,3,,,
"Jul 4, 2023 3:00 PM",67,25,42,53,30,23,38,21,17,40,22,18,,,,14,11,10,1,,,,9,40,17,10,7,17,4,,,,4,4,0,,,
"Jul 4, 2023 4:00 PM",115,25,90,50,28,22,79,41,38,64,36,28,,,,20,23,19,4,,,,17,27,40,29,11,41,4,,,,8,6,2,,,
"Jul 4, 2023 5:00 PM",232,61,171,118,69,49,148,95,53,122,83,39,,,,28,39,34,5,,,,33,28,71,51,20,53,10,,,,8,5,3,,,
"Jul 4, 2023 6:00 PM",173,39,134,103,80,23,103,80,23,86,63,23,,,,26,26,25,1,,,,23,77,67,52,15,33,4,,,,11,10,1,,,
"Jul 4, 2023 7:00 PM",93,25,68,20,13,7,45,29,16,32,15,17,,,,12,13,9,4,,,,10,49,32,21,11,17,4,,,,2,2,0,,,
"Jul 4, 2023 8:00 PM",51,11,40,10,6,4,26,16,10,18,7,11,,,,11,12,11,1,,,,12,23,18,14,4,10,1,,,,2,0,2,,,
"Jul 4, 2023 9:00 PM",50,15,35,28,18,10,33,12,21,21,6,15,,,,8,14,10,4,,,,12,11,13,5,8,17,1,,,,2,1,1,,,
"Jul 4, 2023 10:00 PM",22,7,15,20,16,4,18,8,10,13,7,6,,,,3,4,3,1,,,,3,12,8,6,2,6,3,,,,2,0,2,,,
"Jul 4, 2023 11:00 PM",11,3,8,5,3,2,4,1,3,3,1,2,,,,7,3,3,0,,,,3,4,0,0,0,3,1,,,,0,0,0,,,
"Jul 5, 2023 12:00 AM",10,2,8,1,1,0,1,1,0,3,3,0,,,,1,1,1,0,,,,1,2,2,2,0,2,0,,,,1,1,0,,,
"Jul 5, 2023 1:00 AM",1,0,1,2,2,0,0,0,0,0,0,0,,,,0,0,0,0,,,,1,1,0,0,0,1,0,,,,0,0,0,,,
"Jul 5, 2023 2:00 AM",3,2,1,0,0,0,0,0,0,0,0,0,,,,0,0,0,0,,,,0,0,0,0,0,0,0,,,,0,0,0,,,
"Jul 5, 2023 3:00 AM",1,0,1,1,0,1,1,0,1,1,0,1,,,,0,0,0,0,,,,0,1,0,0,0,0,0,,,,0,0,0,,,
"Jul 5, 2023 4:00 AM",4,1,3,0,0,0,2,2,0,1,1,0,,,,0,2,2,0,,,,2,0,2,2,0,2,0,,,,0,0,0,,,
"Jul 5, 2023 5:00 AM",14,7,7,5,5,0,7,5,2,5,4,1,,,,3,5,5,0,,,,5,5,4,2,2,8,0,,,,0,0,0,,,
"Jul 5, 2023 6:00 AM",51,31,20,12,4,8,22,7,15,13,6,7,,,,6,24,24,0,,,,19,23,12,8,4,35,3,,,,2,2,0,,,
"Jul 5, 2023 7:00 AM",119,79,40,43,13,30,57,19,38,45,14,31,,,,15,90,90,0,,,,96,30,31,7,24,113,0,,,,8,7,1,,,
"Jul 5, 2023 8:00 AM",243,185,58,82,22,60,128,49,79,92,45,47,,,,28,152,149,3,,,,151,59,80,25,55,188,4,,,,6,5,1,,,
"Jul 5, 2023 9:00 AM",108,84,24,40,15,25,62,27,35,52,30,22,,,,6,64,63,1,,,,56,24,35,12,23,68,4,,,,7,5,2,,,
"Jul 5, 2023 10:00 AM",58,48,10,47,16,31,54,28,26,38,20,18,,,,11,30,29,1,,,,27,12,18,7,11,29,2,,,,1,1,0,,,
"Jul 5, 2023 11:00 AM",35,19,16,46,24,22,40,27,13,31,20,11,,,,8,16,14,2,,,,14,14,16,6,10,17,3,,,,4,4,0,,,
"Jul 5, 2023 12:00 PM",51,30,21,68,32,36,59,28,31,48,26,22,,,,10,22,20,2,,,,14,19,26,16,10,22,4,,,,5,3,2,,,
"Jul 5, 2023 1:00 PM",53,19,34,61,30,31,51,27,24,41,21,20,,,,19,23,20,3,,,,21,19,27,16,11,22,2,,,,2,1,1,,,
"Jul 5, 2023 2:00 PM",40,19,21,41,19,22,43,14,29,32,11,21,,,,8,17,17,0,,,,14,16,30,13,17,23,1,,,,4,2,2,,,
"Jul 5, 2023 3:00 PM",65,25,40,31,16,15,47,27,20,29,16,13,,,,19,13,12,1,,,,9,25,31,21,10,35,3,,,,1,1,0,,,
"Jul 5, 2023 4:00 PM",116,38,78,46,21,25,76,37,39,48,22,26,,,,15,22,17,5,,,,15,57,42,22,20,45,4,,,,4,1,3,,,
"Jul 5, 2023 5:00 PM",216,56,160,94,52,42,131,83,48,103,65,38,,,,30,37,30,7,,,,30,132,73,51,22,66,9,,,,10,7,3,,,
"Jul 5, 2023 6:00 PM",191,38,153,88,66,22,133,97,36,106,74,32,,,,18,33,27,6,,,,29,108,100,67,33,34,7,,,,9,4,5,,,
"Jul 5, 2023 7:00 PM",96,27,69,77,47,30,118,76,42,86,58,28,,,,20,23,22,1,,,,23,29,53,41,12,20,4,,,,6,4,2,,,
"Jul 5, 2023 8:00 PM",81,31,50,79,42,37,73,29,44,68,29,39,,,,11,18,15,3,,,,13,1,31,15,16,21,4,,,,4,3,1,,,
"Jul 5, 2023 9:00 PM",49,16,33,37,21,16,39,12,27,40,10,30,,,,6,6,6,0,,,,7,0,18,9,9,17,4,,,,4,2,2,,,
"Jul 5, 2023 10:00 PM",37,10,27,24,18,6,23,9,14,21,7,14,,,,6,8,8,0,,,,9,0,11,6,5,8,2,,,,0,0,0,,,
"Jul 5, 2023 11:00 PM",12,4,8,7,6,1,9,5,4,6,4,2,,,,3,4,3,1,,,,3,5,5,4,1,7,2,,,,1,1,0,,,
"Jul 6, 2023 12:00 AM",7,1,6,0,0,0,4,2,2,2,1,1,,,,2,1,1,0,,,,1,0,1,1,0,2,1,,,,3,2,1,,,
"Jul 6, 2023 1:00 AM",3,2,1,2,2,0,2,2,0,0,0,0,,,,0,1,1,0,,,,1,0,1,1,0,0,0,,,,1,0,1,,,
"Jul 6, 2023 2:00 AM",3,3,0,0,0,0,1,0,1,1,0,1,,,,0,1,0,1,,,,0,1,0,0,0,1,1,,,,3,1,2,,,
"Jul 6, 2023 3:00 AM",2,0,2,2,0,2,1,1,0,2,0,2,,,,0,0,0,0,,,,0,1,0,0,0,2,0,,,,0,0,0,,,
"Jul 6, 2023 4:00 AM",1,0,1,0,0,0,1,0,1,0,0,0,,,,0,3,3,0,,,,3,1,1,0,1,0,0,,,,0,0,0,,,
"Jul 6, 2023 5:00 AM",12,9,3,5,5,0,6,5,1,6,6,0,,,,2,8,8,0,,,,8,4,4,1,3,3,0,,,,1,0,1,,,
"Jul 6, 2023 6:00 AM",40,26,14,23,10,13,32,17,15,26,13,13,,,,9,22,22,0,,,,20,15,9,4,5,32,1,,,,4,2,2,,,
"Jul 6, 2023 7:00 AM",113,75,38,44,11,33,61,17,44,51,17,34,,,,18,65,65,0,,,,60,37,33,10,23,101,2,,,,5,4,1,,,
"Jul 6, 2023 8:00 AM",222,176,46,82,23,59,100,32,68,87,38,49,,,,28,136,135,1,,,,128,57,60,15,45,171,6,,,,6,4,2,,,
"Jul 6, 2023 9:00 AM",117,101,16,56,21,35,77,42,35,65,44,21,,,,12,48,48,0,,,,38,16,39,18,21,66,2,,,,8,6,2,,,
"Jul 6, 2023 10:00 AM",61,44,17,62,16,46,60,39,21,47,26,21,,,,10,36,33,3,,,,33,20,22,14,8,34,5,,,,1,1,0,,,
"Jul 6, 2023 11:00 AM",39,24,15,79,37,42,67,31,36,60,27,33,,,,16,14,13,1,,,,14,16,35,18,17,17,3,,,,4,4,0,,,
"Jul 6, 2023 12:00 PM",56,30,26,57,17,40,48,29,19,48,32,16,,,,13,18,16,2,,,,13,18,21,12,9,20,3,,,,5,3,2,,,
"Jul 6, 2023 1:00 PM",52,23,29,57,22,35,47,25,22,41,26,15,,,,7,10,9,1,,,,8,17,17,8,9,11,1,,,,0,0,0,,,
"Jul 6, 2023 2:00 PM",49,24,25,17,8,9,19,13,6,14,9,5,,,,13,10,7,3,,,,8,17,16,13,3,15,4,,,,5,3,2,,,
"Jul 6, 2023 3:00 PM",49,22,27,17,9,8,35,21,14,18,8,10,,,,7,8,8,0,,,,7,22,20,15,5,21,5,,,,3,1,2,,,
"Jul 6, 2023 4:00 PM",98,23,75,38,28,10,39,19,20,23,14,9,,,,11,25,19,6,,,,17,40,22,16,6,30,2,,,,4,2,2,,,
"Jul 6, 2023 5:00 PM",172,35,137,42,37,5,65,33,32,48,28,20,,,,21,27,22,5,,,,23,93,53,37,16,49,4,,,,4,2,2,,,
"Jul 6, 2023 6:00 PM",188,46,142,42,32,10,58,46,12,52,35,17,,,,21,23,18,5,,,,19,93,37,31,6,30,1,,,,9,6,3,,,
"Jul 6, 2023 7:00 PM",71,23,48,31,20,11,42,29,13,28,11,17,,,,11,14,13,1,,,,11,37,21,15,6,17,3,,,,7,4,3,,,
"Jul 6, 2023 8:00 PM",62,21,41,17,12,5,19,13,6,15,8,7,,,,10,11,9,2,,,,6,28,11,11,0,12,1,,,,1,1,0,,,
"Jul 6, 2023 9:00 PM",35,4,31,15,12,3,20,11,9,13,7,6,,,,3,8,8,0,,,,7,10,8,4,4,15,0,,,,1,0,1,,,
"Jul 6, 2023 10:00 PM",21,4,17,11,11,0,16,7,9,14,7,7,,,,0,8,6,2,,,,6,6,8,6,2,8,0,,,,0,0,0,,,
"Jul 6, 2023 11:00 PM",19,11,8,6,5,1,13,8,5,9,5,4,,,,1,3,3,0,,,,2,3,2,1,1,4,1,,,,1,1,0,,,
"Jul 7, 2023 12:00 AM",8,2,6,0,0,0,0,0,0,2,2,0,,,,0,2,2,0,,,,2,3,2,1,1,3,0,,,,0,0,0,,,
"Jul 7, 2023 1:00 AM",4,0,4,3,2,1,0,0,0,1,0,1,,,,0,0,0,0,,,,0,3,1,1,0,3,0,,,,0,0,0,,,
"Jul 7, 2023 2:00 AM",0,0,0,1,1,0,1,1,0,0,0,0,,,,0,0,0,0,,,,0,1,1,1,0,0,0,,,,1,0,1,,,
"Jul 7, 2023 3:00 AM",1,0,1,0,0,0,0,0,0,2,2,0,,,,0,0,0,0,,,,1,1,1,1,0,0,0,,,,0,0,0,,,
"Jul 7, 2023 4:00 AM",4,0,4,0,0,0,1,0,1,0,0,0,,,,0,2,2,0,,,,2,3,0,0,0,1,0,,,,0,0,0,,,
"Jul 7, 2023 5:00 AM",7,5,2,2,1,1,7,2,5,4,1,3,,,,2,6,6,0,,,,7,2,0,0,0,6,0,,,,0,0,0,,,
"Jul 7, 2023 6:00 AM",41,24,17,22,10,12,28,13,15,20,12,8,,,,5,15,15,0,,,,11,19,6,5,1,28,1,,,,1,0,1,,,
"Jul 7, 2023 7:00 AM",66,45,21,39,14,25,47,16,31,39,17,22,,,,7,36,36,0,,,,35,31,23,7,16,54,2,,,,5,2,3,,,
"Jul 7, 2023 8:00 AM",146,106,40,76,24,52,96,42,54,71,40,31,,,,14,80,78,2,,,,68,45,59,19,40,91,3,,,,3,1,2,,,
"Jul 7, 2023 9:00 AM",94,77,17,82,14,68,82,60,22,84,66,18,,,,9,42,41,1,,,,36,23,29,17,12,43,1,,,,2,1,1,,,
"Jul 7, 2023 10:00 AM",49,31,18,66,28,38,55,38,17,50,34,16,,,,14,21,21,0,,,,16,12,27,15,12,18,2,,,,3,0,3,,,
"Jul 7, 2023 11:00 AM",48,32,16,44,17,27,42,22,20,33,18,15,,,,11,7,6,1,,,,5,15,24,10,14,16,2,,,,2,2,0,,,
"Jul 7, 2023 12:00 PM",57,28,29,38,20,18,42,18,24,43,17,26,,,,9,16,15,1,,,,10,16,21,10,11,23,2,,,,2,1,1,,,
"Jul 7, 2023 1:00 PM",61,17,44,32,19,13,56,27,29,39,20,19,,,,19,20,17,3,,,,13,20,16,12,4,20,3,,,,2,0,2,,,
"Jul 7, 2023 2:00 PM",79,39,40,38,20,18,76,43,33,45,17,28,,,,20,8,6,2,,,,7,26,36,21,15,20,6,,,,6,4,2,,,
"Jul 7, 2023 3:00 PM",69,30,39,57,31,26,66,36,30,45,28,17,,,,28,18,15,3,,,,12,35,34,25,9,26,6,,,,10,8,2,,,
"Jul 7, 2023 4:00 PM",102,35,67,65,42,23,82,44,38,58,38,20,,,,11,20,17,3,,,,18,46,59,35,24,50,3,,,,6,4,2,,,
"Jul 7, 2023 5:00 PM",157,48,109,94,64,30,134,74,60,86,50,36,,,,30,30,28,2,,,,28,66,52,32,20,48,2,,,,14,10,4,,,
"Jul 7, 2023 6:00 PM",111,35,76,84,55,29,115,75,40,70,44,26,,,,14,31,26,5,,,,28,47,59,36,23,22,2,,,,3,0,3,,,
"Jul 7, 2023 7:00 PM",71,20,51,91,46,45,89,44,45,68,34,34,,,,16,22,18,4,,,,17,26,43,24,19,24,7,,,,7,4,3,,,
"Jul 7, 2023 8:00 PM",62,30,32,64,31,33,63,21,42,54,13,41,,,,17,14,11,3,,,,11,18,30,7,23,20,1,,,,4,4,0,,,
"Jul 7, 2023 9:00 PM",36,13,23,43,32,11,31,13,18,34,16,18,,,,4,8,6,2,,,,6,16,18,8,10,15,0,,,,8,3,5,,,
"Jul 7, 2023 10:00 PM",33,11,22,21,14,7,22,7,15,16,6,10,,,,4,6,4,2,,,,4,8,7,3,4,10,1,,,,1,1,0,,,
"Jul 7, 2023 11:00 PM",31,17,14,18,16,2,10,5,5,13,7,6,,,,5,7,7,0,,,,8,4,8,7,1,7,0,,,,0,0,0,,,
"Jul 8, 2023 12:00 AM",16,5,11,0,0,0,1,1,0,5,5,0,,,,0,1,1,0,,,,1,6,3,3,0,7,0,,,,2,1,1,,,
"Jul 8, 2023 1:00 AM",6,2,4,7,4,3,4,3,1,5,2,3,,,,0,2,1,1,,,,0,1,1,1,0,3,2,,,,2,2,0,,,
"Jul 8, 2023 2:00 AM",7,4,3,0,0,0,2,1,1,0,0,0,,,,0,0,0,0,,,,0,3,0,0,0,0,0,,,,0,0,0,,,
"Jul 8, 2023 3:00 AM",7,2,5,2,2,0,0,0,0,0,0,0,,,,0,0,0,0,,,,1,3,1,0,1,1,0,,,,1,1,0,,,
"Jul 8, 2023 4:00 AM",5,0,5,0,0,0,1,0,1,1,0,1,,,,0,1,1,0,,,,1,0,0,0,0,1,0,,,,0,0,0,,,
"Jul 8, 2023 5:00 AM",5,5,0,1,0,1,2,0,2,1,0,1,,,,1,2,2,0,,,,2,1,0,0,0,1,0,,,,0,0,0,,,
"Jul 8, 2023 6:00 AM",13,4,9,6,3,3,6,6,0,7,6,1,,,,2,0,0,0,,,,0,4,1,1,0,7,0,,,,1,1,0,,,
"Jul 8, 2023 7:00 AM",18,5,13,18,12,6,27,22,5,18,16,2,,,,8,6,6,0,,,,6,14,6,4,2,9,0,,,,0,0,0,,,
"Jul 8, 2023 8:00 AM",22,14,8,30,13,17,37,22,15,27,19,8,,,,7,7,7,0,,,,6,16,8,6,2,20,2,,,,5,2,3,,,
"Jul 8, 2023 9:00 AM",34,19,15,78,36,42,55,37,18,51,37,14,,,,8,18,18,0,,,,21,10,24,15,9,18,0,,,,2,0,2,,,
"Jul 8, 2023 10:00 AM",45,27,18,118,49,69,108,63,45,114,74,40,,,,13,14,14,0,,,,14,26,48,30,18,26,1,,,,2,2,0,,,
"Jul 8, 2023 11:00 AM",42,22,20,180,82,98,143,87,56,138,90,48,,,,23,11,11,0,,,,10,38,49,38,11,38,5,,,,10,5,5,,,
"Jul 8, 2023 12:00 PM",49,28,21,149,71,78,138,69,69,112,62,50,,,,7,18,17,1,,,,17,25,79,43,36,44,2,,,,13,9,4,,,
"Jul 8, 2023 1:00 PM",49,18,31,94,48,46,120,66,54,100,52,48,,,,15,15,15,0,,,,14,32,73,42,31,29,7,,,,8,5,3,,,
"Jul 8, 2023 2:00 PM",63,34,29,123,63,60,154,94,60,110,71,39,,,,14,13,13,0,,,,12,35,46,26,20,28,6,,,,4,2,2,,,
"Jul 8, 2023 3:00 PM",50,23,27,140,85,55,171,98,73,120,71,49,,,,16,20,20,0,,,,17,38,101,67,34,37,8,,,,2,2,0,,,
"Jul 8, 2023 4:00 PM",43,21,22,161,75,86,181,101,80,110,64,46,,,,9,17,14,3,,,,10,39,81,37,44,30,4,,,,13,8,5,,,
"Jul 8, 2023 5:00 PM",57,32,25,97,40,57,179,72,107,105,39,66,,,,20,17,17,0,,,,16,30,67,31,36,33,3,,,,6,4,2,,,
"Jul 8, 2023 6:00 PM",43,21,22,74,39,35,122,44,78,96,30,66,,,,15,15,14,1,,,,14,24,48,24,24,43,6,,,,5,1,4,,,
"Jul 8, 2023 7:00 PM",44,21,23,68,35,33,71,29,42,43,16,27,,,,14,15,14,1,,,,12,17,49,16,33,35,5,,,,5,5,0,,,
"Jul 8, 2023 8:00 PM",20,9,11,55,23,32,59,25,34,43,17,26,,,,10,12,11,1,,,,10,15,30,8,22,20,4,,,,6,4,2,,,
"Jul 8, 2023 9:00 PM",42,17,25,39,23,16,28,11,17,25,9,16,,,,4,8,5,3,,,,6,9,7,0,7,14,1,,,,6,4,2,,,
"Jul 8, 2023 10:00 PM",17,8,9,27,19,8,32,7,25,23,6,17,,,,9,8,7,1,,,,7,6,12,7,5,10,0,,,,5,2,3,,,
"Jul 8, 2023 11:00 PM",13,7,6,16,13,3,12,4,8,12,2,10,,,,3,7,7,0,,,,5,6,3,2,1,6,2,,,,2,1,1,,,
"Jul 9, 2023 12:00 AM",9,2,7,0,0,0,5,1,4,12,3,9,,,,0,1,1,0,,,,1,4,4,1,3,5,0,,,,0,0,0,,,
"Jul 9, 2023 1:00 AM",7,3,4,9,9,0,1,0,1,3,0,3,,,,0,1,1,0,,,,1,5,1,0,1,5,0,,,,0,0,0,,,
"Jul 9, 2023 2:00 AM",8,2,6,7,5,2,2,1,1,0,0,0,,,,0,1,1,0,,,,2,1,0,0,0,3,0,,,,0,0,0,,,
"Jul 9, 2023 3:00 AM",4,1,3,1,1,0,4,2,2,2,1,1,,,,1,0,0,0,,,,3,4,2,0,2,4,1,,,,0,0,0,,,
"Jul 9, 2023 4:00 AM",6,0,6,1,0,1,3,0,3,2,0,2,,,,0,2,2,0,,,,2,0,7,6,1,3,0,,,,1,1,0,,,
"Jul 9, 2023 5:00 AM",3,1,2,0,0,0,1,1,0,1,1,0,,,,1,1,1,0,,,,1,1,4,1,3,1,0,,,,0,0,0,,,
"Jul 9, 2023 6:00 AM",7,4,3,13,5,8,16,9,7,11,4,7,,,,2,1,1,0,,,,1,3,2,1,1,4,1,,,,0,0,0,,,
"Jul 9, 2023 7:00 AM",18,9,9,29,14,15,41,24,17,19,12,7,,,,2,11,11,0,,,,11,15,9,3,6,16,0,,,,1,1,0,,,
"Jul 9, 2023 8:00 AM",24,11,13,66,42,24,69,43,26,58,42,16,,,,5,8,8,0,,,,9,32,23,16,7,22,3,,,,3,0,3,,,
"Jul 9, 2023 9:00 AM",27,14,13,143,52,91,131,92,39,112,85,27,,,,7,9,8,1,,,,10,32,48,35,13,29,5,,,,4,2,2,,,
"Jul 9, 2023 10:00 AM",39,24,15,72,29,43,82,39,43,79,41,38,,,,1,16,15,1,,,,14,23,39,17,22,29,3,,,,4,4,0,,,
"Jul 9, 2023 11:00 AM",37,26,11,136,81,55,122,63,59,122,67,55,,,,5,13,13,0,,,,11,35,31,14,17,23,2,,,,6,3,3,,,
"Jul 9, 2023 12:00 PM",33,20,13,94,29,65,108,51,57,89,34,55,,,,13,20,16,4,,,,14,24,48,33,15,38,3,,,,4,2,2,,,
"Jul 9, 2023 1:00 PM",35,12,23,117,68,49,103,57,46,95,60,35,,,,14,14,13,1,,,,13,25,63,38,25,38,5,,,,4,2,2,,,
"Jul 9, 2023 2:00 PM",53,24,29,144,77,67,167,104,63,125,79,46,,,,16,17,15,2,,,,15,20,74,43,31,32,5,,,,1,1,0,,,
"Jul 9, 2023 3:00 PM",53,34,19,135,73,62,142,65,77,98,41,57,,,,23,13,12,1,,,,9,19,58,34,24,34,4,,,,7,4,3,,,
"Jul 9, 2023 4:00 PM",41,22,19,116,62,54,144,80,64,100,52,48,,,,16,16,14,2,,,,9,27,67,42,25,28,1,,,,5,2,3,,,
"Jul 9, 2023 5:00 PM",58,24,34,114,58,56,143,60,83,94,35,59,,,,5,17,14,3,,,,16,20,78,32,46,43,1,,,,9,5,4,,,
"Jul 9, 2023 6:00 PM",53,22,31,80,40,40,148,56,92,82,29,53,,,,17,10,9,1,,,,10,19,75,34,41,39,3,,,,6,5,1,,,
"Jul 9, 2023 7:00 PM",56,29,27,75,29,46,94,39,55,44,20,24,,,,16,15,14,1,,,,13,14,50,25,25,30,6,,,,13,8,5,,,
"Jul 9, 2023 8:00 PM",34,14,20,57,29,28,70,25,45,50,19,31,,,,14,8,8,0,,,,7,10,38,14,24,22,3,,,,5,2,3,,,
"Jul 9, 2023 9:00 PM",26,10,16,30,17,13,25,9,16,25,10,15,,,,7,6,6,0,,,,7,4,13,5,8,21,1,,,,0,0,0,,,
"Jul 9, 2023 10:00 PM",19,8,11,18,16,2,14,6,8,15,8,7,,,,4,8,8,0,,,,7,7,9,3,6,9,1,,,,3,1,2,,,
"Jul 9, 2023 11:00 PM",13,8,5,4,2,2,5,1,4,6,1,5,,,,0,5,5,0,,,,4,1,0,0,0,4,0,,,,2,1,1,,,
"Jul 10, 2023 12:00 AM",7,2,5,0,0,0,0,0,0,0,0,0,,,,1,0,0,0,,,,0,4,1,1,0,4,1,,,,1,1,0,,,
"Jul 10, 2023 1:00 AM",3,1,2,0,0,0,0,0,0,2,1,1,,,,0,1,1,0,,,,0,1,1,1,0,1,0,,,,1,1,0,,,
"Jul 10, 2023 2:00 AM",1,0,1,0,0,0,0,0,0,0,0,0,,,,0,0,0,0,,,,0,1,0,0,0,0,0,,,,0,0,0,,,
"Jul 10, 2023 3:00 AM",0,0,0,0,0,0,0,0,0,0,0,0,,,,0,0,0,0,,,,0,0,0,0,0,0,0,,,,0,0,0,,,
"Jul 10, 2023 4:00 AM",4,1,3,0,0,0,0,0,0,0,0,0,,,,0,1,1,0,,,,1,1,1,1,0,1,0,,,,0,0,0,,,
"Jul 10, 2023 5:00 AM",7,6,1,3,1,2,5,2,3,3,1,2,,,,1,6,6,0,,,,6,4,3,1,2,4,0,,,,0,0,0,,,
"Jul 10, 2023 6:00 AM",37,27,10,8,2,6,13,6,7,8,1,7,,,,3,15,15,0,,,,13,11,2,1,1,31,2,,,,1,1,0,,,
"Jul 10, 2023 7:00 AM",82,56,26,25,8,17,40,15,25,28,12,16,,,,11,58,57,1,,,,56,24,12,3,9,78,1,,,,5,4,1,,,
"Jul 10, 2023 8:00 AM",163,133,30,18,2,16,67,27,40,37,21,16,,,,18,76,75,1,,,,74,33,35,10,25,104,3,,,,3,3,0,,,
"Jul 10, 2023 9:00 AM",69,54,15,15,4,11,25,10,15,21,11,10,,,,11,32,31,1,,,,26,18,7,3,4,29,3,,,,4,3,1,,,
"Jul 10, 2023 10:00 AM",33,26,7,16,9,7,22,14,8,15,8,7,,,,4,8,8,0,,,,4,14,10,4,6,18,1,,,,1,1,0,,,
"Jul 10, 2023 11:00 AM",32,17,15,19,8,11,16,8,8,14,9,5,,,,0,11,11,0,,,,9,8,7,2,5,15,1,,,,2,2,0,,,
"Jul 10, 2023 12:00 PM",20,16,4,15,6,9,15,8,7,13,6,7,,,,6,5,4,1,,,,4,5,9,5,4,10,0,,,,1,1,0,,,
"Jul 10, 2023 1:00 PM",20,8,12,9,6,3,13,8,5,7,6,1,,,,7,7,6,1,,,,3,4,3,2,1,7,0,,,,4,3,1,,,
"Jul 10, 2023 2:00 PM",29,8,21,14,7,7,7,6,1,10,5,5,,,,13,9,8,1,,,,7,9,4,4,0,8,0,,,,3,1,2,,,
"Jul 10, 2023 3:00 PM",46,17,29,13,6,7,18,7,11,14,7,7,,,,8,11,9,2,,,,7,12,5,4,1,11,2,,,,3,1,2,,,
"Jul 10, 2023 4:00 PM",76,20,56,17,10,7,36,20,16,29,14,15,,,,13,9,7,2,,,,8,35,18,11,7,32,1,,,,2,2,0,,,
"Jul 10, 2023 5:00 PM",141,37,104,34,24,10,70,34,36,49,27,22,,,,15,24,21,3,,,,23,72,28,20,8,43,4,,,,3,2,1,,,
"Jul 10, 2023 6:00 PM",109,19,90,18,12,6,42,33,9,29,14,15,,,,16,17,14,3,,,,14,63,43,39,4,21,3,,,,5,4,1,,,
"Jul 10, 2023 7:00 PM",71,21,50,40,27,13,40,27,13,25,15,10,,,,10,10,7,3,,,,5,29,22,19,3,15,0,,,,3,2,1,,,
"Jul 10, 2023 8:00 PM",40,14,26,32,13,19,51,30,21,26,14,12,,,,6,9,9,0,,,,9,16,17,12,5,19,1,,,,2,0,2,,,
"Jul 10, 2023 9:00 PM",32,7,25,7,4,3,11,5,6,6,2,4,,,,3,9,8,1,,,,7,13,10,5,5,8,0,,,,0,0,0,,,
"Jul 10, 2023 10:00 PM",22,6,16,9,5,4,9,3,6,5,2,3,,,,2,4,3,1,,,,4,7,1,1,0,6,1,,,,0,0,0,,,
"Jul 10, 2023 11:00 PM",5,1,4,0,0,0,2,0,2,1,0,1,,,,0,1,1,0,,,,0,0,0,0,0,1,1,,,,1,1,0,,,
"Jul 11, 2023 12:00 AM",4,0,4,0,0,0,0,0,0,0,0,0,,,,0,0,0,0,,,,0,2,0,0,0,1,0,,,,0,0,0,,,
"Jul 11, 2023 1:00 AM",2,2,0,2,2,0,3,2,1,3,2,1,,,,0,0,0,0,,,,0,0,2,2,0,1,0,,,,0,0,0,,,
"Jul 11, 2023 2:00 AM",4,3,1,0,0,0,0,0,0,0,0,0,,,,0,0,0,0,,,,0,3,0,0,0,0,0,,,,0,0,0,,,
"Jul 11, 2023 3:00 AM",0,0,0,0,0,0,0,0,0,0,0,0,,,,0,0,0,0,,,,0,0,0,0,0,0,0,,,,0,0,0,,,
"Jul 11, 2023 4:00 AM",1,0,1,0,0,0,0,0,0,0,0,0,,,,0,0,0,0,,,,0,0,0,0,0,3,0,,,,0,0,0,,,
"Jul 11, 2023 5:00 AM",8,7,1,3,1,2,3,2,1,3,2,1,,,,3,7,7,0,,,,7,0,1,1,0,7,1,,,,1,1,0,,,
"Jul 11, 2023 6:00 AM",45,30,15,19,7,12,31,10,21,18,7,11,,,,7,24,24,0,,,,24,14,7,3,4,29,0,,,,1,1,0,,,
"Jul 11, 2023 7:00 AM",134,91,43,58,19,39,70,27,43,57,19,38,,,,12,65,64,1,,,,64,40,42,17,25,110,5,,,,8,6,2,,,
"Jul 11, 2023 8:00 AM",218,172,46,61,13,48,113,37,76,76,33,43,,,,24,147,146,1,,,,140,50,65,18,47,187,3,,,,10,7,3,,,
"Jul 11, 2023 9:00 AM",121,100,21,67,25,42,83,34,49,64,34,30,,,,16,64,61,3,,,,52,22,50,17,33,85,1,,,,6,4,2,,,
"Jul 11, 2023 10:00 AM",44,33,11,57,33,24,61,35,26,49,32,17,,,,11,28,28,0,,,,23,11,27,18,9,32,3,,,,2,2,0,,,
"Jul 11, 2023 11:00 AM",42,28,14,50,27,23,61,24,37,56,27,29,,,,6,17,15,2,,,,14,12,28,13,15,27,2,,,,4,1,3,,,
"Jul 11, 2023 12:00 PM",58,32,26,56,22,34,36,17,19,40,22,18,,,,15,15,14,1,,,,13,20,20,7,13,16,4,,,,9,4,5,,,
"Jul 11, 2023 1:00 PM",66,34,32,49,21,28,46,20,26,36,15,21,,,,11,18,17,1,,,,17,23,26,15,11,23,2,,,,5,3,2,,,
"Jul 11, 2023 2:00 PM",51,26,25,37,15,22,29,16,13,38,25,13,,,,18,14,12,2,,,,9,22,15,8,7,21,0,,,,5,3,2,,,
"Jul 11, 2023 3:00 PM",72,18,54,40,25,15,62,42,20,46,34,12,,,,17,11,10,1,,,,8,22,38,26,12,19,5,,,,4,3,1,,,
"Jul 11, 2023 4:00 PM",119,33,86,41,23,18,56,34,22,41,20,21,,,,14,25,18,7,,,,14,53,29,25,4,25,7,,,,6,6,0,,,
"Jul 11, 2023 5:00 PM",178,32,146,86,42,44,120,69,51,104,62,42,,,,24,35,31,4,,,,29,121,52,33,19,67,11,,,,5,4,1,,,
"Jul 11, 2023 6:00 PM",203,59,144,85,56,29,138,103,35,97,65,32,,,,19,39,32,7,,,,29,127,78,57,21,34,3,,,,5,4,1,,,
"Jul 11, 2023 7:00 PM",84,25,59,67,46,21,116,68,48,64,41,23,,,,23,18,18,0,,,,16,53,60,43,17,40,5,,,,9,5,4,,,
"Jul 11, 2023 8:00 PM",64,18,46,51,21,30,68,30,38,39,21,18,,,,9,20,15,5,,,,19,25,41,15,26,23,4,,,,6,5,1,,,
"Jul 11, 2023 9:00 PM",50,11,39,49,29,20,47,20,27,33,15,18,,,,10,10,8,2,,,,9,14,25,16,9,12,6,,,,7,6,1,,,
"Jul 11, 2023 10:00 PM",26,9,17,32,27,5,33,15,18,23,8,15,,,,1,11,8,3,,,,8,8,12,7,5,16,1,,,,0,0,0,,,
"Jul 11, 2023 11:00 PM",16,7,9,6,5,1,5,3,2,4,2,2,,,,1,5,5,0,,,,5,3,1,1,0,1,0,,,,0,0,0,,,
"Jul 12, 2023 12:00 AM",6,2,4,0,0,0,0,0,0,1,1,0,,,,1,0,0,0,,,,0,4,2,2,0,1,0,,,,6,3,3,,,
"Jul 12, 2023 1:00 AM",5,1,4,0,0,0,2,2,0,0,0,0,,,,0,1,1,0,,,,1,0,1,1,0,1,0,,,,0,0,0,,,
"Jul 12, 2023 2:00 AM",3,3,0,1,0,1,1,0,1,1,0,1,,,,0,0,0,0,,,,0,0,0,0,0,0,0,,,,0,0,0,,,
"Jul 12, 2023 3:00 AM",0,0,0,0,0,0,0,0,0,0,0,0,,,,0,0,0,0,,,,0,1,0,0,0,0,0,,,,0,0,0,,,
"Jul 12, 2023 4:00 AM",1,0,1,0,0,0,0,0,0,0,0,0,,,,0,2,2,0,,,,2,0,0,0,0,2,0,,,,0,0,0,,,
"Jul 12, 2023 5:00 AM",10,8,2,1,1,0,1,1,0,2,2,0,,,,0,6,5,1,,,,7,3,1,1,0,7,1,,,,1,1,0,,,
"Jul 12, 2023 6:00 AM",41,28,13,20,9,11,17,5,12,12,7,5,,,,5,17,17,0,,,,15,17,6,3,3,37,1,,,,1,1,0,,,
"Jul 12, 2023 7:00 AM",124,84,40,42,11,31,72,27,45,54,19,35,,,,12,79,79,0,,,,75,24,38,12,26,108,1,,,,8,7,1,,,
"Jul 12, 2023 8:00 AM",234,182,52,82,18,64,139,49,90,94,35,59,,,,18,153,150,3,,,,143,54,81,25,56,206,2,,,,9,7,2,,,
"Jul 12, 2023 9:00 AM",125,104,21,46,13,33,82,42,40,52,32,20,,,,2,56,55,1,,,,48,31,42,18,24,70,3,,,,4,2,2,,,
"Jul 12, 2023 10:00 AM",44,30,14,38,21,17,66,35,31,30,19,11,,,,10,17,17,0,,,,17,15,27,14,13,31,3,,,,4,2,2,,,
"Jul 12, 2023 11:00 AM",47,29,18,37,13,24,44,20,24,25,13,12,,,,9,13,13,0,,,,10,16,28,12,16,30,5,,,,4,3,1,,,
"Jul 12, 2023 12:00 PM",47,30,17,45,25,20,56,32,24,46,27,19,,,,17,15,14,1,,,,13,13,30,20,10,24,6,,,,8,6,2,,,
"Jul 12, 2023 1:00 PM",64,31,33,56,31,25,40,19,21,49,31,18,,,,19,14,11,3,,,,11,23,22,13,9,27,5,,,,3,1,2,,,
"Jul 12, 2023 2:00 PM",65,31,34,51,25,26,49,26,23,35,16,19,,,,20,15,13,2,,,,14,25,23,16,7,31,3,,,,6,4,2,,,
"Jul 12, 2023 3:00 PM",69,28,41,60,32,28,58,31,27,53,28,25,,,,14,12,10,2,,,,8,35,29,19,10,26,4,,,,7,5,2,,,
"Jul 12, 2023 4:00 PM",119,37,82,79,44,35,72,41,31,60,33,27,,,,16,26,20,6,,,,19,54,44,25,19,41,6,,,,6,3,3,,,
"Jul 12, 2023 5:00 PM",225,58,167,138,88,50,149,93,56,127,73,54,,,,31,39,34,5,,,,35,115,90,60,30,71,7,,,,9,4,5,,,
"Jul 12, 2023 6:00 PM",196,52,144,121,76,45,196,135,61,133,82,51,,,,16,26,26,0,,,,31,118,86,59,27,53,8,,,,9,7,2,,,
"Jul 12, 2023 7:00 PM",105,30,75,113,68,45,167,98,69,81,49,32,,,,9,25,23,2,,,,17,59,73,52,21,26,8,,,,8,8,0,,,
"Jul 12, 2023 8:00 PM",82,29,53,75,34,41,118,44,74,63,29,34,,,,13,21,19,2,,,,17,37,56,26,30,36,7,,,,3,0,3,,,
"Jul 12, 2023 9:00 PM",50,12,38,41,21,20,52,18,34,31,14,17,,,,3,12,11,1,,,,11,22,26,9,17,30,3,,,,5,5,0,,,
"Jul 12, 2023 10:00 PM",35,7,28,9,6,3,14,9,5,12,8,4,,,,2,9,6,3,,,,5,17,8,4,4,12,1,,,,0,0,0,,,
"Jul 12, 2023 11:00 PM",12,3,9,7,6,1,12,6,6,7,5,2,,,,1,3,3,0,,,,5,6,9,4,5,7,1,,,,2,2,0,,,
"Jul 13, 2023 12:00 AM",4,0,4,0,0,0,3,1,2,4,3,1,,,,0,3,3,0,,,,3,3,4,4,0,9,0,,,,0,0,0,,,
"Jul 13, 2023 1:00 AM",2,0,2,1,1,0,3,3,0,2,2,0,,,,1,0,0,0,,,,0,1,0,0,0,2,0,,,,0,0,0,,,
"Jul 13, 2023 2:00 AM",2,1,1,2,2,0,2,2,0,0,0,0,,,,0,0,0,0,,,,0,1,0,0,0,1,0,,,,0,0,0,,,
"Jul 13, 2023 3:00 AM",1,0,1,0,0,0,0,0,0,0,0,0,,,,0,0,0,0,,,,0,1,0,0,0,0,0,,,,0,0,0,,,
"Jul 13, 2023 4:00 AM",1,0,1,0,0,0,2,2,0,1,1,0,,,,0,2,2,0,,,,2,2,0,0,0,0,0,,,,0,0,0,,,
"Jul 13, 2023 5:00 AM",11,7,4,5,1,4,5,3,2,5,3,2,,,,3,8,7,1,,,,7,3,3,2,1,7,1,,,,0,0,0,,,
"Jul 13, 2023 6:00 AM",50,30,20,22,9,13,17,9,8,19,9,10,,,,7,21,21,0,,,,19,20,13,8,5,33,1,,,,1,1,0,,,
"Jul 13, 2023 7:00 AM",121,79,42,52,19,33,74,24,50,48,17,31,,,,20,87,87,0,,,,85,27,37,16,21,109,2,,,,5,5,0,,,
"Jul 13, 2023 8:00 AM",206,157,49,87,17,70,138,46,92,100,36,64,,,,19,139,138,1,,,,137,55,79,26,53,182,2,,,,8,5,3,,,
"Jul 13, 2023 9:00 AM",106,84,22,69,21,48,105,48,57,70,38,32,,,,8,72,71,1,,,,64,28,45,19,26,77,5,,,,2,1,1,,,
"Jul 13, 2023 10:00 AM",60,47,13,50,21,29,77,47,30,42,23,19,,,,13,27,27,0,,,,22,22,24,15,9,35,1,,,,1,1,0,,,
"Jul 13, 2023 11:00 AM",57,34,23,56,30,26,65,37,28,54,36,18,,,,3,17,16,1,,,,13,13,29,15,14,21,4,,,,3,1,2,,,
"Jul 13, 2023 12:00 PM",65,33,32,71,27,44,73,27,46,62,28,34,,,,3,20,18,2,,,,14,19,36,16,20,19,3,,,,7,3,4,,,
"Jul 13, 2023 1:00 PM",71,37,34,48,24,24,55,24,31,47,20,27,,,,13,17,14,3,,,,13,15,35,12,23,20,4,,,,5,3,2,,,
"Jul 13, 2023 2:00 PM",69,29,40,68,34,34,59,30,29,62,35,27,,,,14,14,13,1,,,,15,19,32,18,14,22,3,,,,7,6,1,,,
"Jul 13, 2023 3:00 PM",83,33,50,59,30,29,63,36,27,47,30,17,,,,22,15,11,4,,,,11,20,39,21,18,19,2,,,,6,2,4,,,
"Jul 13, 2023 4:00 PM",102,34,68,76,48,28,81,48,33,77,55,22,,,,12,16,12,4,,,,12,53,41,30,11,35,2,,,,12,9,3,,,
"Jul 13, 2023 5:00 PM",178,49,129,102,50,52,118,77,41,104,74,30,,,,24,36,32,4,,,,28,112,67,49,18,62,15,,,,8,5,3,,,
"Jul 13, 2023 6:00 PM",173,41,132,93,60,33,128,94,34,91,66,25,,,,28,27,25,2,,,,27,110,72,53,19,42,4,,,,12,6,6,,,
"Jul 13, 2023 7:00 PM",92,22,70,62,38,24,94,59,35,62,37,25,,,,8,27,24,3,,,,21,49,41,34,7,26,0,,,,10,7,3,,,
"Jul 13, 2023 8:00 PM",75,32,43,50,21,29,70,32,38,59,23,36,,,,7,10,7,3,,,,8,28,24,13,11,30,9,,,,8,6,2,,,
"Jul 13, 2023 9:00 PM",50,11,39,42,34,8,58,26,32,41,17,24,,,,4,12,11,1,,,,12,28,19,10,9,28,2,,,,7,4,3,,,
"Jul 13, 2023 10:00 PM",39,10,29,32,30,2,37,14,23,32,14,18,,,,2,8,7,1,,,,6,18,21,13,8,24,1,,,,1,1,0,,,
"Jul 13, 2023 11:00 PM",22,6,16,15,14,1,10,4,6,8,5,3,,,,2,9,8,1,,,,6,5,7,5,2,10,0,,,,7,1,6,,,
"Jul 14, 2023 12:00 AM",8,1,7,0,0,0,2,2,0,2,1,1,,,,1,1,1,0,,,,2,6,4,3,1,1,0,,,,2,1,1,,,
"Jul 14, 2023 1:00 AM",4,0,4,0,0,0,2,2,0,1,1,0,,,,0,1,1,0,,,,1,4,1,1,0,3,0,,,,0,0,0,,,
"Jul 14, 2023 2:00 AM",3,2,1,0,0,0,1,0,1,0,0,0,,,,1,0,0,0,,,,0,2,0,0,0,1,0,,,,0,0,0,,,
"Jul 14, 2023 3:00 AM",3,2,1,0,0,0,2,1,1,1,0,1,,,,1,0,0,0,,,,0,1,1,1,0,0,0,,,,0,0,0,,,
"Jul 14, 2023 4:00 AM",2,0,2,1,1,0,4,3,1,1,1,0,,,,0,0,0,0,,,,0,1,1,0,1,1,0,,,,0,0,0,,,
"Jul 14, 2023 5:00 AM",8,5,3,4,3,1,5,2,3,4,3,1,,,,2,7,7,0,,,,7,4,2,1,1,4,0,,,,0,0,0,,,
"Jul 14, 2023 6:00 AM",41,28,13,2,0,2,7,3,4,4,2,2,,,,3,17,17,0,,,,17,7,3,2,1,24,1,,,,1,1,0,,,
"Jul 14, 2023 7:00 AM",70,43,27,24,13,11,34,16,18,22,14,8,,,,9,48,47,1,,,,44,22,18,7,11,39,2,,,,3,2,1,,,
"Jul 14, 2023 8:00 AM",108,75,33,28,8,20,56,27,29,31,19,12,,,,15,49,48,1,,,,46,38,27,13,14,75,1,,,,5,4,1,,,
"Jul 14, 2023 9:00 AM",52,36,16,17,6,11,26,12,14,21,14,7,,,,6,9,9,0,,,,9,7,11,6,5,26,3,,,,2,1,1,,,
"Jul 14, 2023 10:00 AM",19,12,7,3,1,2,11,7,4,4,2,2,,,,4,4,4,0,,,,2,10,4,1,3,9,0,,,,0,0,0,,,
"Jul 14, 2023 11:00 AM",20,10,10,11,9,2,10,9,1,7,7,0,,,,1,5,4,1,,,,4,5,2,0,2,7,1,,,,0,0,0,,,
"Jul 14, 2023 12:00 PM",24,14,10,2,2,0,3,3,0,2,1,1,,,,2,6,6,0,,,,5,8,5,5,0,8,0,,,,0,0,0,,,
"Jul 14, 2023 1:00 PM",24,9,15,8,4,4,4,1,3,6,2,4,,,,3,4,3,1,,,,3,7,6,4,2,2,0,,,,0,0,0,,,
"Jul 14, 2023 2:00 PM",25,10,15,3,2,1,10,7,3,5,3,2,,,,7,5,4,1,,,,3,7,3,2,1,6,0,,,,0,0,0,,,
"Jul 14, 2023 3:00 PM",40,16,24,3,0,3,9,2,7,6,3,3,,,,4,4,3,1,,,,3,9,11,6,5,13,0,,,,3,2,1,,,
"Jul 14, 2023 4:00 PM",51,13,38,9,6,3,23,13,10,19,9,10,,,,3,11,9,2,,,,8,34,16,12,4,14,0,,,,5,2,3,,,
"Jul 14, 2023 5:00 PM",93,32,61,15,11,4,31,16,15,17,8,9,,,,14,15,13,2,,,,15,32,13,9,4,39,2,,,,6,2,4,,,
"Jul 14, 2023 6:00 PM",75,23,52,25,16,9,32,25,7,27,18,9,,,,19,11,11,0,,,,10,29,25,21,4,10,3,,,,4,4,0,,,
"Jul 14, 2023 7:00 PM",56,23,33,26,18,8,40,28,12,21,15,6,,,,11,12,11,1,,,,13,26,17,9,8,14,1,,,,8,5,3,,,
"Jul 14, 2023 8:00 PM",39,16,23,20,11,9,13,7,6,14,8,6,,,,2,7,6,1,,,,6,11,11,5,6,15,0,,,,1,1,0,,,
"Jul 14, 2023 9:00 PM",29,11,18,17,10,7,12,4,8,10,6,4,,,,2,7,7,0,,,,7,5,10,5,5,7,0,,,,2,1,1,,,
"Jul 14, 2023 10:00 PM",18,3,15,3,0,3,7,3,4,3,0,3,,,,2,4,4,0,,,,4,10,2,2,0,10,1,,,,3,2,1,,,
"Jul 14, 2023 11:00 PM",13,3,10,5,3,2,4,1,3,3,2,1,,,,3,0,0,0,,,,1,2,1,0,1,4,1,,,,2,1,1,,,
"Jul 15, 2023 12:00 AM",7,4,3,1,0,1,2,1,1,3,0,3,,,,0,0,0,0,,,,0,5,2,2,0,4,1,,,,2,1,1,,,
"Jul 15, 2023 1:00 AM",8,4,4,1,1,0,4,3,1,2,1,1,,,,0,3,3,0,,,,3,4,1,1,0,1,1,,,,1,0,1,,,
"Jul 15, 2023 2:00 AM",8,4,4,1,1,0,1,1,0,1,1,0,,,,0,0,0,0,,,,0,1,0,0,0,1,0,,,,0,0,0,,,
"Jul 15, 2023 3:00 AM",1,1,0,0,0,0,0,0,0,0,0,0,,,,0,0,0,0,,,,0,0,0,0,0,2,0,,,,1,1,0,,,
"Jul 15, 2023 4:00 AM",2,0,2,1,1,0,2,2,0,2,2,0,,,,1,1,1,0,,,,1,2,0,0,0,0,0,,,,0,0,0,,,
"Jul 15, 2023 5:00 AM",4,2,2,4,3,1,5,3,2,4,3,1,,,,3,1,1,0,,,,1,2,2,2,0,2,0,,,,1,1,0,,,
"Jul 15, 2023 6:00 AM",10,6,4,10,6,4,11,7,4,9,5,4,,,,2,3,3,0,,,,2,3,7,6,1,9,1,,,,1,1,0,,,
"Jul 15, 2023 7:00 AM",25,11,14,38,24,14,37,26,11,36,28,8,,,,6,2,2,0,,,,3,20,7,4,3,17,1,,,,0,0,0,,,
"Jul 15, 2023 8:00 AM",28,13,15,25,16,9,36,23,13,29,19,10,,,,8,9,9,0,,,,9,12,11,8,3,16,1,,,,5,1,4,,,
"Jul 15, 2023 9:00 AM",13,10,3,42,10,32,51,23,28,32,15,17,,,,5,5,5,0,,,,5,17,14,7,7,10,2,,,,3,1,2,,,
"Jul 15, 2023 10:00 AM",22,9,13,36,22,14,27,15,12,23,10,13,,,,1,9,9,0,,,,7,8,13,9,4,13,3,,,,3,3,0,,,
"Jul 15, 2023 11:00 AM",6,3,3,17,11,6,28,16,12,16,9,7,,,,3,6,5,1,,,,4,5,8,3,5,7,1,,,,6,4,2,,,
"Jul 15, 2023 12:00 PM",20,7,13,26,8,18,21,13,8,14,8,6,,,,1,10,10,0,,,,8,11,9,8,1,9,2,,,,2,2,0,,,
"Jul 15, 2023 1:00 PM",20,10,10,12,10,2,24,9,15,11,8,3,,,,0,2,2,0,,,,3,3,8,4,4,14,4,,,,6,4,2,,,
"Jul 15, 2023 2:00 PM",23,14,9,19,10,9,11,3,8,14,4,10,,,,4,5,3,2,,,,3,4,5,1,4,6,3,,,,2,1,1,,,
"Jul 15, 2023 3:00 PM",18,11,7,32,19,13,21,13,8,16,10,6,,,,4,7,6,1,,,,4,7,9,6,3,6,4,,,,4,3,1,,,
"Jul 15, 2023 4:00 PM",25,15,10,23,11,12,24,15,9,16,10,6,,,,7,10,9,1,,,,9,7,8,6,2,12,2,,,,4,2,2,,,
"Jul 15, 2023 5:00 PM",21,8,13,24,20,4,22,13,9,25,12,13,,,,5,2,2,0,,,,2,9,13,8,5,8,4,,,,6,5,1,,,
"Jul 15, 2023 6:00 PM",22,7,15,21,10,11,25,14,11,28,14,14,,,,9,4,4,0,,,,4,8,7,4,3,19,3,,,,5,3,2,,,
"Jul 15, 2023 7:00 PM",23,15,8,9,5,4,10,4,6,8,5,3,,,,5,4,4,0,,,,6,5,5,1,4,6,2,,,,4,3,1,,,
"Jul 15, 2023 8:00 PM",33,16,17,7,3,4,8,3,5,6,3,3,,,,4,6,6,0,,,,5,5,7,6,1,4,0,,,,2,0,2,,,
"Jul 15, 2023 9:00 PM",14,7,7,4,2,2,5,1,4,5,1,4,,,,3,2,2,0,,,,3,5,2,1,1,8,0,,,,5,3,2,,,
"Jul 15, 2023 10:00 PM",14,7,7,5,2,3,3,0,3,2,0,2,,,,1,3,2,1,,,,2,0,0,0,0,8,1,,,,1,1,0,,,
"Jul 15, 2023 11:00 PM",10,6,4,1,1,0,3,1,2,1,1,0,,,,1,2,2,0,,,,1,1,1,1,0,1,1,,,,1,1,0,,,
"Jul 16, 2023 12:00 AM",5,2,3,2,2,0,2,2,0,2,2,0,,,,1,2,2,0,,,,2,5,4,3,1,3,0,,,,2,1,1,,,
"Jul 16, 2023 1:00 AM",5,0,5,0,0,0,0,0,0,0,0,0,,,,2,0,0,0,,,,0,4,0,0,0,2,0,,,,0,0,0,,,
"Jul 16, 2023 2:00 AM",8,5,3,0,0,0,1,1,0,0,0,0,,,,0,0,0,0,,,,0,1,1,1,0,2,0,,,,0,0,0,,,
"Jul 16, 2023 3:00 AM",4,0,4,0,0,0,1,1,0,0,0,0,,,,0,0,0,0,,,,0,0,1,1,0,1,0,,,,0,0,0,,,
"Jul 16, 2023 4:00 AM",1,0,1,0,0,0,2,0,2,1,0,1,,,,0,1,1,0,,,,1,1,1,1,0,4,0,,,,0,0,0,,,
"Jul 16, 2023 5:00 AM",3,2,1,1,1,0,1,1,0,1,1,0,,,,0,0,0,0,,,,0,2,0,0,0,1,0,,,,0,0,0,,,
"Jul 16, 2023 6:00 AM",8,6,2,7,6,1,5,3,2,6,5,1,,,,2,3,2,1,,,,3,3,0,0,0,5,1,,,,1,1,0,,,
"Jul 16, 2023 7:00 AM",12,8,4,13,8,5,22,13,9,22,15,7,,,,3,6,6,0,,,,6,11,5,3,2,18,1,,,,1,1,0,,,
"Jul 16, 2023 8:00 AM",23,10,13,32,21,11,40,24,16,34,23,11,,,,5,6,6,0,,,,8,14,15,6,9,13,0,,,,3,1,2,,,
"Jul 16, 2023 9:00 AM",30,12,18,59,32,27,62,41,21,52,31,21,,,,7,13,12,1,,,,12,22,23,10,13,14,2,,,,2,2,0,,,
"Jul 16, 2023 10:00 AM",41,30,11,127,69,58,133,70,63,109,58,51,,,,15,25,23,2,,,,21,24,42,28,14,28,7,,,,7,5,2,,,
"Jul 16, 2023 11:00 AM",30,16,14,142,66,76,130,65,65,114,63,51,,,,14,14,14,0,,,,13,26,52,39,13,43,5,,,,6,3,3,,,
"Jul 16, 2023 12:00 PM",42,18,24,92,44,48,130,61,69,112,53,59,,,,7,16,15,1,,,,16,31,50,27,23,31,8,,,,6,6,0,,,
"Jul 16, 2023 1:00 PM",44,27,17,92,45,47,113,56,57,73,32,41,,,,11,20,13,7,,,,14,22,49,24,25,46,7,,,,5,4,1,,,
"Jul 16, 2023 2:00 PM",43,22,21,78,43,35,91,49,42,68,47,21,,,,7,16,15,1,,,,12,18,55,30,25,25,6,,,,5,5,0,,,
"Jul 16, 2023 3:00 PM",41,19,22,121,55,66,99,47,52,88,46,42,,,,26,13,11,2,,,,11,25,38,19,19,21,6,,,,9,7,2,,,
"Jul 16, 2023 4:00 PM",37,20,17,68,21,47,82,30,52,63,20,43,,,,5,5,4,1,,,,3,20,37,16,21,27,2,,,,6,5,1,,,
"Jul 16, 2023 5:00 PM",48,21,27,42,24,18,58,21,37,33,19,14,,,,3,4,3,1,,,,2,13,25,14,11,25,7,,,,3,3,0,,,
"Jul 16, 2023 6:00 PM",39,14,25,27,14,13,29,15,14,25,10,15,,,,13,4,3,1,,,,3,11,17,8,9,16,1,,,,3,0,3,,,
"Jul 16, 2023 7:00 PM",24,11,13,26,14,12,36,17,19,25,15,10,,,,4,10,9,1,,,,7,14,12,4,8,12,2,,,,5,2,3,,,
"Jul 16, 2023 8:00 PM",19,6,13,6,4,2,11,2,9,8,2,6,,,,3,6,5,1,,,,6,7,3,1,2,11,0,,,,1,0,1,,,
"Jul 16, 2023 9:00 PM",14,8,6,5,3,2,11,6,5,10,5,5,,,,1,3,3,0,,,,2,1,5,3,2,8,0,,,,1,1,0,,,
"Jul 16, 2023 10:00 PM",12,4,8,5,5,0,5,3,2,2,1,1,,,,0,7,7,0,,,,7,2,2,2,0,5,0,,,,0,0,0,,,
"Jul 16, 2023 11:00 PM",17,6,11,2,2,0,0,0,0,3,2,1,,,,1,1,1,0,,,,1,3,1,1,0,7,1,,,,2,1,1,,,
"Jul 17, 2023 12:00 AM",4,1,3,0,0,0,1,1,0,1,1,0,,,,1,1,1,0,,,,2,6,0,0,0,6,0,,,,0,0,0,,,
"Jul 17, 2023 1:00 AM",1,0,1,0,0,0,1,1,0,1,0,1,,,,0,0,0,0,,,,1,2,1,1,0,0,0,,,,0,0,0,,,
"Jul 17, 2023 2:00 AM",1,0,1,0,0,0,2,1,1,2,1,1,,,,0,0,0,0,,,,0,3,0,0,0,0,0,,,,0,0,0,,,
"Jul 17, 2023 3:00 AM",1,0,1,1,1,0,0,0,0,0,0,0,,,,0,0,0,0,,,,0,0,0,0,0,0,0,,,,0,0,0,,,
"Jul 17, 2023 4:00 AM",2,1,1,0,0,0,0,0,0,1,1,0,,,,0,1,1,0,,,,1,0,0,0,0,2,0,,,,0,0,0,,,
"Jul 17, 2023 5:00 AM",11,9,2,4,1,3,3,2,1,2,2,0,,,,1,5,5,0,,,,5,4,1,1,0,7,1,,,,0,0,0,,,
"Jul 17, 2023 6:00 AM",45,29,16,19,8,11,24,9,15,16,6,10,,,,5,21,20,1,,,,20,12,7,2,5,31,0,,,,2,1,1,,,
"Jul 17, 2023 7:00 AM",101,67,34,62,24,38,84,32,52,56,25,31,,,,13,84,84,0,,,,82,27,35,11,24,103,4,,,,7,6,1,,,
"Jul 17, 2023 8:00 AM",193,150,43,82,19,63,118,45,73,101,48,53,,,,15,123,121,2,,,,114,57,64,24,40,156,2,,,,8,4,4,,,
"Jul 17, 2023 9:00 AM",94,73,21,37,13,24,78,32,46,55,29,26,,,,3,77,76,1,,,,65,27,33,12,21,76,11,,,,6,5,1,,,
"Jul 17, 2023 10:00 AM",53,41,12,46,22,24,51,31,20,42,31,11,,,,10,26,25,1,,,,22,18,25,15,10,26,1,,,,2,0,2,,,
"Jul 17, 2023 11:00 AM",38,25,13,65,33,32,67,38,29,58,35,23,,,,18,17,15,2,,,,13,13,29,14,15,27,4,,,,6,4,2,,,
"Jul 17, 2023 12:00 PM",48,22,26,39,23,16,70,39,31,49,32,17,,,,12,13,12,1,,,,12,21,28,19,9,23,5,,,,12,9,3,,,
"Jul 17, 2023 1:00 PM",75,37,38,73,33,40,71,31,40,46,20,26,,,,19,15,11,4,,,,10,18,32,11,21,18,3,,,,3,2,1,,,
"Jul 17, 2023 2:00 PM",66,31,35,47,18,29,72,26,46,45,16,29,,,,15,13,11,2,,,,10,17,28,15,13,25,3,,,,7,4,3,,,
"Jul 17, 2023 3:00 PM",83,38,45,45,22,23,64,43,21,51,30,21,,,,20,10,9,1,,,,5,31,37,21,16,21,4,,,,9,6,3,,,
"Jul 17, 2023 4:00 PM",106,25,81,79,44,35,98,56,42,81,45,36,,,,20,19,18,1,,,,20,42,57,34,23,46,4,,,,5,3,2,,,
"Jul 17, 2023 5:00 PM",207,60,147,128,88,40,142,86,56,132,82,50,,,,20,38,32,6,,,,35,114,75,49,26,58,6,,,,8,6,2,,,
"Jul 17, 2023 6:00 PM",166,37,129,118,69,49,151,89,62,118,69,49,,,,18,25,21,4,,,,18,103,67,48,19,42,8,,,,7,5,2,,,
"Jul 17, 2023 7:00 PM",82,29,53,52,25,27,78,38,40,60,28,32,,,,20,18,15,3,,,,12,46,44,29,15,24,2,,,,11,5,6,,,
"Jul 17, 2023 8:00 PM",54,19,35,58,41,17,61,44,17,52,40,12,,,,12,9,7,2,,,,8,28,34,21,13,15,2,,,,6,2,4,,,
"Jul 17, 2023 9:00 PM",32,13,19,32,10,22,42,14,28,30,7,23,,,,7,11,9,2,,,,8,21,12,6,6,26,5,,,,7,4,3,,,
"Jul 17, 2023 10:00 PM",31,9,22,8,5,3,12,5,7,13,8,5,,,,3,5,4,1,,,,3,9,9,3,6,4,0,,,,4,1,3,,,
"Jul 17, 2023 11:00 PM",10,3,7,1,0,1,6,2,4,0,0,0,,,,1,3,3,0,,,,2,1,5,2,3,2,1,,,,4,2,2,,,
"Jul 18, 2023 12:00 AM",5,0,5,0,0,0,2,2,0,4,3,1,,,,1,0,0,0,,,,0,2,2,2,0,2,0,,,,0,0,0,,,
"Jul 18, 2023 1:00 AM",1,0,1,1,1,0,4,2,2,1,1,0,,,,0,0,0,0,,,,0,1,1,1,0,1,0,,,,0,0,0,,,
"Jul 18, 2023 2:00 AM",5,5,0,0,0,0,0,0,0,0,0,0,,,,0,0,0,0,,,,0,0,1,1,0,1,0,,,,0,0,0,,,
"Jul 18, 2023 3:00 AM",0,0,0,0,0,0,1,0,1,0,0,0,,,,0,0,0,0,,,,0,2,1,0,1,0,0,,,,0,0,0,,,
"Jul 18, 2023 4:00 AM",2,0,2,0,0,0,0,0,0,0,0,0,,,,0,1,1,0,,,,1,1,0,0,0,2,0,,,,0,0,0,,,
"Jul 18, 2023 5:00 AM",7,5,2,2,1,1,2,1,1,3,2,1,,,,1,6,6,0,,,,7,2,1,1,0,4,0,,,,0,0,0,,,
"Jul 18, 2023 6:00 AM",42,30,12,7,4,3,18,10,8,13,9,4,,,,4,19,18,1,,,,19,10,4,1,3,23,0,,,,3,2,1,,,
"Jul 18, 2023 7:00 AM",97,66,31,23,6,17,37,9,28,23,7,16,,,,6,48,47,1,,,,45,17,21,6,15,62,3,,,,2,2,0,,,
"Jul 18, 2023 8:00 AM",135,105,30,24,4,20,44,16,28,30,16,14,,,,12,71,71,0,,,,71,35,27,6,21,109,6,,,,6,5,1,,,
"Jul 18, 2023 9:00 AM",63,56,7,12,5,7,19,10,9,20,14,6,,,,5,26,25,1,,,,20,8,9,5,4,38,1,,,,3,1,2,,,
"Jul 18, 2023 10:00 AM",31,22,9,9,4,5,13,4,9,7,4,3,,,,5,23,23,0,,,,18,4,6,3,3,17,1,,,,2,1,1,,,
"Jul 18, 2023 11:00 AM",28,18,10,6,2,4,2,0,2,3,1,2,,,,3,11,11,0,,,,10,2,2,2,0,10,0,,,,0,0,0,,,
"Jul 18, 2023 12:00 PM",26,19,7,6,3,3,9,5,4,3,2,1,,,,7,5,4,1,,,,6,11,6,3,3,9,6,,,,5,3,2,,,
"Jul 18, 2023 1:00 PM",40,26,14,14,8,6,15,9,6,12,8,4,,,,8,11,9,2,,,,7,12,5,4,1,10,3,,,,5,5,0,,,
"Jul 18, 2023 2:00 PM",47,23,24,24,13,11,28,17,11,21,15,6,,,,7,9,9,0,,,,6,21,25,14,11,11,1,,,,3,1,2,,,
"Jul 18, 2023 3:00 PM",44,18,26,30,14,16,44,24,20,29,14,15,,,,16,9,9,0,,,,8,19,18,7,11,23,1,,,,2,1,1,,,
"Jul 18, 2023 4:00 PM",89,29,60,39,16,23,42,18,24,39,22,17,,,,1,22,18,4,,,,17,32,17,12,5,25,4,,,,3,1,2,,,
"Jul 18, 2023 5:00 PM",164,40,124,84,41,43,89,59,30,73,50,23,,,,22,35,27,8,,,,29,75,57,38,19,41,9,,,,10,8,2,,,
"Jul 18, 2023 6:00 PM",132,35,97,79,52,27,94,64,30,75,48,27,,,,16,27,23,4,,,,20,72,53,36,17,28,6,,,,7,4,3,,,
"Jul 18, 2023 7:00 PM",81,29,52,64,33,31,74,42,32,63,31,32,,,,13,13,12,1,,,,11,35,40,29,11,27,2,,,,2,0,2,,,
"Jul 18, 2023 8:00 PM",62,18,44,47,29,18,48,29,19,45,24,21,,,,11,12,11,1,,,,14,24,19,15,4,17,4,,,,4,2,2,,,
"Jul 18, 2023 9:00 PM",37,9,28,32,20,12,43,15,28,23,8,15,,,,4,9,7,2,,,,7,9,14,7,7,24,0,,,,6,3,3,,,
"Jul 18, 2023 10:00 PM",22,4,18,22,14,8,20,7,13,15,6,9,,,,5,7,7,0,,,,6,5,6,2,4,11,1,,,,2,1,1,,,
"Jul 18, 2023 11:00 PM",13,3,10,4,2,2,6,1,5,3,1,2,,,,4,3,2,1,,,,2,7,4,4,0,1,1,,,,1,1,0,,,
"Jul 19, 2023 12:00 AM",4,1,3,0,0,0,3,1,2,0,0,0,,,,0,3,3,0,,,,3,3,2,2,0,3,0,,,,0,0,0,,,
"Jul 19, 2023 1:00 AM",3,0,3,0,0,0,1,1,0,0,0,0,,,,0,0,0,0,,,,0,2,0,0,0,0,0,,,,3,2,1,,,
"Jul 19, 2023 2:00 AM",4,4,0,0,0,0,0,0,0,0,0,0,,,,0,0,0,0,,,,0,0,0,0,0,1,0,,,,1,0,1,,,
"Jul 19, 2023 3:00 AM",3,1,2,0,0,0,0,0,0,0,0,0,,,,0,0,0,0,,,,0,0,0,0,0,0,0,,,,0,0,0,,,
"Jul 19, 2023 4:00 AM",4,2,2,0,0,0,1,1,0,0,0,0,,,,0,1,1,0,,,,1,1,1,1,0,0,0,,,,0,0,0,,,
"Jul 19, 2023 5:00 AM",10,7,3,3,3,0,7,4,3,3,3,0,,,,0,5,5,0,,,,5,3,4,2,2,7,0,,,,0,0,0,,,
"Jul 19, 2023 6:00 AM",57,36,21,20,6,14,24,12,12,21,8,13,,,,3,21,21,0,,,,20,16,8,3,5,32,2,,,,1,1,0,,,
"Jul 19, 2023 7:00 AM",131,90,41,69,25,44,85,22,63,76,28,48,,,,17,82,82,0,,,,79,39,35,12,23,133,6,,,,8,7,1,,,
"Jul 19, 2023 8:00 AM",253,199,54,102,31,71,153,57,96,117,52,65,,,,21,164,159,5,,,,147,71,84,23,61,208,5,,,,8,6,2,,,
"Jul 19, 2023 9:00 AM",114,97,17,55,22,33,72,31,41,62,38,24,,,,7,74,72,2,,,,71,16,44,15,29,80,4,,,,4,2,2,,,
"Jul 19, 2023 10:00 AM",59,40,19,71,36,35,57,32,25,48,26,22,10,8,2,10,32,32,0,,,,27,7,43,22,21,31,7,54,,,4,2,2,,,
"Jul 19, 2023 11:00 AM",34,23,11,62,36,26,81,49,32,55,29,26,0,0,0,12,21,19,2,,,,17,0,37,22,15,25,3,0,,,5,3,2,,,
"Jul 19, 2023 12:00 PM",58,30,28,45,17,28,67,28,39,44,25,19,0,0,0,9,17,17,0,,,,21,0,35,14,21,22,8,0,,,15,9,6,,,
"Jul 19, 2023 1:00 PM",59,20,39,41,24,17,38,22,16,41,23,18,0,0,0,14,16,16,0,,,,14,0,38,21,17,21,5,0,,,4,3,1,,,
"Jul 19, 2023 2:00 PM",41,19,22,56,27,29,61,28,33,32,12,20,0,0,0,11,13,12,1,,,,9,0,36,20,16,17,3,0,,,7,2,5,,,
"Jul 19, 2023 3:00 PM",81,28,53,43,21,22,58,40,18,35,23,12,0,0,0,16,16,15,1,,,,15,27,32,19,13,24,1,0,,,2,1,1,,,
"Jul 19, 2023 4:00 PM",98,27,71,57,32,25,74,43,31,61,37,24,0,0,0,13,21,18,3,,,,22,56,50,32,18,42,4,0,,,5,3,2,,,
"Jul 19, 2023 5:00 PM",206,53,153,95,58,37,122,69,53,92,52,40,0,0,0,44,28,24,4,,,,27,116,62,38,24,70,8,0,,,5,2,3,,,
"Jul 19, 2023 6:00 PM",213,55,158,80,57,23,114,86,28,91,62,29,0,0,0,18,20,18,2,,,,17,110,70,57,13,47,3,0,,,6,5,1,,,
"Jul 19, 2023 7:00 PM",103,25,78,58,37,21,75,55,20,54,36,18,0,0,0,21,15,13,2,,,,11,60,37,34,3,21,3,0,,,5,2,3,,,
"Jul 19, 2023 8:00 PM",72,19,53,41,22,19,44,19,25,41,19,22,0,0,0,3,18,15,3,,,,13,31,18,16,2,30,5,0,,,5,2,3,,,
"Jul 19, 2023 9:00 PM",56,19,37,39,22,17,42,17,25,38,15,23,0,0,0,7,12,11,1,,,,12,18,9,3,6,21,9,0,,,3,3,0,,,
"Jul 19, 2023 10:00 PM",32,11,21,19,7,12,18,2,16,13,0,13,0,0,0,4,9,8,1,,,,9,5,4,3,1,18,0,0,,,4,1,3,,,
"Jul 19, 2023 11:00 PM",12,5,7,5,5,0,4,1,3,5,2,3,0,0,0,2,3,2,1,,,,2,12,1,1,0,6,2,0,,,2,2,0,,,
"Jul 20, 2023 12:00 AM",9,3,6,1,0,1,2,2,0,4,2,2,0,0,0,0,2,2,0,,,,1,2,3,2,1,3,0,0,,,1,0,1,,,
"Jul 20, 2023 1:00 AM",5,0,5,0,0,0,2,0,2,0,0,0,0,0,0,1,0,0,0,,,,0,3,0,0,0,2,0,0,,,1,0,1,,,
"Jul 20, 2023 2:00 AM",6,6,0,0,0,0,0,0,0,0,0,0,0,0,0,0,0,0,0,,,,0,0,0,0,0,2,0,0,,,1,1,0,,,
"Jul 20, 2023 3:00 AM",0,0,0,0,0,0,0,0,0,0,0,0,0,0,0,0,0,0,0,,,,0,2,0,0,0,1,0,0,,,0,0,0,,,
"Jul 20, 2023 4:00 AM",2,1,1,0,0,0,0,0,0,0,0,0,0,0,0,0,0,0,0,,,,0,0,0,0,0,0,0,0,,,0,0,0,,,
"Jul 20, 2023 5:00 AM",8,6,2,2,1,1,4,2,2,3,2,1,0,0,0,2,8,8,0,,,,8,3,1,1,0,5,1,0,,,0,0,0,,,
"Jul 20, 2023 6:00 AM",51,29,22,22,11,11,34,16,18,25,15,10,0,0,0,6,21,21,0,,,,21,18,10,7,3,28,2,0,,,2,1,1,,,
"Jul 20, 2023 7:00 AM",121,77,44,43,14,29,73,19,54,50,19,31,0,0,0,18,63,62,1,,,,58,33,36,10,26,108,3,0,,,10,7,3,,,
"Jul 20, 2023 8:00 AM",236,185,51,88,25,63,120,42,78,98,42,56,0,0,0,18,148,145,3,,,,130,55,59,16,43,189,2,0,,,3,2,1,,,
"Jul 20, 2023 9:00 AM",106,89,17,64,22,42,74,32,42,69,37,32,0,0,0,9,74,73,1,,,,63,27,49,11,38,68,1,0,,,3,2,1,,,
"Jul 20, 2023 10:00 AM",52,38,14,53,20,33,57,28,29,42,23,19,0,0,0,14,22,20,2,,,,20,14,27,12,15,46,5,0,,,7,5,2,,,
"Jul 20, 2023 11:00 AM",38,24,14,44,23,21,54,24,30,37,16,21,0,0,0,10,16,15,1,,,,15,22,22,8,14,21,1,0,,,7,5,2,,,
"Jul 20, 2023 12:00 PM",44,22,22,34,11,23,46,20,26,30,7,23,0,0,0,7,9,9,0,,,,7,10,16,11,5,20,8,0,,,7,2,5,,,
"Jul 20, 2023 1:00 PM",60,28,32,54,29,25,70,43,27,50,31,19,0,0,0,10,13,13,0,,,,10,22,40,29,11,30,8,0,,,7,6,1,,,
"Jul 20, 2023 2:00 PM",50,20,30,40,20,20,73,34,39,44,23,21,0,0,0,17,18,17,1,,,,17,23,46,26,20,25,3,0,,,3,1,2,,,
"Jul 20, 2023 3:00 PM",71,32,39,52,29,23,65,38,27,39,28,11,0,0,0,8,10,10,0,,,,8,29,30,16,14,18,6,0,,,8,4,4,,,
"Jul 20, 2023 4:00 PM",108,29,79,66,28,38,72,45,27,44,30,14,0,0,0,21,27,24,3,,,,22,53,28,20,8,39,8,0,,,5,4,1,,,
"Jul 20, 2023 5:00 PM",204,48,156,121,55,66,124,73,51,108,68,40,0,0,0,26,27,20,7,,,,22,120,64,44,20,62,7,0,,,6,5,1,,,
"Jul 20, 2023 6:00 PM",166,48,118,74,54,20,118,83,35,90,61,29,0,0,0,23,27,23,4,,,,20,107,66,52,14,33,4,0,,,8,4,4,,,
"Jul 20, 2023 7:00 PM",85,24,61,70,47,23,88,67,21,63,45,18,0,0,0,13,16,15,1,,,,14,47,41,32,9,24,3,0,,,6,2,4,,,
"Jul 20, 2023 8:00 PM",60,23,37,26,17,9,43,23,20,36,21,15,0,0,0,2,17,13,4,,,,14,33,18,13,5,18,2,0,,,8,5,3,,,
"Jul 20, 2023 9:00 PM",42,9,33,32,23,9,33,9,24,45,9,36,0,0,0,11,5,5,0,,,,6,18,16,12,4,13,1,0,,,3,0,3,,,
"Jul 20, 2023 10:00 PM",24,6,18,28,23,5,25,5,20,14,1,13,0,0,0,2,11,9,2,,,,7,16,8,5,3,13,0,0,,,1,1,0,,,
"Jul 20, 2023 11:00 PM",12,5,7,5,5,0,12,6,6,6,3,3,0,0,0,2,6,6,0,,,,4,9,4,3,1,10,1,0,,,1,1,0,,,
"Jul 21, 2023 12:00 AM",13,4,9,0,0,0,1,0,1,4,0,4,0,0,0,2,1,1,0,,,,1,2,3,1,2,2,0,0,,,0,0,0,,,
"Jul 21, 2023 1:00 AM",7,1,6,5,4,1,3,1,2,4,2,2,0,0,0,0,3,3,0,,,,3,3,1,1,0,3,0,0,,,0,0,0,,,
"Jul 21, 2023 2:00 AM",5,4,1,2,2,0,0,0,0,0,0,0,0,0,0,0,0,0,0,,,,0,2,0,0,0,0,0,0,,,0,0,0,,,
"Jul 21, 2023 3:00 AM",1,1,0,0,0,0,1,0,1,2,1,1,0,0,0,0,0,0,0,,,,0,0,1,1,0,0,0,0,,,0,0,0,,,
"Jul 21, 2023 4:00 AM",1,0,1,0,0,0,2,1,1,0,0,0,0,0,0,0,0,0,0,,,,0,0,0,0,0,1,0,0,,,0,0,0,,,
"Jul 21, 2023 5:00 AM",7,5,2,1,0,1,6,4,2,2,1,1,0,0,0,2,7,7,0,,,,8,2,1,1,0,6,0,0,,,0,0,0,,,
"Jul 21, 2023 6:00 AM",45,29,16,14,6,8,21,10,11,13,8,5,0,0,0,1,14,13,1,,,,11,13,8,5,3,31,2,0,,,3,2,1,,,
"Jul 21, 2023 7:00 AM",76,42,34,37,14,23,57,21,36,38,17,21,0,0,0,16,42,41,1,,,,43,28,18,5,13,66,2,0,,,5,5,0,,,
"Jul 21, 2023 8:00 AM",137,100,37,73,23,50,91,35,56,73,35,38,0,0,0,21,72,69,3,,,,66,43,53,16,37,85,6,0,,,9,8,1,,,
"Jul 21, 2023 9:00 AM",85,66,19,59,27,32,77,43,34,65,38,27,0,0,0,3,36,36,0,,,,29,22,29,14,15,47,2,0,,,6,5,1,,,
"Jul 21, 2023 10:00 AM",50,30,20,46,22,24,40,20,20,45,26,19,0,0,0,5,30,28,2,,,,19,16,21,7,14,23,2,0,,,6,3,3,,,
"Jul 21, 2023 11:00 AM",44,28,16,71,34,37,57,38,19,57,37,20,0,0,0,14,14,13,1,,,,15,23,14,5,9,17,2,0,,,5,3,2,,,
"Jul 21, 2023 12:00 PM",51,18,33,62,29,33,72,35,37,56,30,26,0,0,0,9,17,15,2,,,,13,19,17,10,7,20,6,0,,,11,6,5,,,
"Jul 21, 2023 1:00 PM",75,32,43,59,29,30,71,48,23,53,24,29,0,0,0,8,13,10,3,,,,12,25,24,15,9,26,6,0,,,8,7,1,,,
"Jul 21, 2023 2:00 PM",58,31,27,54,29,25,71,38,33,44,23,21,0,0,0,14,18,16,2,,,,13,27,44,26,18,29,3,0,,,8,6,2,,,
"Jul 21, 2023 3:00 PM",79,28,51,59,30,29,102,50,52,52,25,27,0,0,0,24,18,15,3,,,,17,36,43,26,17,36,2,0,,,4,3,1,,,
"Jul 21, 2023 4:00 PM",92,32,60,68,41,27,81,47,34,79,48,31,0,0,0,14,23,22,1,,,,19,39,40,21,19,43,7,0,,,7,3,4,,,
"Jul 21, 2023 5:00 PM",138,47,91,51,33,18,62,35,27,55,30,25,0,0,0,16,17,15,2,,,,15,62,30,21,9,33,5,0,,,4,1,3,,,
"Jul 21, 2023 6:00 PM",89,28,61,44,25,19,71,46,25,47,30,17,0,0,0,13,13,9,4,,,,8,53,22,20,2,25,2,0,,,4,1,3,,,
"Jul 21, 2023 7:00 PM",57,14,43,27,21,6,29,13,16,29,15,14,0,0,0,9,6,6,0,,,,6,15,8,6,2,10,3,0,,,6,3,3,,,
"Jul 21, 2023 8:00 PM",39,16,23,11,8,3,15,10,5,7,3,4,0,0,0,3,3,3,0,,,,3,16,11,8,3,12,3,0,,,0,0,0,,,
"Jul 21, 2023 9:00 PM",33,13,20,12,9,3,12,4,8,13,6,7,0,0,0,4,11,10,1,,,,9,3,9,8,1,7,2,0,,,1,1,0,,,
"Jul 21, 2023 10:00 PM",28,12,16,3,1,2,4,3,1,5,3,2,0,0,0,3,7,6,1,,,,6,7,1,1,0,6,3,0,,,7,6,1,,,
"Jul 21, 2023 11:00 PM",23,8,15,3,2,1,14,11,3,7,5,2,0,0,0,2,6,6,0,,,,5,5,5,2,3,4,0,0,,,3,3,0,,,
"Jul 22, 2023 12:00 AM",7,1,6,0,0,0,2,2,0,5,3,2,0,0,0,0,1,1,0,,,,1,2,4,3,1,7,1,0,,,1,1,0,,,
"Jul 22, 2023 1:00 AM",9,4,5,1,1,0,4,3,1,0,0,0,0,0,0,0,0,0,0,,,,0,4,1,1,0,4,0,0,,,0,0,0,,,
"Jul 22, 2023 2:00 AM",7,3,4,0,0,0,0,0,0,0,0,0,0,0,0,0,1,1,0,,,,0,1,1,1,0,6,0,0,,,0,0,0,,,
"Jul 22, 2023 3:00 AM",2,1,1,4,2,2,1,0,1,0,0,0,0,0,0,0,0,0,0,,,,0,1,0,0,0,2,0,0,,,0,0,0,,,
"Jul 22, 2023 4:00 AM",2,0,2,0,0,0,1,0,1,1,0,1,0,0,0,0,2,2,0,,,,2,0,0,0,0,0,0,0,,,0,0,0,,,
"Jul 22, 2023 5:00 AM",5,2,3,0,0,0,1,0,1,1,0,1,0,0,0,1,0,0,0,,,,0,2,0,0,0,2,0,0,,,0,0,0,,,
"Jul 22, 2023 6:00 AM",10,7,3,3,3,0,4,3,1,2,1,1,0,0,0,2,1,1,0,,,,0,2,2,2,0,1,2,0,,,0,0,0,,,
"Jul 22, 2023 7:00 AM",15,8,7,14,7,7,19,11,8,15,10,5,0,0,0,2,3,3,0,,,,3,4,5,3,2,13,0,0,,,1,1,0,,,
"Jul 22, 2023 8:00 AM",20,9,11,31,18,13,30,21,9,27,21,6,0,0,0,8,17,17,0,,,,15,14,9,5,4,13,0,0,,,1,1,0,,,
"Jul 22, 2023 9:00 AM",32,18,14,54,30,24,47,30,17,47,30,17,0,0,0,7,14,14,0,,,,15,23,13,10,3,17,0,0,,,0,0,0,,,
"Jul 22, 2023 10:00 AM",30,16,14,140,71,69,141,87,54,150,83,67,0,0,0,17,13,13,0,,,,14,65,35,20,15,77,4,0,,,3,2,1,,,
"Jul 22, 2023 11:00 AM",39,17,22,82,41,41,70,41,29,66,44,22,0,0,0,14,7,6,1,,,,5,25,30,19,11,27,5,0,,,7,6,1,,,
"Jul 22, 2023 12:00 PM",36,22,14,65,29,36,70,43,27,58,32,26,0,0,0,17,15,14,1,,,,14,27,31,23,8,25,5,0,,,4,4,0,,,
"Jul 22, 2023 1:00 PM",33,17,16,65,32,33,71,34,37,60,34,26,0,0,0,9,10,9,1,,,,6,16,25,15,10,19,4,0,,,2,1,1,,,
"Jul 22, 2023 2:00 PM",47,25,22,65,33,32,64,29,35,43,17,26,0,0,0,22,13,13,0,,,,12,17,19,7,12,13,5,0,,,2,2,0,,,
"Jul 22, 2023 3:00 PM",52,24,28,62,36,26,65,38,27,46,25,21,0,0,0,23,16,15,1,,,,12,22,40,25,15,24,7,0,,,7,5,2,,,
"Jul 22, 2023 4:00 PM",55,25,30,79,45,34,83,45,38,69,37,32,0,0,0,15,9,8,1,,,,7,26,41,20,21,32,1,0,,,6,4,2,,,
"Jul 22, 2023 5:00 PM",37,16,21,52,20,32,65,21,44,36,12,24,0,0,0,5,4,3,1,,,,3,16,21,7,14,19,2,0,,,7,3,4,,,
"Jul 22, 2023 6:00 PM",19,6,13,22,11,11,28,7,21,23,4,19,0,0,0,8,8,8,0,,,,8,10,4,0,4,24,2,0,,,6,3,3,,,
"Jul 22, 2023 7:00 PM",25,11,14,9,8,1,14,6,8,6,3,3,0,0,0,6,2,2,0,,,,2,6,7,6,1,11,1,0,,,2,1,1,,,
"Jul 22, 2023 8:00 PM",13,7,6,5,3,2,4,2,2,2,1,1,0,0,0,1,4,4,0,,,,5,4,2,1,1,6,0,0,,,0,0,0,,,
"Jul 22, 2023 9:00 PM",6,0,6,2,0,2,0,0,0,0,0,0,0,0,0,1,5,5,0,,,,5,4,4,1,3,5,0,0,,,1,0,1,,,
"Jul 22, 2023 10:00 PM",5,3,2,3,3,0,4,1,3,4,1,3,0,0,0,2,3,3,0,,,,3,2,0,0,0,2,1,0,,,3,1,2,,,
"Jul 22, 2023 11:00 PM",5,0,5,1,0,1,6,4,2,2,0,2,0,0,0,0,6,6,0,,,,6,5,1,1,0,5,1,0,,,2,2,0,,,
"Jul 23, 2023 12:00 AM",3,0,3,0,0,0,1,1,0,7,5,2,0,0,0,0,4,4,0,,,,3,5,0,0,0,1,0,0,,,0,0,0,,,
"Jul 23, 2023 1:00 AM",4,1,3,0,0,0,1,1,0,0,0,0,0,0,0,0,0,0,0,,,,0,2,0,0,0,8,0,0,,,0,0,0,,,
"Jul 23, 2023 2:00 AM",3,1,2,0,0,0,0,0,0,1,1,0,0,0,0,0,0,0,0,,,,0,1,0,0,0,0,0,0,,,0,0,0,,,
"Jul 23, 2023 3:00 AM",2,0,2,0,0,0,0,0,0,0,0,0,0,0,0,1,0,0,0,,,,0,2,0,0,0,0,0,0,,,0,0,0,,,
"Jul 23, 2023 4:00 AM",0,0,0,0,0,0,0,0,0,0,0,0,0,0,0,0,0,0,0,,,,0,0,0,0,0,0,0,0,,,0,0,0,,,
"Jul 23, 2023 5:00 AM",2,1,1,1,0,1,1,1,0,0,0,0,0,0,0,0,1,1,0,,,,2,4,0,0,0,1,0,0,,,0,0,0,,,
"Jul 23, 2023 6:00 AM",7,4,3,7,4,3,8,5,3,5,3,2,0,0,0,1,5,5,0,,,,2,2,0,0,0,4,0,0,,,0,0,0,,,
"Jul 23, 2023 7:00 AM",13,9,4,11,7,4,13,9,4,11,8,3,0,0,0,3,4,4,0,,,,5,5,0,0,0,11,0,0,,,0,0,0,,,
"Jul 23, 2023 8:00 AM",18,9,9,38,20,18,16,8,8,19,11,8,0,0,0,4,8,7,1,,,,9,11,10,5,5,15,1,0,,,1,0,1,,,
"Jul 23, 2023 9:00 AM",18,6,12,55,30,25,41,25,16,42,25,17,0,0,0,3,8,7,1,,,,7,7,14,7,7,11,5,0,,,4,3,1,,,
"Jul 23, 2023 10:00 AM",30,15,15,49,16,33,50,27,23,38,21,17,0,0,0,5,6,6,0,,,,6,15,9,3,6,18,2,0,,,1,1,0,,,
"Jul 23, 2023 11:00 AM",27,11,16,41,26,15,32,17,15,31,19,12,0,0,0,5,7,7,0,,,,7,15,19,7,12,20,3,0,,,4,3,1,,,
"Jul 23, 2023 12:00 PM",26,13,13,34,22,12,38,19,19,27,16,11,0,0,0,5,7,5,2,,,,5,14,6,4,2,11,3,0,,,3,2,1,,,
"Jul 23, 2023 1:00 PM",28,14,14,14,4,10,26,6,20,20,7,13,0,0,0,2,5,5,0,,,,7,8,11,4,7,13,3,0,,,1,1,0,,,
"Jul 23, 2023 2:00 PM",22,12,10,13,7,6,16,7,9,11,6,5,0,0,0,3,5,5,0,,,,4,6,2,0,2,12,1,0,,,5,2,3,,,
"Jul 23, 2023 3:00 PM",21,9,12,13,8,5,21,11,10,14,7,7,0,0,0,1,5,4,1,,,,3,14,2,1,1,14,1,0,,,2,2,0,,,
"Jul 23, 2023 4:00 PM",28,14,14,12,9,3,23,11,12,13,5,8,0,0,0,5,5,5,0,,,,5,9,13,9,4,9,2,0,,,2,1,1,,,
"Jul 23, 2023 5:00 PM",34,15,19,12,7,5,15,6,9,11,4,7,0,0,0,4,6,6,0,,,,5,8,8,5,3,14,2,0,,,1,1,0,,,
"Jul 23, 2023 6:00 PM",28,11,17,15,9,6,11,5,6,11,5,6,0,0,0,5,3,3,0,,,,2,5,11,5,6,10,2,0,,,4,3,1,,,
"Jul 23, 2023 7:00 PM",20,8,12,10,7,3,14,9,5,9,6,3,0,0,0,6,6,6,0,,,,6,8,6,6,0,9,2,0,,,1,1,0,,,
"Jul 23, 2023 8:00 PM",29,14,15,7,4,3,9,6,3,11,6,5,0,0,0,2,3,2,1,,,,3,4,6,2,4,11,1,0,,,8,3,5,,,
"Jul 23, 2023 9:00 PM",14,4,10,5,2,3,6,2,4,10,4,6,0,0,0,4,4,4,0,,,,3,1,3,3,0,8,0,0,,,0,0,0,,,
"Jul 23, 2023 10:00 PM",15,9,6,4,3,1,7,3,4,8,3,5,0,0,0,1,8,7,1,,,,8,6,3,2,1,5,0,0,,,0,0,0,,,
"Jul 23, 2023 11:00 PM",9,5,4,5,5,0,5,4,1,5,4,1,0,0,0,1,5,5,0,,,,5,5,2,2,0,1,2,0,,,1,1,0,,,
"Jul 24, 2023 12:00 AM",2,1,1,0,0,0,0,0,0,6,6,0,0,0,0,0,2,2,0,,,,3,3,0,0,0,5,0,0,,,0,0,0,,,
"Jul 24, 2023 1:00 AM",4,0,4,1,0,1,0,0,0,0,0,0,0,0,0,0,0,0,0,,,,0,2,0,0,0,0,0,0,,,0,0,0,,,
"Jul 24, 2023 2:00 AM",0,0,0,0,0,0,3,0,3,4,0,4,0,0,0,1,1,0,1,,,,0,0,0,0,0,1,0,0,,,0,0,0,,,
"Jul 24, 2023 3:00 AM",0,0,0,1,1,0,0,0,0,0,0,0,0,0,0,0,0,0,0,,,,0,0,0,0,0,0,0,0,,,0,0,0,,,
"Jul 24, 2023 4:00 AM",1,0,1,0,0,0,0,0,0,0,0,0,0,0,0,0,1,1,0,,,,1,0,1,1,0,0,0,0,,,0,0,0,,,
"Jul 24, 2023 5:00 AM",12,9,3,2,1,1,3,0,3,1,0,1,0,0,0,1,5,5,0,,,,6,4,1,0,1,5,0,0,,,0,0,0,,,
"Jul 24, 2023 6:00 AM",40,28,12,9,2,7,18,5,13,13,3,10,0,0,0,5,24,24,0,,,,22,13,6,0,6,30,2,0,,,2,1,1,,,
"Jul 24, 2023 7:00 AM",109,80,29,50,15,35,68,22,46,44,16,28,0,0,0,9,72,71,1,,,,67,26,26,8,18,88,3,0,,,5,4,1,,,
"Jul 24, 2023 8:00 AM",194,149,45,85,21,64,127,45,82,93,49,44,0,0,0,22,138,137,1,,,,125,52,67,19,48,142,3,0,,,6,4,2,,,
"Jul 24, 2023 9:00 AM",86,60,26,52,28,24,70,33,37,65,44,21,0,0,0,13,55,54,1,,,,45,25,45,19,26,72,6,0,,,9,7,2,,,
"Jul 24, 2023 10:00 AM",42,29,13,55,21,34,67,31,36,48,24,24,0,0,0,15,37,37,0,,,,29,16,21,11,10,34,4,0,,,6,5,1,,,
"Jul 24, 2023 11:00 AM",40,26,14,50,28,22,50,27,23,44,25,19,0,0,0,18,18,17,1,,,,18,11,32,20,12,19,1,0,,,6,5,1,,,
"Jul 24, 2023 12:00 PM",55,33,22,64,33,31,69,31,38,50,21,29,0,0,0,11,6,6,0,,,,8,24,29,11,18,29,3,0,,,7,3,4,,,
"Jul 24, 2023 1:00 PM",54,27,27,55,26,29,62,38,24,50,31,19,0,0,0,14,16,16,0,,,,14,19,24,16,8,20,3,0,,,4,3,1,,,
"Jul 24, 2023 2:00 PM",40,19,21,51,22,29,68,38,30,60,30,30,0,0,0,24,20,19,1,,,,13,22,39,25,14,15,10,0,,,9,6,3,,,
"Jul 24, 2023 3:00 PM",69,26,43,38,19,19,64,35,29,32,16,16,0,0,0,21,26,20,6,,,,20,25,40,23,17,19,3,0,,,7,5,2,,,
"Jul 24, 2023 4:00 PM",96,17,79,60,29,31,88,53,35,61,33,28,0,0,0,15,20,18,2,,,,17,33,37,24,13,29,3,0,,,4,2,2,,,
"Jul 24, 2023 5:00 PM",188,43,145,93,60,33,170,101,69,109,61,48,0,0,0,19,31,21,10,,,,23,111,78,54,24,65,10,0,,,6,4,2,,,
"Jul 24, 2023 6:00 PM",167,49,118,99,73,26,140,91,49,108,68,40,0,0,0,29,27,24,3,,,,22,97,86,59,27,37,3,0,,,3,0,3,,,
"Jul 24, 2023 7:00 PM",86,25,61,76,40,36,100,61,39,55,36,19,0,0,0,14,18,15,3,,,,13,59,65,44,21,28,4,0,,,6,3,3,,,
"Jul 24, 2023 8:00 PM",58,19,39,35,18,17,44,25,19,38,21,17,0,0,0,10,16,13,3,,,,11,26,27,9,18,16,3,0,,,5,4,1,,,
"Jul 24, 2023 9:00 PM",51,16,35,36,13,23,27,6,21,18,4,14,0,0,0,6,11,11,0,,,,9,11,3,2,1,17,1,0,,,3,1,2,,,
"Jul 24, 2023 10:00 PM",29,8,21,10,5,5,18,6,12,14,2,12,0,0,0,4,8,6,2,,,,6,9,9,6,3,7,1,0,,,5,2,3,,,
"Jul 24, 2023 11:00 PM",10,5,5,7,5,2,6,4,2,2,1,1,0,0,0,2,3,3,0,,,,3,9,7,5,2,3,1,0,,,3,1,2,,,
"Jul 25, 2023 12:00 AM",5,2,3,1,1,0,0,0,0,1,1,0,0,0,0,1,3,3,0,,,,3,3,2,2,0,3,2,0,,,5,3,2,,,
"Jul 25, 2023 1:00 AM",0,0,0,0,0,0,2,2,0,0,0,0,0,0,0,2,1,1,0,,,,0,0,1,1,0,3,0,0,,,1,0,1,,,
"Jul 25, 2023 2:00 AM",4,3,1,0,0,0,1,0,1,0,0,0,0,0,0,0,0,0,0,,,,0,1,0,0,0,1,0,0,,,0,0,0,,,
"Jul 25, 2023 3:00 AM",0,0,0,0,0,0,0,0,0,0,0,0,0,0,0,0,0,0,0,,,,0,0,0,0,0,0,0,0,,,0,0,0,,,
"Jul 25, 2023 4:00 AM",1,0,1,0,0,0,0,0,0,0,0,0,0,0,0,0,0,0,0,,,,0,0,0,0,0,3,0,0,,,0,0,0,,,
"Jul 25, 2023 5:00 AM",12,10,2,4,1,3,3,1,2,1,1,0,0,0,0,2,6,6,0,,,,6,4,3,2,1,4,1,0,,,0,0,0,,,
"Jul 25, 2023 6:00 AM",52,38,14,17,5,12,27,9,18,17,6,11,0,0,0,4,25,25,0,,,,26,13,11,5,6,40,1,0,,,2,0,2,,,
"Jul 25, 2023 7:00 AM",123,88,35,56,16,40,72,15,57,59,22,37,0,0,0,13,97,97,0,,,,95,35,42,12,30,121,7,0,,,8,7,1,,,
"Jul 25, 2023 8:00 AM",254,204,50,100,21,79,175,60,115,121,47,74,0,0,0,20,156,156,0,,,,154,47,90,26,64,211,6,0,,,5,5,0,,,
"Jul 25, 2023 9:00 AM",113,101,12,79,29,50,84,32,52,77,45,32,0,0,0,8,78,74,4,,,,70,33,63,21,42,97,4,0,,,11,8,3,,,
"Jul 25, 2023 10:00 AM",45,32,13,55,28,27,72,46,26,64,45,19,0,0,0,12,42,42,0,,,,34,20,47,31,16,31,5,0,,,4,2,2,,,
"Jul 25, 2023 11:00 AM",43,32,11,80,43,37,76,36,40,61,33,28,0,0,0,10,27,25,2,,,,25,14,39,24,15,23,3,0,,,4,3,1,,,
"Jul 25, 2023 12:00 PM",61,33,28,80,40,40,75,35,40,74,36,38,0,0,0,17,18,16,2,,,,16,20,30,14,16,32,1,0,,,5,4,1,,,
"Jul 25, 2023 1:00 PM",57,32,25,74,33,41,64,33,31,58,24,34,0,0,0,9,12,11,1,,,,11,33,25,17,8,34,2,0,,,11,7,4,,,
"Jul 25, 2023 2:00 PM",64,28,36,52,22,30,73,40,33,47,28,19,0,0,0,11,15,13,2,,,,9,32,40,22,18,20,6,0,,,8,7,1,,,
"Jul 25, 2023 3:00 PM",71,22,49,85,37,48,80,41,39,65,33,32,0,0,0,36,25,24,1,,,,21,31,31,21,10,21,4,0,,,5,4,1,,,
"Jul 25, 2023 4:00 PM",117,34,83,66,34,32,109,63,46,78,45,33,0,0,0,14,27,24,3,,,,22,57,55,36,19,37,10,0,,,7,6,1,,,
"Jul 25, 2023 5:00 PM",234,51,183,142,82,60,193,114,79,130,79,51,0,0,0,23,40,33,7,,,,36,139,111,77,34,69,12,0,,,7,6,1,,,
"Jul 25, 2023 6:00 PM",218,51,167,132,93,39,222,161,61,146,103,43,0,0,0,50,38,35,3,,,,31,152,139,102,37,54,6,0,,,14,8,6,,,
"Jul 25, 2023 7:00 PM",114,47,67,105,60,45,157,103,54,94,61,33,0,0,0,40,17,16,1,,,,17,60,65,44,21,41,7,0,,,8,6,2,,,
"Jul 25, 2023 8:00 PM",77,25,52,60,36,24,95,42,53,68,33,35,0,0,0,9,15,12,3,,,,12,33,42,25,17,19,7,0,,,5,2,3,,,
"Jul 25, 2023 9:00 PM",53,15,38,47,29,18,54,20,34,32,13,19,0,0,0,10,9,9,0,,,,7,16,28,11,17,20,3,0,,,5,3,2,,,
"Jul 25, 2023 10:00 PM",34,7,27,29,25,4,31,7,24,28,6,22,0,0,0,6,10,6,4,,,,6,12,7,4,3,16,3,0,,,4,1,3,,,
"Jul 25, 2023 11:00 PM",10,3,7,3,2,1,10,1,9,6,1,5,0,0,0,0,5,3,2,,,,4,6,12,8,4,8,1,0,,,0,0,0,,,
"Jul 26, 2023 12:00 AM",9,4,5,0,0,0,0,0,0,2,0,2,0,0,0,3,2,2,0,,,,1,1,3,3,0,0,0,0,,,0,0,0,,,
"Jul 26, 2023 1:00 AM",3,1,2,1,1,0,0,0,0,0,0,0,0,0,0,0,2,2,0,,,,1,0,0,0,0,3,0,0,,,0,0,0,,,
"Jul 26, 2023 2:00 AM",5,5,0,1,0,1,2,1,1,0,0,0,0,0,0,0,2,1,1,,,,1,3,0,0,0,1,0,0,,,0,0,0,,,
"Jul 26, 2023 3:00 AM",0,0,0,0,0,0,0,0,0,0,0,0,0,0,0,1,0,0,0,,,,0,0,1,0,1,0,0,0,,,0,0,0,,,
"Jul 26, 2023 4:00 AM",3,1,2,0,0,0,0,0,0,0,0,0,0,0,0,0,1,1,0,,,,1,1,1,1,0,3,0,0,,,1,1,0,,,
"Jul 26, 2023 5:00 AM",7,7,0,3,1,2,8,5,3,4,2,2,0,0,0,1,7,7,0,,,,8,2,5,2,3,7,0,0,,,0,0,0,,,
"Jul 26, 2023 6:00 AM",41,25,16,16,3,13,36,14,22,14,2,12,0,0,0,3,17,16,1,,,,18,15,8,5,3,36,1,0,,,3,1,2,,,
"Jul 26, 2023 7:00 AM",112,87,25,67,25,42,94,32,62,62,21,41,0,0,0,13,85,85,0,,,,80,29,42,14,28,103,6,0,,,4,3,1,,,
"Jul 26, 2023 8:00 AM",198,152,46,81,23,58,132,49,83,87,38,49,0,0,0,25,137,135,2,,,,134,42,68,24,44,182,6,0,,,8,8,0,,,
"Jul 26, 2023 9:00 AM",87,70,17,57,22,35,55,29,26,62,38,24,0,0,0,2,34,33,1,,,,33,14,32,9,23,46,2,0,,,1,1,0,,,
"Jul 26, 2023 10:00 AM",24,15,9,17,6,11,30,16,14,13,8,5,0,0,0,4,16,16,0,,,,11,11,19,11,8,13,2,0,,,1,1,0,,,
"Jul 26, 2023 11:00 AM",24,13,11,25,12,13,17,9,8,16,7,9,0,0,0,7,13,12,1,,,,13,8,21,8,13,13,2,0,,,4,1,3,,,
"Jul 26, 2023 12:00 PM",37,26,11,9,7,2,21,13,8,13,10,3,0,0,0,7,11,10,1,,,,8,6,8,7,1,13,6,0,,,4,3,1,,,
"Jul 26, 2023 1:00 PM",43,13,30,28,15,13,30,11,19,27,16,11,0,0,0,4,12,10,2,,,,7,12,18,6,12,12,0,0,,,3,1,2,,,
"Jul 26, 2023 2:00 PM",24,10,14,20,13,7,16,6,10,17,6,11,0,0,0,7,4,3,1,,,,3,15,3,0,3,12,1,0,,,2,0,2,,,
"Jul 26, 2023 3:00 PM",43,16,27,8,4,4,17,14,3,9,6,3,0,0,0,6,5,3,2,,,,3,14,8,7,1,12,1,0,,,5,4,1,,,
"Jul 26, 2023 4:00 PM",69,17,52,9,5,4,18,12,6,18,9,9,0,0,0,4,21,15,6,,,,17,32,16,14,2,17,3,0,,,6,5,1,,,
"Jul 26, 2023 5:00 PM",175,32,143,33,22,11,80,46,34,52,25,27,0,0,0,23,33,28,5,,,,28,87,39,30,9,41,3,0,,,2,0,2,,,
"Jul 26, 2023 6:00 PM",135,36,99,40,31,9,65,52,13,42,32,10,0,0,0,13,21,18,3,,,,17,77,58,47,11,25,4,0,,,5,3,2,,,
"Jul 26, 2023 7:00 PM",78,21,57,38,26,12,43,35,8,30,20,10,0,0,0,14,11,6,5,,,,6,41,22,16,6,13,3,0,,,5,2,3,,,
"Jul 26, 2023 8:00 PM",54,13,41,15,11,4,38,19,19,26,15,11,0,0,0,5,10,10,0,,,,10,25,22,13,9,17,3,0,,,6,3,3,,,
"Jul 26, 2023 9:00 PM",42,14,28,12,8,4,20,8,12,12,4,8,0,0,0,12,10,8,2,,,,9,14,16,9,7,7,8,0,,,4,2,2,,,
"Jul 26, 2023 10:00 PM",22,2,20,9,7,2,15,10,5,16,7,9,0,0,0,1,7,5,2,,,,5,13,9,8,1,10,1,0,,,2,0,2,,,
"Jul 26, 2023 11:00 PM",16,6,10,3,3,0,8,4,4,3,2,1,0,0,0,1,5,3,2,,,,4,10,6,5,1,5,1,0,,,1,1,0,,,
"Jul 27, 2023 12:00 AM",6,0,6,0,0,0,1,1,0,1,1,0,0,0,0,0,1,1,0,,,,1,4,3,0,3,1,0,0,,,1,0,1,,,
"Jul 27, 2023 1:00 AM",3,0,3,0,0,0,0,0,0,0,0,0,0,0,0,0,2,2,0,,,,1,0,0,0,0,0,0,0,,,0,0,0,,,
"Jul 27, 2023 2:00 AM",2,2,0,0,0,0,1,1,0,0,0,0,0,0,0,0,0,0,0,,,,0,0,0,0,0,1,0,0,,,0,0,0,,,
"Jul 27, 2023 3:00 AM",0,0,0,0,0,0,0,0,0,0,0,0,0,0,0,0,0,0,0,,,,0,3,0,0,0,0,0,0,,,0,0,0,,,
"Jul 27, 2023 4:00 AM",3,1,2,0,0,0,0,0,0,1,0,1,0,0,0,0,0,0,0,,,,0,0,0,0,0,2,0,0,,,0,0,0,,,
"Jul 27, 2023 5:00 AM",12,9,3,4,2,2,8,4,4,11,7,4,0,0,0,3,6,6,0,,,,6,2,2,1,1,6,0,0,,,0,0,0,,,
"Jul 27, 2023 6:00 AM",38,25,13,20,9,11,18,7,11,15,6,9,0,0,0,6,21,21,0,,,,22,14,13,9,4,33,0,0,,,1,1,0,,,
"Jul 27, 2023 7:00 AM",118,85,33,59,23,36,89,27,62,60,19,41,0,0,0,13,74,74,0,,,,76,33,38,11,27,108,5,0,,,7,6,1,,,
"Jul 27, 2023 8:00 AM",203,160,43,75,14,61,142,46,96,79,23,56,0,0,0,16,126,124,2,,,,125,57,84,23,61,192,7,0,,,12,10,2,,,
"Jul 27, 2023 9:00 AM",77,59,18,53,20,33,87,41,46,57,33,24,0,0,0,20,61,59,2,,,,53,33,37,12,25,89,2,0,,,2,1,1,,,
"Jul 27, 2023 10:00 AM",32,22,10,61,33,28,73,38,35,51,32,19,0,0,0,12,28,27,1,,,,24,20,38,15,23,36,5,0,,,7,4,3,,,
"Jul 27, 2023 11:00 AM",59,34,25,61,26,35,58,23,35,39,18,21,0,0,0,12,32,30,2,,,,24,11,26,14,12,20,2,0,,,5,4,1,,,
"Jul 27, 2023 12:00 PM",50,21,29,63,34,29,48,20,28,44,22,22,0,0,0,20,23,21,2,,,,15,20,16,7,9,22,3,0,,,4,3,1,,,
"Jul 27, 2023 1:00 PM",55,25,30,66,32,34,42,18,24,41,16,25,0,0,0,14,9,8,1,,,,8,20,23,10,13,25,8,0,,,10,7,3,,,
"Jul 27, 2023 2:00 PM",65,31,34,60,22,38,47,21,26,37,20,17,0,0,0,20,22,21,1,,,,22,19,30,15,15,22,2,0,,,3,2,1,,,
"Jul 27, 2023 3:00 PM",63,27,36,61,27,34,54,29,25,49,32,17,0,0,0,7,12,7,5,,,,6,43,51,33,18,19,4,0,,,6,3,3,,,
"Jul 27, 2023 4:00 PM",103,34,69,59,34,25,73,43,30,60,34,26,0,0,0,11,22,20,2,,,,19,51,39,21,18,46,5,0,,,10,4,6,,,
"Jul 27, 2023 5:00 PM",184,35,149,139,70,69,167,117,50,132,98,34,0,0,0,41,43,33,10,,,,29,121,98,77,21,56,11,0,,,11,8,3,,,
"Jul 27, 2023 6:00 PM",177,52,125,115,67,48,198,134,64,125,85,40,0,0,0,31,27,25,2,,,,20,126,81,59,22,49,4,0,,,7,3,4,,,
"Jul 27, 2023 7:00 PM",105,37,68,85,45,40,158,97,61,87,53,34,0,0,0,8,21,17,4,,,,16,67,75,42,33,40,7,0,,,11,11,0,,,
"Jul 27, 2023 8:00 PM",94,42,52,64,35,29,112,45,67,69,37,32,0,0,0,12,17,17,0,,,,15,35,56,26,30,26,7,0,,,10,8,2,,,
"Jul 27, 2023 9:00 PM",66,25,41,76,46,30,87,27,60,76,23,53,0,0,0,10,8,6,2,,,,6,20,35,16,19,28,11,0,,,6,4,2,,,
"Jul 27, 2023 10:00 PM",43,8,35,32,25,7,37,9,28,33,6,27,0,0,0,4,9,7,2,,,,10,9,23,12,11,28,1,0,,,5,2,3,,,
"Jul 27, 2023 11:00 PM",24,7,17,17,9,8,20,1,19,14,0,14,0,0,0,1,6,6,0,,,,6,3,3,2,1,12,1,0,,,1,1,0,,,
"Jul 28, 2023 12:00 AM",12,2,10,0,0,0,2,2,0,3,1,2,0,0,0,4,3,2,1,,,,2,4,4,3,1,6,0,0,,,2,1,1,,,
"Jul 28, 2023 1:00 AM",8,1,7,0,0,0,1,1,0,0,0,0,0,0,0,0,3,3,0,,,,1,3,0,0,0,1,0,0,,,0,0,0,,,
"Jul 28, 2023 2:00 AM",8,5,3,1,1,0,0,0,0,1,0,1,0,0,0,0,0,0,0,,,,0,3,0,0,0,1,0,0,,,0,0,0,,,
"Jul 28, 2023 3:00 AM",1,0,1,0,0,0,0,0,0,0,0,0,0,0,0,0,0,0,0,,,,0,0,1,1,0,1,0,0,,,1,1,0,,,
"Jul 28, 2023 4:00 AM",1,0,1,1,1,0,3,2,1,2,2,0,0,0,0,0,0,0,0,,,,0,2,0,0,0,3,0,0,,,0,0,0,,,
"Jul 28, 2023 5:00 AM",9,6,3,2,2,0,5,2,3,2,1,1,0,0,0,2,5,5,0,,,,5,3,4,2,2,7,0,0,,,0,0,0,,,
"Jul 28, 2023 6:00 AM",43,29,14,13,4,9,36,19,17,14,3,11,0,0,0,3,17,17,0,,,,16,16,8,5,3,24,0,0,,,1,0,1,,,
"Jul 28, 2023 7:00 AM",68,45,23,56,22,34,80,31,49,49,21,28,0,0,0,9,43,43,0,,,,41,37,28,10,18,77,4,0,,,3,2,1,,,
"Jul 28, 2023 8:00 AM",144,113,31,68,16,52,129,47,82,74,33,41,0,0,0,22,86,86,0,,,,78,37,64,19,45,93,5,0,,,8,6,2,,,
"Jul 28, 2023 9:00 AM",94,63,31,55,25,30,78,42,36,52,29,23,0,0,0,12,49,48,1,,,,44,20,34,13,21,48,3,0,,,7,6,1,,,
"Jul 28, 2023 10:00 AM",56,30,26,50,25,25,71,38,33,48,26,22,0,0,0,15,33,32,1,,,,24,24,27,20,7,28,2,0,,,3,3,0,,,
"Jul 28, 2023 11:00 AM",46,25,21,62,31,31,72,32,40,51,29,22,0,0,0,10,21,20,1,,,,19,8,47,25,22,29,6,0,,,6,4,2,,,
"Jul 28, 2023 12:00 PM",67,30,37,79,43,36,93,53,40,72,46,26,0,0,0,7,21,19,2,,,,12,35,42,21,21,35,6,0,,,5,3,2,,,
"Jul 28, 2023 1:00 PM",91,36,55,70,40,30,66,29,37,56,30,26,0,0,0,16,17,17,0,,,,16,31,33,14,19,31,4,0,,,4,3,1,,,
"Jul 28, 2023 2:00 PM",82,42,40,54,28,26,69,45,24,42,25,17,0,0,0,20,16,13,3,,,,15,27,43,23,20,33,3,0,,,3,3,0,,,
"Jul 28, 2023 3:00 PM",79,40,39,74,38,36,70,43,27,64,48,16,0,0,0,19,17,13,4,,,,11,28,46,32,14,23,6,0,,,6,4,2,,,
"Jul 28, 2023 4:00 PM",96,29,67,103,50,53,105,52,53,93,52,41,0,0,0,22,20,17,3,,,,19,39,51,37,14,33,5,0,,,3,2,1,,,
"Jul 28, 2023 5:00 PM",134,40,94,93,56,37,129,76,53,109,61,48,0,0,0,17,30,25,5,,,,25,65,71,44,27,37,10,0,,,11,6,5,,,
"Jul 28, 2023 6:00 PM",100,36,64,79,41,38,123,70,53,73,42,31,0,0,0,17,23,22,1,,,,21,52,54,41,13,55,4,0,,,14,9,5,,,
"Jul 28, 2023 7:00 PM",94,32,62,56,31,25,86,51,35,50,33,17,0,0,0,13,12,7,5,,,,8,27,30,19,11,27,1,0,,,5,2,3,,,
"Jul 28, 2023 8:00 PM",66,20,46,47,26,21,47,20,27,40,15,25,0,0,0,10,15,13,2,,,,11,14,21,11,10,18,3,0,,,4,3,1,,,
"Jul 28, 2023 9:00 PM",43,14,29,28,12,16,27,9,18,19,8,11,0,0,0,10,6,6,0,,,,5,10,13,9,4,28,1,0,,,3,2,1,,,
"Jul 28, 2023 10:00 PM",36,13,23,19,7,12,15,7,8,15,8,7,0,0,0,2,12,9,3,,,,9,10,2,2,0,13,1,0,,,5,5,0,,,
"Jul 28, 2023 11:00 PM",27,10,17,4,4,0,15,6,9,8,2,6,0,0,0,1,6,5,1,,,,3,5,4,2,2,11,2,0,,,4,2,2,,,
"Jul 29, 2023 12:00 AM",16,5,11,0,0,0,3,1,2,7,1,6,0,0,0,1,3,3,0,,,,4,4,3,2,1,9,1,0,,,1,0,1,,,
"Jul 29, 2023 1:00 AM",8,1,7,5,5,0,0,0,0,0,0,0,0,0,0,0,1,1,0,,,,0,6,0,0,0,0,0,0,,,0,0,0,,,
"Jul 29, 2023 2:00 AM",10,5,5,2,2,0,4,4,0,0,0,0,0,0,0,0,2,2,0,,,,2,4,1,1,0,2,0,0,,,0,0,0,,,
"Jul 29, 2023 3:00 AM",3,1,2,0,0,0,0,0,0,0,0,0,0,0,0,1,0,0,0,,,,1,0,0,0,0,0,1,0,,,0,0,0,,,
"Jul 29, 2023 4:00 AM",2,0,2,1,0,1,3,1,2,1,0,1,0,0,0,0,1,1,0,,,,1,0,0,0,0,0,0,0,,,1,1,0,,,
"Jul 29, 2023 5:00 AM",4,2,2,5,2,3,8,5,3,4,2,2,0,0,0,0,3,3,0,,,,2,2,3,1,2,4,0,0,,,1,1,0,,,
"Jul 29, 2023 6:00 AM",8,3,5,9,7,2,11,9,2,7,5,2,0,0,0,0,6,5,1,,,,5,4,2,2,0,4,0,0,,,0,0,0,,,
"Jul 29, 2023 7:00 AM",27,11,16,30,19,11,41,22,19,28,20,8,0,0,0,6,9,9,0,,,,9,14,8,5,3,12,3,0,,,1,1,0,,,
"Jul 29, 2023 8:00 AM",21,10,11,71,48,23,67,46,21,64,47,17,0,0,0,8,16,14,2,,,,12,23,29,20,9,17,1,0,,,5,3,2,,,
"Jul 29, 2023 9:00 AM",39,24,15,93,54,39,128,93,35,85,64,21,0,0,0,6,23,21,2,,,,18,28,39,27,12,25,2,0,,,2,1,1,,,
"Jul 29, 2023 10:00 AM",50,25,25,123,71,52,161,88,73,121,63,58,0,0,0,19,22,22,0,,,,21,27,75,50,25,35,2,0,,,2,1,1,,,
"Jul 29, 2023 11:00 AM",52,31,21,112,53,59,153,74,79,95,58,37,0,0,0,18,19,18,1,,,,14,27,61,32,29,32,5,0,,,10,10,0,,,
"Jul 29, 2023 12:00 PM",60,37,23,131,43,88,98,49,49,89,43,46,0,0,0,10,12,11,1,,,,11,24,46,25,21,33,6,0,,,9,6,3,,,
"Jul 29, 2023 1:00 PM",47,23,24,80,50,30,86,50,36,82,57,25,0,0,0,14,17,17,0,,,,17,31,57,35,22,20,7,0,,,7,7,0,,,
"Jul 29, 2023 2:00 PM",53,24,29,103,51,52,99,52,47,92,54,38,0,0,0,10,9,8,1,,,,8,18,41,20,21,30,5,0,,,5,3,2,,,
"Jul 29, 2023 3:00 PM",47,20,27,100,52,48,95,46,49,67,43,24,0,0,0,19,11,9,2,,,,7,21,77,42,35,24,7,0,,,10,7,3,,,
"Jul 29, 2023 4:00 PM",38,17,21,93,53,40,108,64,44,79,45,34,0,0,0,18,17,17,0,,,,16,23,60,28,32,26,8,0,,,6,5,1,,,
"Jul 29, 2023 5:00 PM",42,7,35,97,55,42,99,47,52,81,35,46,0,0,0,20,10,7,3,,,,6,30,40,16,24,27,8,0,,,6,5,1,,,
"Jul 29, 2023 6:00 PM",39,21,18,70,31,39,86,39,47,60,22,38,0,0,0,17,17,16,1,,,,17,19,35,8,27,33,4,0,,,4,3,1,,,
"Jul 29, 2023 7:00 PM",33,19,14,50,27,23,49,22,27,40,18,22,0,0,0,9,17,17,0,,,,16,14,17,6,11,20,6,0,,,5,2,3,,,
"Jul 29, 2023 8:00 PM",35,16,19,49,18,31,52,26,26,24,13,11,0,0,0,9,14,13,1,,,,12,10,30,11,19,14,5,0,,,4,0,4,,,
"Jul 29, 2023 9:00 PM",30,10,20,19,15,4,31,11,20,15,10,5,0,0,0,7,11,11,0,,,,10,5,11,8,3,19,0,0,,,2,2,0,,,
"Jul 29, 2023 10:00 PM",24,7,17,9,6,3,20,7,13,13,4,9,0,0,0,12,2,2,0,,,,1,4,5,3,2,8,1,0,,,1,1,0,,,
"Jul 29, 2023 11:00 PM",15,6,9,2,2,0,7,3,4,6,3,3,0,0,0,3,7,6,1,,,,6,7,4,3,1,4,2,0,,,3,3,0,,,
"Jul 30, 2023 12:00 AM",6,3,3,0,0,0,6,5,1,11,8,3,0,0,0,4,4,4,0,,,,4,1,12,8,4,9,0,0,,,2,1,1,,,
"Jul 30, 2023 1:00 AM",3,0,3,9,4,5,6,3,3,4,1,3,0,0,0,1,4,4,0,,,,3,2,2,1,1,4,0,0,,,0,0,0,,,
"Jul 30, 2023 2:00 AM",5,2,3,0,0,0,4,1,3,1,1,0,0,0,0,0,1,1,0,,,,1,2,2,0,2,1,0,0,,,0,0,0,,,
"Jul 30, 2023 3:00 AM",5,2,3,1,1,0,1,1,0,0,0,0,0,0,0,0,0,0,0,,,,0,0,0,0,0,0,0,0,,,1,1,0,,,
"Jul 30, 2023 4:00 AM",1,0,1,3,2,1,3,1,2,3,1,2,0,0,0,0,1,0,1,,,,0,0,0,0,0,1,0,0,,,0,0,0,,,
"Jul 30, 2023 5:00 AM",3,2,1,3,1,2,3,2,1,2,1,1,0,0,0,1,2,2,0,,,,2,2,1,0,1,3,0,0,,,0,0,0,,,
"Jul 30, 2023 6:00 AM",10,7,3,8,7,1,10,9,1,8,8,0,0,0,0,4,3,3,0,,,,1,5,1,1,0,6,0,0,,,1,0,1,,,
"Jul 30, 2023 7:00 AM",15,8,7,25,10,15,35,21,14,27,12,15,0,0,0,4,8,8,0,,,,8,11,6,6,0,16,2,0,,,0,0,0,,,
"Jul 30, 2023 8:00 AM",28,12,16,57,38,19,56,37,19,46,34,12,0,0,0,4,10,9,1,,,,8,18,17,9,8,17,3,0,,,7,3,4,,,
"Jul 30, 2023 9:00 AM",27,17,10,129,70,59,100,68,32,98,67,31,0,0,0,6,14,14,0,,,,11,20,49,33,16,28,3,0,,,5,4,1,,,
"Jul 30, 2023 10:00 AM",46,29,17,119,57,62,130,65,65,86,49,37,0,0,0,3,17,14,3,,,,14,25,52,27,25,39,1,0,,,2,2,0,,,
"Jul 30, 2023 11:00 AM",48,24,24,89,34,55,105,45,60,79,29,50,0,0,0,7,10,8,2,,,,7,21,49,28,21,30,7,0,,,5,4,1,,,
"Jul 30, 2023 12:00 PM",52,27,25,64,22,42,69,30,39,53,31,22,0,0,0,11,9,8,1,,,,8,22,35,18,17,21,5,0,,,3,2,1,,,
"Jul 30, 2023 1:00 PM",39,19,20,63,24,39,53,24,29,51,24,27,0,0,0,9,22,21,1,,,,17,24,25,12,13,22,3,0,,,8,7,1,,,
"Jul 30, 2023 2:00 PM",31,10,21,56,35,21,47,23,24,41,26,15,0,0,0,26,13,12,1,,,,10,13,21,8,13,19,0,0,,,7,4,3,,,
"Jul 30, 2023 3:00 PM",31,13,18,38,22,16,34,12,22,27,5,22,0,0,0,7,7,7,0,,,,5,7,10,7,3,16,5,0,,,1,1,0,,,
"Jul 30, 2023 4:00 PM",38,20,18,27,17,10,34,15,19,21,12,9,0,0,0,5,10,8,2,,,,7,8,12,6,6,13,2,0,,,2,2,0,,,
"Jul 30, 2023 5:00 PM",25,8,17,30,14,16,21,9,12,15,6,9,0,0,0,4,7,7,0,,,,8,5,5,1,4,9,5,0,,,2,1,1,,,
"Jul 30, 2023 6:00 PM",19,7,12,10,3,7,14,7,7,12,4,8,0,0,0,7,7,6,1,,,,6,8,7,4,3,11,2,0,,,5,4,1,,,
"Jul 30, 2023 7:00 PM",25,12,13,17,11,6,18,9,9,15,8,7,0,0,0,2,7,7,0,,,,8,12,12,10,2,7,1,0,,,2,1,1,,,
"Jul 30, 2023 8:00 PM",30,12,18,13,6,7,23,13,10,10,3,7,0,0,0,3,6,6,0,,,,4,10,16,11,5,9,1,0,,,2,1,1,,,
"Jul 30, 2023 9:00 PM",34,12,22,15,4,11,26,16,10,10,6,4,0,0,0,7,6,6,0,,,,6,3,15,5,10,8,1,0,,,3,2,1,,,
"Jul 30, 2023 10:00 PM",13,2,11,11,7,4,9,3,6,6,5,1,0,0,0,3,6,6,0,,,,5,4,8,6,2,6,0,0,,,1,0,1,,,
"Jul 30, 2023 11:00 PM",11,4,7,2,2,0,7,2,5,5,1,4,0,0,0,0,2,2,0,,,,2,5,0,0,0,6,0,0,,,3,3,0,,,
"Jul 31, 2023 12:00 AM",3,0,3,0,0,0,0,0,0,2,0,2,0,0,0,2,1,1,0,,,,1,1,4,3,1,3,0,0,,,0,0,0,,,
"Jul 31, 2023 1:00 AM",4,1,3,3,3,0,1,1,0,0,0,0,0,0,0,0,0,0,0,,,,0,0,2,0,2,1,0,0,,,0,0,0,,,
"Jul 31, 2023 2:00 AM",2,1,1,0,0,0,1,0,1,0,0,0,0,0,0,0,0,0,0,,,,0,0,0,0,0,0,0,0,,,0,0,0,,,
"Jul 31, 2023 3:00 AM",2,0,2,1,1,0,0,0,0,1,0,1,0,0,0,0,0,0,0,,,,1,0,0,0,0,0,0,0,,,0,0,0,,,
"Jul 31, 2023 4:00 AM",2,0,2,0,0,0,0,0,0,0,0,0,0,0,0,0,1,1,0,,,,1,0,0,0,0,0,0,0,,,0,0,0,,,
"Jul 31, 2023 5:00 AM",6,4,2,2,0,2,3,1,2,2,1,1,0,0,0,2,7,7,0,,,,8,2,3,2,1,6,0,0,,,0,0,0,,,
"Jul 31, 2023 6:00 AM",37,24,13,11,4,7,13,5,8,14,5,9,0,0,0,3,16,16,0,,,,13,11,2,1,1,33,2,0,,,3,3,0,,,
"Jul 31, 2023 7:00 AM",106,79,27,40,15,25,43,13,30,38,15,23,0,0,0,15,61,60,1,,,,61,30,18,4,14,85,6,0,,,3,3,0,,,
"Jul 31, 2023 8:00 AM",161,141,20,60,9,51,75,19,56,58,20,38,0,0,0,12,100,99,1,,,,101,31,34,5,29,139,3,0,,,9,6,3,,,
"Jul 31, 2023 9:00 AM",71,56,15,27,10,17,51,23,28,34,19,15,0,0,0,12,34,31,3,,,,26,17,20,6,14,38,2,0,,,5,4,1,,,
"Jul 31, 2023 10:00 AM",35,30,5,17,8,9,28,17,11,18,15,3,0,0,0,6,15,14,1,,,,13,10,12,7,5,16,3,0,,,4,2,2,,,
"Jul 31, 2023 11:00 AM",23,13,10,12,6,6,22,11,11,18,8,10,0,0,0,5,12,11,1,,,,8,5,10,4,6,13,4,0,,,2,1,1,,,
"Jul 31, 2023 12:00 PM",23,11,12,15,7,8,21,10,11,12,10,2,0,0,0,4,8,8,0,,,,8,10,11,5,6,10,1,0,,,2,1,1,,,
"Jul 31, 2023 1:00 PM",43,26,17,25,15,10,18,10,8,12,9,3,0,0,0,1,12,11,1,,,,8,6,9,6,3,11,1,0,,,2,1,1,,,
"Jul 31, 2023 2:00 PM",53,26,27,21,12,9,34,19,15,22,12,10,0,0,0,6,7,7,0,,,,4,16,16,10,6,9,4,0,,,3,2,1,,,
"Jul 31, 2023 3:00 PM",52,16,36,31,20,11,42,27,15,31,17,14,0,0,0,6,14,10,4,,,,9,17,16,10,6,19,0,0,,,5,3,2,,,
"Jul 31, 2023 4:00 PM",63,14,49,49,27,22,41,21,20,33,19,14,0,0,0,9,16,13,3,,,,11,29,16,12,4,30,4,0,,,2,1,1,,,
"Jul 31, 2023 5:00 PM",154,38,116,35,23,12,68,44,24,51,27,24,0,0,0,10,21,19,2,,,,22,94,33,20,13,35,9,0,,,4,3,1,,,
"Jul 31, 2023 6:00 PM",124,26,98,46,39,7,69,51,18,52,36,16,0,0,0,15,15,13,2,,,,16,83,56,49,7,23,3,0,,,7,4,3,,,
"Jul 31, 2023 7:00 PM",70,16,54,32,21,11,52,40,12,31,23,8,0,0,0,11,13,13,0,,,,9,37,27,20,7,12,2,0,,,4,2,2,,,
"Jul 31, 2023 8:00 PM",51,19,32,41,26,15,38,22,16,37,21,16,0,0,0,5,5,3,2,,,,3,23,20,14,6,14,5,0,,,2,2,0,,,
"Jul 31, 2023 9:00 PM",41,16,25,29,10,19,30,9,21,17,6,11,0,0,0,6,9,9,0,,,,8,19,11,6,5,13,1,0,,,6,6,0,,,
"Jul 31, 2023 10:00 PM",18,5,13,9,5,4,12,7,5,14,2,12,0,0,0,3,8,7,1,,,,6,7,8,5,3,10,2,0,,,1,1,0,,,
"Jul 31, 2023 11:00 PM",10,3,7,4,3,1,12,3,9,7,4,3,0,0,0,0,2,1,1,,,,1,3,7,6,1,1,1,0,,,0,0,0,,,
"Aug 1, 2023 12:00 AM",6,1,5,0,0,0,1,1,0,1,1,0,0,0,0,0,2,2,0,,,,2,4,0,0,0,1,0,0,,,1,1,0,,,
"Aug 1, 2023 1:00 AM",3,1,2,0,0,0,1,1,0,1,1,0,0,0,0,0,1,1,0,,,,1,3,0,0,0,1,0,0,,,0,0,0,,,
"Aug 1, 2023 2:00 AM",2,2,0,1,1,0,0,0,0,0,0,0,0,0,0,0,0,0,0,,,,0,1,0,0,0,1,1,0,,,1,1,0,,,
"Aug 1, 2023 3:00 AM",0,0,0,0,0,0,0,0,0,0,0,0,0,0,0,0,0,0,0,,,,0,1,0,0,0,1,0,0,,,0,0,0,,,
"Aug 1, 2023 4:00 AM",2,0,2,1,0,1,1,1,0,0,0,0,0,0,0,0,0,0,0,,,,0,2,0,0,0,1,0,0,,,1,1,0,,,
"Aug 1, 2023 5:00 AM",12,11,1,3,1,2,3,0,3,2,0,2,0,0,0,4,8,8,0,,,,9,2,3,3,0,4,0,0,,,0,0,0,,,
"Aug 1, 2023 6:00 AM",54,32,22,23,12,11,32,18,14,20,12,8,0,0,0,9,18,18,0,,,,18,18,9,5,4,34,2,0,,,3,2,1,,,
"Aug 1, 2023 7:00 AM",137,103,34,60,17,43,85,18,67,71,22,49,0,0,0,10,84,84,0,,,,85,34,47,14,33,125,3,0,,,9,7,2,,,
"Aug 1, 2023 8:00 AM",242,191,51,92,19,73,124,43,81,103,46,57,0,0,0,24,137,134,3,,,,138,60,65,22,43,190,9,0,,,14,10,4,,,
"Aug 1, 2023 9:00 AM",86,73,13,69,27,42,96,42,54,66,35,31,0,0,0,10,62,61,1,,,,55,27,50,19,31,70,5,0,,,11,7,4,,,
"Aug 1, 2023 10:00 AM",62,40,22,59,30,29,76,43,33,59,34,25,0,0,0,11,33,31,2,,,,30,17,31,16,15,42,5,0,,,5,2,3,,,
"Aug 1, 2023 11:00 AM",39,28,11,82,37,45,108,59,49,73,42,31,0,0,0,15,27,27,0,,,,23,23,52,26,26,31,4,0,,,6,3,3,,,
"Aug 1, 2023 12:00 PM",46,29,17,61,30,31,89,45,44,45,28,17,0,0,0,20,18,16,2,,,,15,14,30,21,9,19,1,0,,,4,4,0,,,
"Aug 1, 2023 1:00 PM",60,30,30,66,35,31,80,41,39,44,26,18,0,0,0,9,17,16,1,,,,14,31,41,23,18,20,5,0,,,7,3,4,,,
"Aug 1, 2023 2:00 PM",68,24,44,62,31,31,60,38,22,41,25,16,0,0,0,21,11,10,1,,,,5,25,47,20,27,21,5,0,,,4,2,2,,,
"Aug 1, 2023 3:00 PM",70,35,35,71,34,37,94,45,49,69,35,34,0,0,0,18,13,11,2,,,,10,26,47,20,27,30,2,0,,,10,9,1,,,
"Aug 1, 2023 4:00 PM",107,25,82,65,34,31,90,47,43,53,32,21,0,0,0,20,23,19,4,,,,18,54,44,27,17,36,7,0,,,7,4,3,,,
"Aug 1, 2023 5:00 PM",241,53,188,115,72,43,142,86,56,123,75,48,0,0,0,21,41,36,5,,,,31,133,86,53,33,71,15,0,,,15,11,4,,,
"Aug 1, 2023 6:00 PM",210,53,157,106,68,38,153,100,53,121,76,45,0,0,0,21,38,35,3,,,,33,141,87,56,31,43,6,0,,,12,6,6,,,
"Aug 1, 2023 7:00 PM",106,32,74,62,45,17,96,63,33,73,48,25,0,0,0,13,24,22,2,,,,19,58,39,27,12,28,8,0,,,12,6,6,,,
"Aug 1, 2023 8:00 PM",67,20,47,67,31,36,60,31,29,50,20,30,0,0,0,10,16,16,0,,,,17,30,49,35,14,29,1,0,,,4,1,3,,,
"Aug 1, 2023 9:00 PM",52,15,37,34,21,13,49,15,34,33,12,21,0,0,0,7,6,6,0,,,,5,10,25,12,13,14,4,0,,,3,2,1,,,
"Aug 1, 2023 10:00 PM",26,9,17,21,19,2,18,6,12,16,7,9,0,0,0,3,11,10,1,,,,9,7,23,12,11,15,2,0,,,4,3,1,,,
"Aug 1, 2023 11:00 PM",13,8,5,5,4,1,4,0,4,3,1,2,0,0,0,5,2,2,0,,,,2,3,2,2,0,1,0,0,,,0,0,0,,,
"Aug 2, 2023 12:00 AM",16,3,13,0,0,0,1,1,0,1,1,0,0,0,0,1,0,0,0,0,0,0,0,2,0,0,0,1,0,0,,,5,2,3,,,
"Aug 2, 2023 1:00 AM",2,0,2,0,0,0,1,1,0,0,0,0,0,0,0,0,1,1,0,0,0,0,0,0,1,1,0,0,0,0,,,1,0,1,,,
"Aug 2, 2023 2:00 AM",1,1,0,0,0,0,0,0,0,0,0,0,0,0,0,0,0,0,0,0,0,0,0,0,0,0,0,1,1,0,,,0,0,0,,,
"Aug 2, 2023 3:00 AM",0,0,0,0,0,0,0,0,0,0,0,0,0,0,0,0,0,0,0,0,0,0,0,0,0,0,0,1,0,0,,,0,0,0,,,
"Aug 2, 2023 4:00 AM",4,0,4,0,0,0,2,0,2,0,0,0,0,0,0,0,1,1,0,0,0,0,1,0,0,0,0,3,0,0,,,0,0,0,,,
"Aug 2, 2023 5:00 AM",4,2,2,1,0,1,6,2,4,2,0,2,0,0,0,0,7,7,0,0,0,0,7,0,1,1,0,5,1,0,,,2,2,0,,,
"Aug 2, 2023 6:00 AM",31,25,6,12,4,8,15,5,10,11,5,6,0,0,0,4,13,13,0,0,0,0,10,14,3,1,2,24,1,0,,,1,1,0,,,
"Aug 2, 2023 7:00 AM",99,73,26,28,5,23,37,10,27,26,9,17,0,0,0,9,52,52,0,0,0,0,46,21,14,2,12,77,1,0,,,2,2,0,,,
"Aug 2, 2023 8:00 AM",158,122,36,51,10,41,73,21,52,62,23,39,0,0,0,20,97,96,1,0,0,0,95,42,51,8,43,134,8,0,,,10,9,1,,,
"Aug 2, 2023 9:00 AM",77,70,7,26,8,18,39,14,25,34,20,14,0,0,0,10,44,43,1,0,0,0,38,10,27,10,17,41,1,0,,,4,3,1,,,
"Aug 2, 2023 10:00 AM",28,21,7,6,3,3,17,7,10,10,7,3,0,0,0,3,14,12,2,0,0,0,12,7,21,13,8,11,1,0,,,4,2,2,,,
"Aug 2, 2023 11:00 AM",26,17,9,12,5,7,13,6,7,10,6,4,0,0,0,0,10,8,2,0,0,0,7,6,18,5,13,5,1,0,,,3,2,1,,,
"Aug 2, 2023 12:00 PM",31,19,12,13,8,5,22,14,8,16,10,6,0,0,0,1,5,5,0,2,1,1,6,10,13,9,4,14,2,0,,,2,0,2,,,
"Aug 2, 2023 1:00 PM",21,7,14,16,8,8,17,7,10,17,9,8,0,0,0,1,7,7,0,36,14,22,7,7,9,3,6,9,1,0,,,1,0,1,,,
"Aug 2, 2023 2:00 PM",30,17,13,12,6,6,14,9,5,15,8,7,0,0,0,4,7,7,0,19,9,9,7,11,8,5,3,6,1,0,,,3,3,0,,,
"Aug 2, 2023 3:00 PM",34,12,22,13,10,3,28,16,12,23,14,9,0,0,0,2,7,5,2,32,15,16,5,15,11,8,3,9,0,0,,,2,1,1,,,
"Aug 2, 2023 4:00 PM",63,19,44,16,12,4,17,14,3,21,13,8,0,0,0,7,15,13,2,60,30,30,12,29,14,12,2,19,1,0,,,2,0,2,,,
"Aug 2, 2023 5:00 PM",163,40,123,45,30,15,64,42,22,46,33,13,0,0,0,19,28,24,4,130,63,67,23,65,45,35,10,31,8,0,,,3,2,1,,,
"Aug 2, 2023 6:00 PM",147,31,116,55,39,16,71,53,18,60,44,16,0,0,0,11,19,14,5,118,61,57,16,84,49,36,13,19,3,0,,,4,1,3,,,
"Aug 2, 2023 7:00 PM",79,22,57,32,18,14,43,30,13,37,18,19,0,0,0,11,9,8,1,42,21,21,9,28,27,22,5,22,3,0,,,7,5,2,,,
"Aug 2, 2023 8:00 PM",61,19,42,26,16,10,25,15,10,24,11,13,0,0,0,3,11,9,2,36,18,18,12,23,15,11,4,18,4,0,,,8,6,2,,,
"Aug 2, 2023 9:00 PM",38,13,25,20,16,4,23,10,13,16,10,6,0,0,0,9,9,9,0,16,8,8,8,16,8,4,4,11,4,0,,,6,4,2,,,
"Aug 2, 2023 10:00 PM",23,6,17,5,4,1,12,5,7,12,4,8,0,0,0,2,9,6,3,10,5,5,9,5,6,4,2,6,1,0,,,1,0,1,,,
"Aug 2, 2023 11:00 PM",6,2,4,3,1,2,8,4,4,4,2,2,0,0,0,1,4,4,0,6,3,3,4,5,3,3,0,5,0,0,,,1,0,1,,,
"Aug 3, 2023 12:00 AM",8,4,4,0,0,0,0,0,0,1,1,0,0,0,0,0,1,1,0,6,3,3,0,2,1,1,0,0,0,0,,,0,0,0,,,
"Aug 3, 2023 1:00 AM",5,2,3,0,0,0,1,1,0,1,1,0,0,0,0,0,4,4,0,3,1,2,3,2,2,1,1,1,0,0,,,1,0,1,,,
"Aug 3, 2023 2:00 AM",2,2,0,1,1,0,0,0,0,0,0,0,0,0,0,0,0,0,0,2,1,1,0,0,0,0,0,1,0,0,,,0,0,0,,,
"Aug 3, 2023 3:00 AM",0,0,0,0,0,0,1,0,1,1,0,1,0,0,0,0,0,0,0,0,0,0,0,1,0,0,0,2,0,0,,,1,0,1,,,
"Aug 3, 2023 4:00 AM",3,0,3,0,0,0,0,0,0,0,0,0,0,0,0,0,0,0,0,0,0,0,0,0,0,0,0,1,0,0,,,0,0,0,,,
"Aug 3, 2023 5:00 AM",11,9,2,1,0,1,3,1,2,3,1,2,0,0,0,3,7,7,0,3,1,1,7,2,0,0,0,9,1,0,,,1,1,0,,,
"Aug 3, 2023 6:00 AM",45,30,15,20,12,8,27,14,13,18,11,7,0,0,0,10,17,17,0,7,4,3,16,17,8,3,5,23,1,0,,,1,1,0,,,
"Aug 3, 2023 7:00 AM",113,85,28,55,20,35,63,24,39,59,27,32,0,0,0,16,52,52,0,22,11,11,55,32,23,8,15,87,3,0,,,7,6,1,,,
"Aug 3, 2023 8:00 AM",174,145,29,78,16,62,105,32,73,85,33,52,0,0,0,19,118,116,2,26,12,13,112,52,52,11,41,168,7,0,,,11,7,4,,,
"Aug 3, 2023 9:00 AM",109,88,21,59,24,35,67,28,39,58,29,29,0,0,0,11,52,52,0,14,7,7,44,14,29,13,16,63,3,0,,,3,1,2,,,
"Aug 3, 2023 10:00 AM",48,38,10,86,53,33,54,30,24,47,35,12,0,0,0,16,26,26,0,14,7,7,24,18,12,5,7,29,3,0,,,8,5,3,,,
"Aug 3, 2023 11:00 AM",40,26,14,44,21,23,41,20,21,32,16,16,0,0,0,10,21,20,1,17,8,9,20,14,27,13,14,29,2,0,,,5,5,0,,,
"Aug 3, 2023 12:00 PM",46,18,28,45,13,32,63,24,39,33,8,25,0,0,0,15,19,16,3,17,8,8,13,18,21,15,6,20,4,0,,,3,3,0,,,
"Aug 3, 2023 1:00 PM",62,42,20,47,24,23,50,22,28,39,18,21,0,0,0,8,19,16,3,15,7,8,13,23,21,11,10,24,4,0,,,4,3,1,,,
"Aug 3, 2023 2:00 PM",61,32,29,53,30,23,66,41,25,35,23,12,0,0,0,7,10,8,2,48,23,22,10,21,33,21,12,21,2,0,,,5,2,3,,,
"Aug 3, 2023 3:00 PM",47,17,30,49,24,25,53,30,23,38,23,15,0,0,0,18,15,11,4,48,23,25,11,23,37,24,13,27,8,0,,,9,6,3,,,
"Aug 3, 2023 4:00 PM",94,28,66,62,37,25,55,41,14,50,35,15,0,0,0,21,13,13,0,76,36,39,14,47,42,29,13,32,4,0,,,5,4,1,,,
"Aug 3, 2023 5:00 PM",186,51,135,105,60,45,142,83,59,123,74,49,0,0,0,23,27,23,4,146,72,74,25,93,88,53,35,57,18,0,,,13,8,5,,,
"Aug 3, 2023 6:00 PM",170,39,131,103,66,37,125,83,42,104,76,28,0,0,0,28,26,22,4,145,71,74,23,103,59,47,12,38,7,0,,,7,2,5,,,
"Aug 3, 2023 7:00 PM",86,29,57,45,28,17,75,44,31,67,35,32,0,0,0,10,23,21,2,54,25,29,21,43,39,24,15,24,5,0,,,6,4,2,,,
"Aug 3, 2023 8:00 PM",72,25,47,53,28,25,61,31,30,48,25,23,0,0,0,7,13,11,2,38,19,18,9,21,36,22,14,22,3,0,,,5,4,1,,,
"Aug 3, 2023 9:00 PM",42,12,30,35,25,10,29,8,21,25,6,19,0,0,0,7,8,6,2,14,7,7,6,9,14,6,8,18,3,0,,,8,3,5,,,
"Aug 3, 2023 10:00 PM",34,11,23,7,4,3,14,7,7,12,5,7,0,0,0,1,6,4,2,14,7,7,3,10,5,4,1,8,1,0,,,2,1,1,,,
"Aug 3, 2023 11:00 PM",12,3,9,10,10,0,5,4,1,5,5,0,0,0,0,2,2,2,0,11,6,5,3,3,6,4,2,3,2,0,,,1,0,1,,,
"Aug 4, 2023 12:00 AM",12,2,10,0,0,0,1,1,0,3,2,1,0,0,0,3,1,1,0,1,0,1,1,5,2,1,1,5,0,0,,,2,1,1,,,
"Aug 4, 2023 1:00 AM",7,3,4,2,2,0,0,0,0,1,1,0,0,0,0,0,0,0,0,0,0,0,0,4,0,0,0,1,0,0,,,0,0,0,,,
"Aug 4, 2023 2:00 AM",3,2,1,1,1,0,1,1,0,1,1,0,0,0,0,0,1,1,0,0,0,0,2,1,0,0,0,1,0,0,,,0,0,0,,,
"Aug 4, 2023 3:00 AM",0,0,0,1,0,1,4,0,4,1,0,1,0,0,0,0,0,0,0,0,0,0,0,0,2,0,2,0,0,0,,,0,0,0,,,
"Aug 4, 2023 4:00 AM",6,2,4,0,0,0,2,2,0,0,0,0,0,0,0,0,0,0,0,1,0,0,0,1,0,0,0,1,0,0,,,0,0,0,,,
"Aug 4, 2023 5:00 AM",8,6,2,4,3,1,4,4,0,4,3,1,0,0,0,1,7,7,0,1,0,0,7,4,1,1,0,3,0,0,,,0,0,0,,,
"Aug 4, 2023 6:00 AM",42,26,16,15,10,5,27,14,13,20,10,10,0,0,0,3,6,6,0,10,5,5,6,17,10,6,4,25,0,0,,,0,0,0,,,
"Aug 4, 2023 7:00 AM",74,53,21,60,29,31,62,27,35,56,25,31,0,0,0,13,47,47,0,21,10,11,40,19,23,9,14,55,4,0,,,8,7,1,,,
"Aug 4, 2023 8:00 AM",128,95,33,81,19,62,89,40,49,68,31,37,0,0,0,11,65,64,1,13,6,7,65,38,37,17,20,99,10,0,,,10,10,0,,,
"Aug 4, 2023 9:00 AM",63,49,14,64,30,34,63,29,34,69,33,36,0,0,0,16,36,35,1,5,2,3,28,21,34,15,19,42,3,0,,,4,3,1,,,
"Aug 4, 2023 10:00 AM",44,31,13,56,33,23,73,51,22,44,34,10,0,0,0,11,24,24,0,7,3,3,17,22,30,18,12,26,3,0,,,6,5,1,,,
"Aug 4, 2023 11:00 AM",46,28,18,77,33,44,79,40,39,63,29,34,0,0,0,19,11,10,1,12,6,6,10,18,47,29,18,29,6,0,,,9,7,2,,,
"Aug 4, 2023 12:00 PM",58,33,25,82,36,46,114,57,57,65,28,37,0,0,0,19,15,13,2,40,20,20,12,29,33,16,17,31,4,0,,,5,4,1,,,
"Aug 4, 2023 1:00 PM",80,33,47,62,32,30,86,35,51,58,29,29,0,0,0,14,16,15,1,24,12,12,14,17,29,17,12,29,6,0,,,1,1,0,,,
"Aug 4, 2023 2:00 PM",56,27,29,57,31,26,56,32,24,31,18,13,0,0,0,18,10,9,1,32,16,16,7,27,30,19,11,27,5,0,,,5,4,1,,,
"Aug 4, 2023 3:00 PM",76,30,46,76,36,40,92,51,41,70,38,32,0,0,0,13,14,13,1,26,13,13,13,25,48,25,23,32,2,0,,,7,5,2,,,
"Aug 4, 2023 4:00 PM",87,24,63,72,40,32,96,48,48,69,36,33,0,0,0,15,17,13,4,57,28,29,15,40,42,29,13,34,6,0,,,5,3,2,,,
"Aug 4, 2023 5:00 PM",112,32,80,91,62,29,103,56,47,99,61,38,0,0,0,19,25,22,3,112,55,57,21,67,51,28,23,36,6,0,,,8,5,3,,,
"Aug 4, 2023 6:00 PM",90,25,65,61,30,31,79,40,39,59,26,33,0,0,0,11,20,16,4,70,34,35,21,52,37,23,14,28,5,0,,,3,2,1,,,
"Aug 4, 2023 7:00 PM",74,30,44,42,24,18,44,28,16,30,20,10,0,0,0,7,11,10,1,35,17,18,10,25,27,22,5,22,2,0,,,5,3,2,,,
"Aug 4, 2023 8:00 PM",56,16,40,23,13,10,22,9,13,17,6,11,0,0,0,9,3,3,0,15,7,8,2,16,9,5,4,17,2,0,,,0,0,0,,,
"Aug 4, 2023 9:00 PM",34,16,18,10,8,2,11,7,4,6,4,2,0,0,0,8,10,9,1,14,7,7,9,13,5,3,2,10,2,0,,,3,1,2,,,
"Aug 4, 2023 10:00 PM",20,8,12,10,5,5,7,4,3,7,5,2,0,0,0,4,7,4,3,13,6,7,5,5,0,0,0,4,2,0,,,4,3,1,,,
"Aug 4, 2023 11:00 PM",9,4,5,4,3,1,6,2,4,3,2,1,0,0,0,0,3,3,0,2,1,1,2,4,0,0,0,7,1,0,,,2,2,0,,,
"Aug 5, 2023 12:00 AM",11,3,8,0,0,0,1,1,0,0,0,0,0,0,0,2,1,1,0,4,2,1,1,3,2,1,1,5,1,0,,,1,1,0,,,
"Aug 5, 2023 1:00 AM",3,0,3,0,0,0,3,3,0,1,1,0,0,0,0,0,2,2,0,8,4,4,1,1,0,0,0,2,0,0,,,0,0,0,,,
"Aug 5, 2023 2:00 AM",4,2,2,0,0,0,0,0,0,0,0,0,0,0,0,0,1,0,1,0,0,0,0,1,0,0,0,1,0,0,,,0,0,0,,,
"Aug 5, 2023 3:00 AM",3,1,2,1,1,0,0,0,0,0,0,0,0,0,0,0,0,0,0,0,0,0,0,2,0,0,0,0,0,0,,,0,0,0,,,
"Aug 5, 2023 4:00 AM",3,0,3,0,0,0,0,0,0,0,0,0,0,0,0,0,1,1,0,0,0,0,1,0,0,0,0,2,0,0,,,0,0,0,,,
"Aug 5, 2023 5:00 AM",3,0,3,0,0,0,0,0,0,0,0,0,0,0,0,0,0,0,0,2,1,1,0,0,0,0,0,1,0,0,,,0,0,0,,,
"Aug 5, 2023 6:00 AM",4,3,1,2,2,0,0,0,0,0,0,0,0,0,0,0,0,0,0,2,1,1,0,0,0,0,0,3,0,0,,,0,0,0,,,
"Aug 5, 2023 7:00 AM",14,4,10,1,0,1,2,2,0,1,0,1,0,0,0,1,1,1,0,0,0,0,1,5,0,0,0,2,0,0,,,1,0,1,,,
"Aug 5, 2023 8:00 AM",8,4,4,1,1,0,4,1,3,0,0,0,0,0,0,1,6,6,0,6,3,3,6,0,1,1,0,2,1,0,,,2,2,0,,,
"Aug 5, 2023 9:00 AM",13,6,7,3,0,3,5,3,2,3,3,0,0,0,0,1,5,5,0,0,0,0,4,5,5,4,1,6,0,0,,,2,1,1,,,
"Aug 5, 2023 10:00 AM",30,21,9,15,8,7,12,9,3,14,11,3,0,0,0,13,3,3,0,7,3,3,3,13,4,3,1,6,0,0,,,3,2,1,,,
"Aug 5, 2023 11:00 AM",20,13,7,24,12,12,23,15,8,19,12,7,0,0,0,3,8,7,1,6,3,3,8,8,11,8,3,9,2,0,,,3,2,1,,,
"Aug 5, 2023 12:00 PM",28,13,15,44,20,24,34,17,17,28,22,6,0,0,0,3,5,5,0,9,4,5,7,8,17,12,5,6,2,0,,,2,1,1,,,
"Aug 5, 2023 1:00 PM",38,22,16,47,17,30,42,20,22,27,14,13,0,0,0,5,14,14,0,16,8,8,14,12,22,12,10,21,4,0,,,7,5,2,,,
"Aug 5, 2023 2:00 PM",42,23,19,49,33,16,52,30,22,49,35,14,0,0,0,9,9,9,0,19,9,10,6,13,23,18,5,17,0,0,,,1,0,1,,,
"Aug 5, 2023 3:00 PM",44,25,19,74,41,33,66,36,30,60,26,34,0,0,0,5,8,7,1,18,9,9,7,15,32,20,12,14,5,0,,,5,4,1,,,
"Aug 5, 2023 4:00 PM",43,16,27,84,48,36,75,40,35,57,34,23,0,0,0,17,12,11,1,18,9,9,11,19,45,20,25,17,3,0,,,7,4,3,,,
"Aug 5, 2023 5:00 PM",40,20,20,77,44,33,40,19,21,43,22,21,0,0,0,6,13,12,1,14,7,7,12,5,32,13,19,12,4,0,,,9,7,2,,,
"Aug 5, 2023 6:00 PM",35,18,17,21,13,8,28,13,15,23,9,14,0,0,0,11,9,8,1,4,2,2,7,6,20,10,10,12,4,0,,,6,4,2,,,
"Aug 5, 2023 7:00 PM",41,24,17,16,8,8,16,7,9,15,7,8,0,0,0,2,4,4,0,11,5,5,4,7,16,9,7,10,1,0,,,2,1,1,,,
"Aug 5, 2023 8:00 PM",27,10,17,12,9,3,13,5,8,17,10,7,0,0,0,6,6,6,0,8,4,4,6,7,7,0,7,11,0,0,,,1,0,1,,,
"Aug 5, 2023 9:00 PM",21,7,14,7,3,4,7,2,5,6,2,4,0,0,0,6,5,4,1,12,6,6,5,3,4,2,2,8,2,0,,,2,1,1,,,
"Aug 5, 2023 10:00 PM",21,3,18,5,2,3,5,2,3,3,1,2,0,0,0,0,9,9,0,9,4,4,7,11,3,3,0,6,1,0,,,3,2,1,,,
"Aug 5, 2023 11:00 PM",18,6,12,2,2,0,4,3,1,4,2,2,0,0,0,7,9,9,0,8,4,4,7,5,0,0,0,5,1,0,,,3,2,1,,,
"Aug 6, 2023 12:00 AM",7,4,3,0,0,0,0,0,0,1,0,1,0,0,0,0,2,2,0,2,1,1,4,5,1,0,1,7,0,0,,,3,3,0,,,
"Aug 6, 2023 1:00 AM",9,3,6,0,0,0,2,1,1,1,0,1,0,0,0,0,0,0,0,4,1,2,0,4,0,0,0,2,0,0,,,2,1,1,,,
"Aug 6, 2023 2:00 AM",1,0,1,0,0,0,1,1,0,0,0,0,0,0,0,0,0,0,0,2,1,1,1,0,1,1,0,1,0,0,,,0,0,0,,,
"Aug 6, 2023 3:00 AM",5,0,5,1,1,0,0,0,0,1,1,0,0,0,0,0,0,0,0,2,1,1,0,0,0,0,0,0,0,0,,,0,0,0,,,
"Aug 6, 2023 4:00 AM",3,1,2,0,0,0,1,0,1,0,0,0,0,0,0,0,0,0,0,0,0,0,0,0,0,0,0,0,0,0,,,0,0,0,,,
"Aug 6, 2023 5:00 AM",2,2,0,1,1,0,1,1,0,1,1,0,0,0,0,2,4,4,0,0,0,0,4,1,0,0,0,1,0,0,,,0,0,0,,,
"Aug 6, 2023 6:00 AM",6,3,3,12,3,9,9,2,7,9,2,7,0,0,0,0,0,0,0,3,1,2,1,3,1,1,0,6,1,0,,,0,0,0,,,
"Aug 6, 2023 7:00 AM",21,9,12,29,20,9,30,21,9,28,21,7,0,0,0,2,6,6,0,5,2,2,6,19,4,3,1,13,0,0,,,3,3,0,,,
"Aug 6, 2023 8:00 AM",18,9,9,72,45,27,63,46,17,65,48,17,0,0,0,7,6,6,0,14,7,7,5,22,16,13,3,18,1,0,,,2,0,2,,,
"Aug 6, 2023 9:00 AM",29,13,16,79,48,31,66,44,22,76,49,27,0,0,0,6,15,13,2,16,8,8,15,17,24,16,8,34,7,0,,,6,5,1,,,
"Aug 6, 2023 10:00 AM",31,22,9,112,55,57,100,54,46,94,55,39,0,0,0,10,15,13,2,7,3,4,15,31,42,23,19,28,7,0,,,5,4,1,,,
"Aug 6, 2023 11:00 AM",53,29,24,155,84,71,135,71,64,137,84,53,0,0,0,8,9,9,0,16,8,8,11,30,48,29,19,39,8,0,,,11,8,3,,,
"Aug 6, 2023 12:00 PM",37,17,20,143,70,73,120,68,52,129,66,63,0,0,0,11,16,15,1,25,12,13,11,29,48,30,18,28,7,0,,,9,6,3,,,
"Aug 6, 2023 1:00 PM",62,38,24,139,65,74,124,46,78,115,46,69,0,0,0,7,12,12,0,34,18,16,12,28,50,24,26,37,8,0,,,6,3,3,,,
"Aug 6, 2023 2:00 PM",37,21,16,85,36,49,95,44,51,67,41,26,0,0,0,12,10,9,1,19,10,9,10,17,42,23,19,34,7,0,,,8,8,0,,,
"Aug 6, 2023 3:00 PM",36,14,22,72,27,45,76,35,41,66,26,40,0,0,0,11,8,8,0,21,10,10,9,28,50,20,30,23,1,0,,,6,3,3,,,
"Aug 6, 2023 4:00 PM",43,23,20,56,33,23,68,34,34,46,19,27,0,0,0,13,14,14,0,19,9,10,14,21,38,19,19,29,3,0,,,2,0,2,,,
"Aug 6, 2023 5:00 PM",33,14,19,43,20,23,62,15,47,54,18,36,0,0,0,1,11,11,0,21,10,11,10,19,33,12,21,31,4,0,,,3,3,0,,,
"Aug 6, 2023 6:00 PM",43,20,23,40,20,20,46,18,28,35,10,25,0,0,0,9,8,8,0,17,8,8,6,7,26,9,17,21,0,0,,,3,2,1,,,
"Aug 6, 2023 7:00 PM",33,16,17,23,16,7,25,15,10,19,14,5,0,0,0,6,2,2,0,10,5,5,3,9,7,4,3,7,2,0,,,4,2,2,,,
"Aug 6, 2023 8:00 PM",39,14,25,20,10,10,21,8,13,17,8,9,0,0,0,10,9,8,1,8,4,4,7,10,7,2,5,16,1,0,,,0,0,0,,,
"Aug 6, 2023 9:00 PM",16,7,9,16,7,9,17,6,11,12,4,8,0,0,0,4,12,9,3,2,1,1,9,5,4,2,2,12,2,0,,,2,2,0,,,
"Aug 6, 2023 10:00 PM",16,5,11,5,4,1,10,7,3,5,4,1,0,0,0,3,5,5,0,5,2,2,5,7,5,5,0,5,0,0,,,4,1,3,,,
"Aug 6, 2023 11:00 PM",11,2,9,1,1,0,6,3,3,4,2,2,0,0,0,2,5,5,0,2,1,1,4,1,2,2,0,3,0,0,,,1,1,0,,,
"Aug 7, 2023 12:00 AM",8,2,6,0,0,0,3,2,1,3,2,1,0,0,0,1,1,1,0,2,1,1,1,4,5,5,0,1,0,0,,,0,0,0,,,
"Aug 7, 2023 1:00 AM",5,1,4,7,7,0,6,5,1,6,5,1,0,0,0,0,2,2,0,1,0,0,1,4,0,0,0,3,1,0,,,0,0,0,,,
"Aug 7, 2023 2:00 AM",4,1,3,0,0,0,0,0,0,0,0,0,0,0,0,0,1,1,0,0,0,0,2,0,0,0,0,1,0,0,,,0,0,0,,,
"Aug 7, 2023 3:00 AM",1,0,1,0,0,0,2,0,2,1,0,1,0,0,0,0,0,0,0,0,0,0,0,0,0,0,0,1,0,0,,,0,0,0,,,
"Aug 7, 2023 4:00 AM",4,1,3,2,1,1,2,1,1,2,1,1,0,0,0,0,0,0,0,0,0,0,0,2,0,0,0,0,0,0,,,0,0,0,,,
"Aug 7, 2023 5:00 AM",5,2,3,0,0,0,2,2,0,0,0,0,0,0,0,1,1,1,0,0,0,0,1,1,1,0,1,0,0,0,,,1,1,0,,,
"Aug 7, 2023 6:00 AM",14,8,6,10,8,2,8,6,2,6,4,2,0,0,0,2,4,4,0,2,1,1,3,5,4,4,0,10,0,0,,,0,0,0,,,
"Aug 7, 2023 7:00 AM",21,10,11,22,12,10,33,18,15,18,12,6,0,0,0,3,7,7,0,14,7,7,7,15,8,4,4,17,0,0,,,4,4,0,,,
"Aug 7, 2023 8:00 AM",27,16,11,49,31,18,47,35,12,45,34,11,0,0,0,8,12,9,3,11,5,5,8,15,13,10,3,16,0,0,,,2,2,0,,,
"Aug 7, 2023 9:00 AM",30,17,13,70,45,25,46,30,16,55,41,14,0,0,0,5,8,8,0,10,5,5,5,20,14,8,6,17,5,0,,,4,3,1,,,
"Aug 7, 2023 10:00 AM",33,14,19,86,40,46,81,46,35,73,43,30,0,0,0,18,10,9,1,15,7,7,10,21,47,27,20,29,2,0,,,6,4,2,,,
"Aug 7, 2023 11:00 AM",51,28,23,125,62,63,103,59,44,111,62,49,0,0,0,13,20,19,1,14,7,7,22,30,38,23,15,26,4,0,,,7,6,1,,,
"Aug 7, 2023 12:00 PM",56,29,27,139,65,74,142,75,67,143,77,66,0,0,0,20,16,16,0,26,13,13,16,26,61,33,28,31,6,0,,,5,4,1,,,
"Aug 7, 2023 1:00 PM",34,15,19,111,52,59,96,57,39,72,43,29,0,0,0,14,11,10,1,32,16,16,7,22,42,26,16,32,3,0,,,5,2,3,,,
"Aug 7, 2023 2:00 PM",51,23,28,104,61,43,113,62,51,94,56,38,0,0,0,13,10,10,0,28,14,14,11,24,52,30,22,20,6,0,,,7,6,1,,,
"Aug 7, 2023 3:00 PM",48,21,27,117,56,61,104,45,59,104,58,46,0,0,0,14,24,19,5,31,15,15,13,19,40,17,23,28,2,0,,,4,3,1,,,
"Aug 7, 2023 4:00 PM",49,21,28,110,69,41,121,62,59,83,41,42,0,0,0,16,19,18,1,25,13,12,20,29,59,27,32,24,1,0,,,8,6,2,,,
"Aug 7, 2023 5:00 PM",63,27,36,92,44,48,91,43,48,63,30,33,0,0,0,14,19,16,3,30,15,15,17,13,39,19,20,28,2,0,,,10,6,4,,,
"Aug 7, 2023 6:00 PM",47,21,26,97,48,49,89,36,53,68,27,41,0,0,0,13,24,23,1,20,9,10,23,26,53,19,34,24,2,0,,,6,3,3,,,
"Aug 7, 2023 7:00 PM",43,22,21,38,19,19,63,29,34,37,18,19,0,0,0,6,11,8,3,6,3,3,8,22,26,13,13,19,3,0,,,5,5,0,,,
"Aug 7, 2023 8:00 PM",31,12,19,47,27,20,47,23,24,43,19,24,0,0,0,7,8,8,0,5,2,3,8,13,24,10,14,9,1,0,,,5,2,3,,,
"Aug 7, 2023 9:00 PM",29,11,18,17,9,8,19,7,12,14,4,10,0,0,0,8,9,8,1,2,1,1,9,3,8,7,1,17,1,0,,,2,2,0,,,
"Aug 7, 2023 10:00 PM",17,6,11,8,5,3,11,2,9,7,3,4,0,0,0,2,4,4,0,13,6,7,4,2,5,3,2,8,1,0,,,3,1,2,,,
"Aug 7, 2023 11:00 PM",9,3,6,3,1,2,6,1,5,5,2,3,0,0,0,1,3,3,0,3,1,2,3,3,3,2,1,6,0,0,,,0,0,0,,,
"Aug 8, 2023 12:00 AM",8,2,6,0,0,0,0,0,0,0,0,0,0,0,0,1,1,1,0,0,0,0,1,5,0,0,0,2,0,0,,,1,1,0,,,
"Aug 8, 2023 1:00 AM",1,0,1,0,0,0,1,1,0,0,0,0,0,0,0,0,0,0,0,1,0,0,0,0,2,2,0,0,0,0,,,0,0,0,,,
"Aug 8, 2023 2:00 AM",2,2,0,0,0,0,1,0,1,0,0,0,0,0,0,0,1,1,0,0,0,0,1,0,0,0,0,0,0,0,,,1,1,0,,,
"Aug 8, 2023 3:00 AM",2,1,1,1,0,1,2,0,2,2,0,2,0,0,0,0,0,0,0,2,1,1,0,2,0,0,0,1,0,0,,,1,1,0,,,
"Aug 8, 2023 4:00 AM",4,2,2,0,0,0,0,0,0,0,0,0,0,0,0,0,0,0,0,0,0,0,0,0,1,0,1,0,0,0,,,0,0,0,,,
"Aug 8, 2023 5:00 AM",6,4,2,4,2,2,3,1,2,3,1,2,0,0,0,2,4,4,0,3,1,1,5,2,0,0,0,9,0,0,,,0,0,0,,,
"Aug 8, 2023 6:00 AM",45,30,15,19,5,14,21,7,14,19,7,12,0,0,0,9,21,21,0,10,5,5,21,13,13,7,6,35,1,0,,,1,1,0,,,
"Aug 8, 2023 7:00 AM",129,94,35,51,13,38,69,19,50,52,20,32,0,0,0,11,73,73,0,28,14,14,75,29,34,10,24,95,6,0,,,7,6,1,,,
"Aug 8, 2023 8:00 AM",214,177,37,88,20,68,114,39,75,85,29,56,0,0,0,21,128,128,0,31,15,16,130,45,61,19,42,150,8,0,,,7,7,0,,,
"Aug 8, 2023 9:00 AM",104,86,18,57,22,35,58,32,26,67,44,23,0,0,0,4,65,62,3,14,7,7,48,26,43,12,31,58,4,0,,,2,2,0,,,
"Aug 8, 2023 10:00 AM",61,47,14,59,28,31,63,30,33,55,25,30,0,0,0,6,31,29,2,20,10,10,31,14,37,21,16,24,1,0,,,6,1,5,,,
"Aug 8, 2023 11:00 AM",43,27,16,56,27,29,54,23,31,44,25,19,0,0,0,15,19,18,1,17,9,7,19,18,26,13,13,32,1,0,,,3,1,2,,,
"Aug 8, 2023 12:00 PM",56,37,19,60,33,27,43,25,18,43,26,17,0,0,0,16,10,9,1,14,7,7,8,13,16,7,9,19,6,0,,,12,9,3,,,
"Aug 8, 2023 1:00 PM",50,24,26,42,22,20,41,14,27,40,21,19,0,0,0,12,7,6,1,10,5,5,6,16,16,5,11,18,3,0,,,5,3,2,,,
"Aug 8, 2023 2:00 PM",46,23,23,46,25,21,33,22,11,37,24,13,0,0,0,16,6,6,0,45,22,23,5,12,21,10,11,20,5,0,,,5,2,3,,,
"Aug 8, 2023 3:00 PM",72,27,45,50,33,17,47,34,13,39,27,12,0,0,0,21,16,9,7,42,21,21,8,24,33,20,13,12,4,0,,,3,2,1,,,
"Aug 8, 2023 4:00 PM",109,30,79,60,35,25,86,55,31,55,31,24,0,0,0,16,23,20,3,76,36,39,23,61,35,19,16,31,4,0,,,5,5,0,,,
"Aug 8, 2023 5:00 PM",216,38,178,113,67,46,184,116,68,133,84,49,0,0,0,35,28,24,4,175,86,89,25,124,90,67,23,57,13,0,,,10,4,6,,,
"Aug 8, 2023 6:00 PM",215,56,159,135,87,48,182,124,58,130,88,42,0,0,0,40,29,27,2,164,81,83,25,99,98,71,27,46,10,0,,,10,8,2,,,
"Aug 8, 2023 7:00 PM",122,33,89,90,53,37,144,81,63,103,54,49,0,0,0,26,23,19,4,45,22,23,17,55,53,32,21,31,6,0,,,6,2,4,,,
"Aug 8, 2023 8:00 PM",72,27,45,67,29,38,94,41,53,67,31,36,0,0,0,30,14,14,0,32,16,16,11,26,48,26,22,33,6,0,,,3,3,0,,,
"Aug 8, 2023 9:00 PM",56,17,39,40,29,11,36,11,25,25,13,12,0,0,0,5,12,11,1,27,14,13,9,9,19,8,11,15,2,0,,,6,3,3,,,
"Aug 8, 2023 10:00 PM",31,9,22,20,16,4,26,6,20,14,3,11,0,0,0,13,8,8,0,16,8,8,8,10,4,2,2,12,4,0,,,6,3,3,,,
"Aug 8, 2023 11:00 PM",10,3,7,3,3,0,7,1,6,6,1,5,0,0,0,0,2,2,0,8,4,4,2,3,3,2,1,4,0,0,,,0,0,0,,,
"Aug 9, 2023 12:00 AM",5,1,4,0,0,0,0,0,0,1,1,0,0,0,0,5,0,0,0,6,3,3,0,3,1,1,0,0,1,0,,,0,0,0,,,
"Aug 9, 2023 1:00 AM",4,0,4,0,0,0,0,0,0,0,0,0,0,0,0,1,1,1,0,2,1,1,1,1,0,0,0,1,0,0,,,0,0,0,,,
"Aug 9, 2023 2:00 AM",1,1,0,2,0,2,2,1,1,1,0,1,0,0,0,0,1,1,0,0,0,0,1,0,0,0,0,3,1,0,,,0,0,0,,,
"Aug 9, 2023 3:00 AM",0,0,0,1,0,1,1,0,1,1,0,1,0,0,0,2,0,0,0,0,0,0,1,0,2,2,0,0,0,0,,,0,0,0,,,
"Aug 9, 2023 4:00 AM",1,0,1,1,0,1,1,1,0,2,1,1,0,0,0,0,1,1,0,0,0,0,1,0,1,0,1,1,0,0,,,0,0,0,,,
"Aug 9, 2023 5:00 AM",9,6,3,5,3,2,8,4,4,6,3,3,0,0,0,1,5,5,0,6,2,2,7,6,2,1,1,8,0,0,,,0,0,0,,,
"Aug 9, 2023 6:00 AM",50,34,16,18,10,8,33,17,16,29,15,14,0,0,0,5,17,17,0,6,3,3,12,15,10,6,4,44,1,0,,,1,1,0,,,
"Aug 9, 2023 7:00 AM",113,74,39,59,18,41,71,22,49,58,19,39,0,0,0,13,80,79,1,31,16,15,84,24,33,8,25,102,6,0,,,8,6,2,,,
"Aug 9, 2023 8:00 AM",239,185,54,88,16,72,128,44,84,108,41,67,0,0,0,17,117,115,2,27,13,13,118,56,68,18,50,180,9,0,,,11,9,2,,,
"Aug 9, 2023 9:00 AM",107,94,13,60,27,33,73,39,34,55,39,16,0,0,0,9,67,65,2,10,5,5,50,19,44,13,31,62,5,0,,,10,5,5,,,
"Aug 9, 2023 10:00 AM",48,38,10,45,21,24,47,26,21,50,29,21,0,0,0,15,21,20,1,18,9,9,17,17,34,19,15,26,7,0,,,11,7,4,,,
"Aug 9, 2023 11:00 AM",42,29,13,46,25,21,56,29,27,41,20,21,0,0,0,8,21,17,4,14,7,7,14,11,28,18,10,30,9,0,,,6,6,0,,,
"Aug 9, 2023 12:00 PM",53,26,27,68,36,32,69,32,37,56,28,28,0,0,0,16,18,17,1,19,9,10,18,23,59,24,35,21,12,0,,,6,3,3,,,
"Aug 9, 2023 1:00 PM",69,28,41,60,32,28,58,35,23,59,35,24,0,0,0,20,10,9,1,29,14,15,10,20,24,16,8,22,3,0,,,0,0,0,,,
"Aug 9, 2023 2:00 PM",54,33,21,57,31,26,64,40,24,50,23,27,0,0,0,11,14,14,0,33,16,17,17,22,47,29,18,23,4,0,,,4,2,2,,,
"Aug 9, 2023 3:00 PM",69,34,35,58,31,27,50,29,21,37,22,15,0,0,0,21,16,12,4,44,22,22,9,29,34,19,15,23,5,0,,,3,3,0,,,
"Aug 9, 2023 4:00 PM",93,21,72,80,50,30,121,73,48,86,47,39,0,0,0,15,22,17,5,73,36,36,16,61,66,44,22,37,3,0,,,2,1,1,,,
"Aug 9, 2023 5:00 PM",235,54,181,107,70,37,183,103,80,126,70,56,0,0,0,27,28,23,5,204,101,102,19,128,98,66,32,59,10,0,,,12,7,5,,,
"Aug 9, 2023 6:00 PM",223,54,169,119,77,42,201,134,67,126,76,50,0,0,0,42,31,30,1,151,73,75,29,123,108,69,39,60,9,0,,,10,7,3,,,
"Aug 9, 2023 7:00 PM",100,29,71,102,57,45,142,90,52,97,62,35,0,0,0,21,21,20,1,59,30,29,18,64,78,52,26,43,4,0,,,5,3,2,,,
"Aug 9, 2023 8:00 PM",69,22,47,82,39,43,122,52,70,78,32,46,0,0,0,11,16,16,0,34,17,17,14,42,54,20,34,34,5,0,,,6,5,1,,,
"Aug 9, 2023 9:00 PM",50,18,32,41,21,20,71,20,51,50,19,31,0,0,0,16,9,8,1,17,8,9,11,9,34,17,17,35,7,0,,,7,5,2,,,
"Aug 9, 2023 10:00 PM",38,8,30,15,9,6,18,11,7,22,12,10,0,0,0,2,5,4,1,11,6,5,4,17,7,4,3,7,1,0,,,3,1,2,,,
"Aug 9, 2023 11:00 PM",10,4,6,7,4,3,7,2,5,7,2,5,0,0,0,1,3,2,1,16,8,8,2,6,7,4,3,7,0,0,,,3,1,2,,,
"Aug 10, 2023 12:00 AM",13,0,13,0,0,0,3,2,1,3,2,1,0,0,0,0,0,0,0,8,4,4,0,3,2,2,0,5,0,0,,,0,0,0,,,
"Aug 10, 2023 1:00 AM",0,0,0,2,2,0,6,3,3,4,1,3,0,0,0,0,1,1,0,0,0,0,1,2,7,3,4,2,0,0,,,0,0,0,,,
"Aug 10, 2023 2:00 AM",3,3,0,0,0,0,1,1,0,1,1,0,0,0,0,0,2,2,0,2,1,1,2,2,0,0,0,1,0,0,,,0,0,0,,,
"Aug 10, 2023 3:00 AM",2,2,0,1,0,1,1,0,1,1,0,1,0,0,0,0,0,0,0,0,0,0,1,0,0,0,0,0,1,0,,,0,0,0,,,
"Aug 10, 2023 4:00 AM",1,0,1,0,0,0,0,0,0,0,0,0,0,0,0,0,1,1,0,0,0,0,2,1,1,0,1,0,0,0,,,0,0,0,,,
"Aug 10, 2023 5:00 AM",6,2,4,1,0,1,2,2,0,1,1,0,0,0,0,1,10,10,0,7,3,3,11,4,3,2,1,4,1,0,,,2,2,0,,,
"Aug 10, 2023 6:00 AM",48,30,18,14,7,7,18,7,11,14,6,8,0,0,0,11,18,18,0,8,4,4,17,16,9,7,2,40,0,0,,,1,1,0,,,
"Aug 10, 2023 7:00 AM",123,84,39,44,14,30,59,19,40,44,17,27,0,0,0,16,56,55,1,20,10,10,55,31,40,11,29,93,6,0,,,2,2,0,,,
"Aug 10, 2023 8:00 AM",223,163,60,79,17,62,114,43,71,85,31,54,0,0,0,16,114,113,1,13,7,6,113,58,60,22,38,172,9,0,,,10,7,3,,,
"Aug 10, 2023 9:00 AM",110,92,18,61,20,41,73,32,41,66,38,28,0,0,0,19,54,53,1,16,8,8,45,22,45,17,28,61,1,0,,,4,4,0,,,
"Aug 10, 2023 10:00 AM",60,39,21,62,30,32,56,29,27,48,29,19,0,0,0,10,23,23,0,14,7,7,22,16,26,17,9,41,2,0,,,3,3,0,,,
"Aug 10, 2023 11:00 AM",40,29,11,61,32,29,61,35,26,43,29,14,0,0,0,8,20,19,1,16,8,8,18,11,23,12,11,23,3,0,,,2,2,0,,,
"Aug 10, 2023 12:00 PM",47,22,25,53,36,17,64,35,29,48,25,23,0,0,0,12,14,13,1,10,5,4,15,20,29,18,11,22,6,0,,,5,3,2,,,
"Aug 10, 2023 1:00 PM",65,33,32,58,36,22,57,32,25,54,32,22,0,0,0,6,9,7,2,16,8,8,5,26,28,17,11,14,3,0,,,4,2,2,,,
"Aug 10, 2023 2:00 PM",62,25,37,75,30,45,83,56,27,72,38,34,0,0,0,15,17,16,1,35,18,17,14,24,31,24,7,17,4,0,,,4,1,3,,,
"Aug 10, 2023 3:00 PM",57,22,35,84,34,50,79,41,38,63,29,34,0,0,0,18,15,11,4,43,21,21,12,26,31,16,15,42,9,0,,,3,1,2,,,
"Aug 10, 2023 4:00 PM",95,28,67,85,50,35,110,67,43,85,48,37,0,0,0,14,24,20,4,83,42,41,23,57,55,37,18,46,8,0,,,7,5,2,,,
"Aug 10, 2023 5:00 PM",184,41,143,123,67,56,182,116,66,141,97,44,0,0,0,31,32,26,6,145,72,73,24,120,87,67,20,72,6,0,,,5,4,1,,,
"Aug 10, 2023 6:00 PM",203,47,156,85,56,29,153,100,53,70,51,19,0,0,0,24,26,25,1,147,73,73,21,110,101,77,24,38,3,0,,,7,3,4,,,
"Aug 10, 2023 7:00 PM",84,28,56,66,40,26,101,58,43,60,32,28,0,0,0,19,15,14,1,49,25,24,15,38,53,26,27,34,3,0,,,10,5,5,,,
"Aug 10, 2023 8:00 PM",75,23,52,47,24,23,73,29,44,55,23,32,0,0,0,18,12,10,2,45,22,23,8,23,33,13,20,35,3,0,,,5,2,3,,,
"Aug 10, 2023 9:00 PM",42,13,29,35,28,7,36,11,25,25,7,18,0,0,0,6,10,10,0,26,12,14,11,22,12,8,4,23,1,0,,,4,0,4,,,
"Aug 10, 2023 10:00 PM",37,7,30,16,13,3,25,3,22,18,2,16,0,0,0,2,4,4,0,13,6,7,5,6,7,4,3,10,4,0,,,8,4,4,,,
"Aug 10, 2023 11:00 PM",13,4,9,4,3,1,7,3,4,8,2,6,0,0,0,3,5,4,1,4,2,2,4,5,5,4,1,6,0,0,,,0,0,0,,,
"Aug 11, 2023 12:00 AM",8,3,5,0,0,0,1,1,0,2,2,0,0,0,0,0,5,5,0,8,4,4,4,5,2,2,0,1,0,0,,,1,0,1,,,
"Aug 11, 2023 1:00 AM",10,1,9,2,1,1,0,0,0,1,0,1,0,0,0,0,2,2,0,2,1,1,2,1,0,0,0,3,0,0,,,0,0,0,,,
"Aug 11, 2023 2:00 AM",8,3,5,1,0,1,1,0,1,1,0,1,0,0,0,0,5,5,0,2,1,1,5,1,1,0,1,1,0,0,,,0,0,0,,,
"Aug 11, 2023 3:00 AM",0,0,0,2,1,1,2,1,1,2,1,1,0,0,0,0,1,1,0,0,0,0,1,1,0,0,0,0,0,0,,,0,0,0,,,
"Aug 11, 2023 4:00 AM",6,1,5,0,0,0,0,0,0,0,0,0,0,0,0,0,1,0,1,0,0,0,0,3,1,0,1,0,0,0,,,0,0,0,,,
"Aug 11, 2023 5:00 AM",5,4,1,9,9,0,12,11,1,8,8,0,0,0,0,2,8,8,0,12,5,5,8,3,4,4,0,6,1,0,,,1,1,0,,,
"Aug 11, 2023 6:00 AM",42,21,21,26,11,15,34,16,18,19,10,9,0,0,0,5,16,16,0,11,5,6,17,18,8,4,4,29,3,0,,,0,0,0,,,
"Aug 11, 2023 7:00 AM",95,63,32,77,35,42,88,40,48,70,29,41,0,0,0,12,42,42,0,23,12,11,40,33,31,16,15,88,4,0,,,1,0,1,,,
"Aug 11, 2023 8:00 AM",156,112,44,111,35,76,138,54,84,98,43,55,0,0,0,16,64,64,0,29,14,15,58,47,53,16,37,114,10,0,,,6,4,2,,,
"Aug 11, 2023 9:00 AM",82,73,9,60,23,37,95,50,45,62,32,30,0,0,0,7,42,39,3,24,12,12,32,21,49,21,28,37,0,0,,,9,7,2,,,
"Aug 11, 2023 10:00 AM",52,31,21,60,38,22,97,57,40,61,38,23,0,0,0,4,25,23,2,10,5,5,17,26,63,38,25,29,0,0,,,2,1,1,,,
"Aug 11, 2023 11:00 AM",44,28,16,92,39,53,105,61,44,71,45,26,0,0,0,22,17,16,1,25,11,12,14,15,39,27,12,28,3,0,,,9,6,3,,,
"Aug 11, 2023 12:00 PM",56,27,29,108,54,54,98,45,53,78,41,37,0,0,0,25,17,15,2,16,8,8,15,16,43,26,17,22,3,0,,,6,1,5,,,
"Aug 11, 2023 1:00 PM",68,26,42,81,41,40,95,42,53,83,43,40,0,0,0,10,12,12,0,28,14,14,12,22,57,23,34,33,4,0,,,6,4,2,,,
"Aug 11, 2023 2:00 PM",76,40,36,70,42,28,83,46,37,81,50,31,0,0,0,15,18,17,1,35,18,17,15,18,45,26,19,37,8,0,,,6,3,3,,,
"Aug 11, 2023 3:00 PM",62,28,34,92,50,42,79,42,37,74,39,35,0,0,0,14,14,11,3,46,23,23,10,29,31,14,17,29,5,0,,,9,9,0,,,
"Aug 11, 2023 4:00 PM",98,27,71,91,51,40,112,62,50,90,49,41,0,0,0,16,27,23,4,78,38,40,25,48,57,33,24,44,5,0,,,10,6,4,,,
"Aug 11, 2023 5:00 PM",144,46,98,91,54,37,128,69,59,84,45,39,0,0,0,19,26,24,2,117,58,59,21,60,65,47,18,42,3,0,,,2,1,1,,,
"Aug 11, 2023 6:00 PM",115,31,84,91,52,39,112,76,36,72,45,27,0,0,0,25,26,25,1,63,31,31,20,62,74,57,17,29,7,0,,,3,2,1,,,
"Aug 11, 2023 7:00 PM",73,20,53,71,41,30,128,72,56,60,30,30,0,0,0,10,16,15,1,40,20,20,14,46,56,37,19,29,3,0,,,7,3,4,,,
"Aug 11, 2023 8:00 PM",61,23,38,54,23,31,70,24,46,48,21,27,0,0,0,9,8,7,1,14,7,7,10,15,41,15,26,30,4,0,,,5,3,2,,,
"Aug 11, 2023 9:00 PM",25,13,12,24,16,8,33,11,22,21,9,12,0,0,0,7,13,13,0,10,5,5,15,15,16,8,8,11,0,0,,,1,1,0,,,
"Aug 11, 2023 10:00 PM",35,13,22,13,6,7,16,1,15,11,3,8,0,0,0,0,5,5,0,11,5,6,4,6,6,5,1,16,1,0,,,1,1,0,,,
"Aug 11, 2023 11:00 PM",20,4,16,12,5,7,14,4,10,8,3,5,0,0,0,3,5,4,1,10,5,5,4,5,5,2,3,8,0,0,,,0,0,0,,,
"Aug 12, 2023 12:00 AM",11,3,8,1,1,0,3,3,0,5,1,4,0,0,0,2,2,1,1,4,2,2,1,3,6,5,1,2,0,0,,,2,1,1,,,
"Aug 12, 2023 1:00 AM",4,0,4,2,1,1,5,2,3,3,2,1,0,0,0,0,1,1,0,2,1,1,1,3,1,1,0,4,0,0,,,0,0,0,,,
"Aug 12, 2023 2:00 AM",5,3,2,2,0,2,2,0,2,1,0,1,0,0,0,0,0,0,0,2,1,1,0,0,0,0,0,2,0,0,,,0,0,0,,,
"Aug 12, 2023 3:00 AM",4,1,3,0,0,0,0,0,0,0,0,0,0,0,0,0,0,0,0,2,1,1,1,4,1,1,0,2,0,0,,,1,0,1,,,
"Aug 12, 2023 4:00 AM",3,0,3,1,1,0,2,2,0,2,2,0,0,0,0,1,1,1,0,2,1,1,1,2,0,0,0,0,0,0,,,0,0,0,,,
"Aug 12, 2023 5:00 AM",5,2,3,3,3,0,5,4,1,3,3,0,0,0,0,1,2,2,0,2,1,1,2,3,1,1,0,4,0,0,,,1,1,0,,,
"Aug 12, 2023 6:00 AM",13,5,8,4,3,1,6,4,2,5,4,1,0,0,0,2,4,4,0,4,2,2,3,3,0,0,0,10,0,0,,,1,1,0,,,
"Aug 12, 2023 7:00 AM",17,8,9,16,5,11,20,11,9,13,7,6,0,0,0,3,4,3,1,7,3,4,2,9,3,2,1,13,0,0,,,1,1,0,,,
"Aug 12, 2023 8:00 AM",23,13,10,44,28,16,44,33,11,32,23,9,0,0,0,5,5,5,0,8,4,4,4,21,15,11,4,21,2,0,,,2,2,0,,,
"Aug 12, 2023 9:00 AM",34,14,20,75,37,38,81,53,28,53,35,18,0,0,0,9,15,15,0,21,10,11,14,20,31,20,11,36,3,0,,,2,2,0,,,
"Aug 12, 2023 10:00 AM",40,22,18,99,49,50,131,89,42,82,50,32,0,0,0,6,18,18,0,18,9,9,15,33,62,33,29,26,3,0,,,5,5,0,,,
"Aug 12, 2023 11:00 AM",50,27,23,119,73,46,171,85,86,125,81,44,0,0,0,5,13,13,0,20,10,10,13,27,77,49,28,45,5,0,,,10,6,4,,,
"Aug 12, 2023 12:00 PM",67,42,25,160,56,104,158,67,91,120,60,60,0,0,0,12,15,13,2,30,15,15,10,34,65,27,38,36,2,0,,,6,1,5,,,
"Aug 12, 2023 1:00 PM",57,31,26,119,63,56,103,57,46,108,66,42,0,0,0,10,12,10,2,13,6,6,13,23,62,34,28,25,4,0,,,6,4,2,,,
"Aug 12, 2023 2:00 PM",46,30,16,92,55,37,94,57,37,88,58,30,0,0,0,9,17,16,1,28,13,15,12,35,38,25,13,25,1,0,,,4,3,1,,,
"Aug 12, 2023 3:00 PM",43,22,21,107,58,49,102,49,53,92,47,45,0,0,0,21,8,7,1,21,10,10,6,23,56,21,35,28,5,0,,,8,6,2,,,
"Aug 12, 2023 4:00 PM",39,21,18,117,63,54,108,57,51,117,62,55,0,0,0,15,20,20,0,12,6,6,16,23,60,36,24,23,4,0,,,7,2,5,,,
"Aug 12, 2023 5:00 PM",45,14,31,96,51,45,102,35,67,93,34,59,0,0,0,14,14,14,0,15,7,8,11,21,50,16,34,30,1,0,,,7,5,2,,,
"Aug 12, 2023 6:00 PM",53,23,30,56,29,27,50,24,26,50,22,28,0,0,0,17,11,10,1,12,5,6,13,29,33,14,19,15,6,0,,,8,6,2,,,
"Aug 12, 2023 7:00 PM",31,15,16,39,15,24,38,14,24,25,11,14,0,0,0,5,10,10,0,22,10,12,10,12,17,5,12,16,7,0,,,5,5,0,,,
"Aug 12, 2023 8:00 PM",38,12,26,45,22,23,47,17,30,48,17,31,0,0,0,11,9,6,3,11,5,6,5,12,8,6,2,21,0,0,,,4,0,4,,,
"Aug 12, 2023 9:00 PM",26,11,15,19,9,10,18,5,13,14,2,12,0,0,0,3,5,5,0,2,1,1,6,5,6,2,4,9,1,0,,,3,3,0,,,
"Aug 12, 2023 10:00 PM",21,10,11,12,7,5,7,1,6,10,5,5,0,0,0,2,2,1,1,8,4,4,3,5,6,5,1,7,3,0,,,3,1,2,,,
"Aug 12, 2023 11:00 PM",7,3,4,11,5,6,7,3,4,10,6,4,0,0,0,1,5,5,0,8,2,6,4,3,7,2,5,6,1,0,,,1,1,0,,,
"Aug 13, 2023 12:00 AM",7,2,5,1,1,0,0,0,0,4,4,0,0,0,0,0,6,4,2,4,2,2,5,1,1,0,1,2,1,0,,,1,0,1,,,
"Aug 13, 2023 1:00 AM",10,3,7,0,0,0,0,0,0,0,0,0,0,0,0,0,1,1,0,4,2,2,1,2,1,0,1,4,0,0,,,0,0,0,,,
"Aug 13, 2023 2:00 AM",5,2,3,0,0,0,3,0,3,3,0,3,0,0,0,0,1,1,0,4,2,2,1,0,0,0,0,1,0,0,,,2,2,0,,,
"Aug 13, 2023 3:00 AM",1,0,1,1,1,0,0,0,0,0,0,0,0,0,0,0,0,0,0,2,1,1,0,2,0,0,0,3,0,0,,,0,0,0,,,
"Aug 13, 2023 4:00 AM",4,1,3,0,0,0,1,0,1,0,0,0,0,0,0,0,1,1,0,0,0,0,1,0,0,0,0,1,0,0,,,0,0,0,,,
"Aug 13, 2023 5:00 AM",0,0,0,0,0,0,2,1,1,1,1,0,0,0,0,1,1,1,0,2,0,1,1,1,2,1,1,3,1,0,,,0,0,0,,,
"Aug 13, 2023 6:00 AM",9,4,5,9,4,5,11,6,5,7,4,3,0,0,0,1,1,1,0,4,2,2,1,3,1,0,1,9,1,0,,,0,0,0,,,
"Aug 13, 2023 7:00 AM",18,6,12,24,14,10,24,15,9,25,15,10,0,0,0,5,16,16,0,9,5,4,15,13,3,3,0,14,0,0,,,0,0,0,,,
"Aug 13, 2023 8:00 AM",26,12,14,67,41,26,64,41,23,47,33,14,0,0,0,1,8,8,0,16,8,8,10,20,26,18,8,38,1,0,,,1,0,1,,,
"Aug 13, 2023 9:00 AM",34,19,15,106,63,43,94,65,29,101,73,28,0,0,0,15,26,24,2,15,8,7,23,38,28,19,9,36,0,0,,,3,3,0,,,
"Aug 13, 2023 10:00 AM",62,37,25,178,104,74,190,121,69,148,87,61,0,0,0,18,19,15,4,33,16,17,16,38,69,49,20,39,7,0,,,6,3,3,,,
"Aug 13, 2023 11:00 AM",48,27,21,186,98,88,217,123,94,161,95,66,0,0,0,18,22,22,0,19,9,10,24,46,96,68,28,55,8,0,,,7,6,1,,,
"Aug 13, 2023 12:00 PM",45,26,19,212,92,120,251,121,130,193,102,91,0,0,0,14,21,21,0,26,13,13,20,40,99,59,40,37,10,0,,,9,6,3,,,
"Aug 13, 2023 1:00 PM",57,19,38,184,97,87,199,96,103,150,73,77,0,0,0,26,23,23,0,35,17,18,18,44,105,46,59,39,4,0,,,6,3,3,,,
"Aug 13, 2023 2:00 PM",44,19,25,170,97,73,168,72,96,159,90,69,0,0,0,9,24,21,3,19,9,10,20,36,88,40,48,54,2,0,,,4,2,2,,,
"Aug 13, 2023 3:00 PM",50,24,26,171,72,99,175,86,89,164,75,89,0,0,0,19,16,15,1,33,16,16,16,30,73,35,38,46,3,0,,,5,4,1,,,
"Aug 13, 2023 4:00 PM",61,31,30,120,55,65,123,56,67,103,45,58,0,0,0,8,16,14,2,29,14,14,13,35,62,28,34,48,8,0,,,5,3,2,,,
"Aug 13, 2023 5:00 PM",44,19,25,132,57,75,136,58,78,100,46,54,0,0,0,11,20,18,2,14,7,7,17,17,54,21,33,52,2,0,,,7,4,3,,,
"Aug 13, 2023 6:00 PM",51,20,31,96,55,41,87,41,46,82,35,47,0,0,0,18,12,11,1,29,14,15,12,23,42,18,24,32,2,0,,,2,0,2,,,
"Aug 13, 2023 7:00 PM",37,17,20,73,31,42,67,23,44,51,16,35,0,0,0,13,6,6,0,20,10,10,4,18,34,13,21,29,7,0,,,5,3,2,,,
"Aug 13, 2023 8:00 PM",35,18,17,34,16,18,45,15,30,33,12,21,0,0,0,6,9,9,0,5,2,3,11,15,25,10,15,25,3,0,,,3,3,0,,,
"Aug 13, 2023 9:00 PM",21,7,14,11,6,5,24,9,15,13,6,7,0,0,0,4,14,13,1,4,2,2,10,6,7,2,5,14,2,0,,,1,1,0,,,
"Aug 13, 2023 10:00 PM",22,7,15,11,8,3,11,4,7,11,5,6,0,0,0,3,8,7,1,6,3,3,8,5,1,1,0,6,1,0,,,1,1,0,,,
"Aug 13, 2023 11:00 PM",6,1,5,3,0,3,6,1,5,8,1,7,0,0,0,1,4,4,0,1,0,0,4,5,1,0,1,6,1,0,,,0,0,0,,,
"Aug 14, 2023 12:00 AM",6,1,5,0,0,0,1,0,1,1,0,1,0,0,0,2,2,2,0,2,1,1,2,2,3,2,1,7,0,0,,,2,2,0,,,
"Aug 14, 2023 1:00 AM",0,0,0,2,0,2,1,1,0,3,1,2,0,0,0,0,1,1,0,10,5,5,1,2,0,0,0,1,0,0,,,1,1,0,,,
"Aug 14, 2023 2:00 AM",2,0,2,0,0,0,0,0,0,0,0,0,0,0,0,0,0,0,0,0,0,0,0,0,0,0,0,0,0,0,,,0,0,0,,,
"Aug 14, 2023 3:00 AM",1,0,1,0,0,0,0,0,0,0,0,0,0,0,0,0,0,0,0,0,0,0,0,0,0,0,0,0,0,0,,,0,0,0,,,
"Aug 14, 2023 4:00 AM",4,1,3,0,0,0,0,0,0,0,0,0,0,0,0,0,1,1,0,0,0,0,1,0,0,0,0,0,0,0,,,0,0,0,,,
"Aug 14, 2023 5:00 AM",3,3,0,3,2,1,8,5,3,4,3,1,0,0,0,2,5,5,0,4,1,1,6,4,0,0,0,7,0,0,,,0,0,0,,,
"Aug 14, 2023 6:00 AM",46,28,18,14,3,11,13,3,10,7,1,6,0,0,0,7,21,21,0,6,3,3,21,13,5,1,4,33,1,0,,,1,1,0,,,
"Aug 14, 2023 7:00 AM",103,63,40,52,19,33,60,19,41,50,22,28,0,0,0,15,70,69,1,29,14,14,61,21,26,6,20,101,3,0,,,4,3,1,,,
"Aug 14, 2023 8:00 AM",167,122,45,64,13,51,108,38,70,76,29,47,0,0,0,11,122,122,0,24,11,12,122,31,65,21,44,130,8,0,,,9,7,2,,,
"Aug 14, 2023 9:00 AM",96,75,21,52,17,35,64,29,35,54,30,24,0,0,0,9,39,37,2,19,9,9,35,19,34,14,20,55,4,0,,,4,2,2,,,
"Aug 14, 2023 10:00 AM",41,30,11,42,24,18,53,27,26,36,19,17,0,0,0,5,23,21,2,8,4,4,21,15,35,19,16,33,2,0,,,2,1,1,,,
"Aug 14, 2023 11:00 AM",45,28,17,37,18,19,53,26,27,39,21,18,0,0,0,14,9,9,0,4,2,2,8,12,27,14,13,19,8,0,,,9,8,1,,,
"Aug 14, 2023 12:00 PM",40,20,20,71,33,38,80,38,42,53,25,28,0,0,0,14,11,11,0,32,16,16,13,15,38,23,15,27,5,0,,,7,5,2,,,
"Aug 14, 2023 1:00 PM",51,26,25,61,34,27,81,43,38,48,24,24,0,0,0,11,13,12,1,23,12,11,13,16,39,23,16,21,6,0,,,12,9,3,,,
"Aug 14, 2023 2:00 PM",45,26,19,45,21,24,56,28,28,42,24,18,0,0,0,9,12,12,0,37,18,19,12,15,24,13,11,18,2,0,,,5,1,4,,,
"Aug 14, 2023 3:00 PM",66,27,39,57,36,21,58,35,23,49,35,14,0,0,0,14,20,18,2,24,12,12,11,21,31,18,13,20,3,0,,,7,3,4,,,
"Aug 14, 2023 4:00 PM",90,34,56,83,43,40,81,41,40,77,40,37,0,0,0,20,22,18,4,75,37,38,27,43,50,36,14,38,1,0,,,7,6,1,,,
"Aug 14, 2023 5:00 PM",202,56,146,76,56,20,120,66,54,97,54,43,0,0,0,30,33,30,3,184,92,91,29,113,55,45,10,43,4,0,,,9,6,3,,,
"Aug 14, 2023 6:00 PM",174,46,128,87,56,31,131,89,42,82,61,21,0,0,0,24,33,30,3,144,72,72,26,101,73,61,12,42,5,0,,,6,4,2,,,
"Aug 14, 2023 7:00 PM",103,24,79,65,38,27,83,57,26,65,42,23,0,0,0,40,15,13,2,63,30,32,13,47,36,28,8,27,6,0,,,8,5,3,,,
"Aug 14, 2023 8:00 PM",61,20,41,62,27,35,72,28,44,48,17,31,0,0,0,7,16,15,1,39,20,19,13,19,30,12,18,24,3,0,,,0,0,0,,,
"Aug 14, 2023 9:00 PM",34,13,21,27,13,14,28,14,14,33,17,16,0,0,0,10,10,10,0,32,16,16,11,9,11,8,3,21,5,0,,,4,3,1,,,
"Aug 14, 2023 10:00 PM",29,6,23,8,6,2,9,4,5,8,4,4,0,0,0,0,7,5,2,14,7,7,6,8,3,3,0,3,2,0,,,3,2,1,,,
"Aug 14, 2023 11:00 PM",22,4,18,5,2,3,7,2,5,6,0,6,0,0,0,6,3,3,0,2,1,1,3,2,8,5,3,5,0,0,,,6,2,4,,,
"Aug 15, 2023 12:00 AM",7,4,3,0,0,0,2,2,0,5,1,4,0,0,0,0,0,0,0,2,1,1,0,5,2,2,0,2,0,0,,,2,1,1,,,
"Aug 15, 2023 1:00 AM",4,0,4,0,0,0,4,2,2,2,1,1,0,0,0,0,0,0,0,0,0,0,0,1,1,1,0,1,0,0,,,0,0,0,,,
"Aug 15, 2023 2:00 AM",5,3,2,1,1,0,2,1,1,1,1,0,0,0,0,0,1,1,0,0,0,0,1,1,0,0,0,2,0,0,,,0,0,0,,,
"Aug 15, 2023 3:00 AM",1,0,1,0,0,0,0,0,0,0,0,0,0,0,0,0,0,0,0,0,0,0,0,0,0,0,0,0,0,0,,,0,0,0,,,
"Aug 15, 2023 4:00 AM",7,3,4,0,0,0,0,0,0,0,0,0,0,0,0,0,0,0,0,0,0,0,0,0,0,0,0,1,0,0,,,0,0,0,,,
"Aug 15, 2023 5:00 AM",7,3,4,3,0,3,4,1,3,4,2,2,0,0,0,2,7,7,0,5,2,2,7,3,4,1,3,6,1,0,,,0,0,0,,,
"Aug 15, 2023 6:00 AM",53,27,26,26,13,13,33,10,23,27,12,15,0,0,0,6,23,23,0,6,3,3,23,14,5,1,4,36,2,0,,,3,2,1,,,
"Aug 15, 2023 7:00 AM",131,91,40,62,12,50,86,27,59,75,26,49,0,0,0,15,74,74,0,32,15,16,82,28,38,11,27,129,5,0,,,5,4,1,,,
"Aug 15, 2023 8:00 AM",239,187,52,104,27,77,142,52,90,110,51,59,0,0,0,15,146,145,1,36,17,18,141,61,87,25,62,205,12,0,,,4,4,0,,,
"Aug 15, 2023 9:00 AM",115,96,19,69,28,41,75,34,41,70,41,29,0,0,0,4,66,64,2,15,7,7,52,20,47,13,34,74,3,0,,,5,4,1,,,
"Aug 15, 2023 10:00 AM",54,40,14,52,26,26,76,39,37,44,22,22,0,0,0,10,36,32,4,10,4,5,29,19,26,15,11,37,4,0,,,4,2,2,,,
"Aug 15, 2023 11:00 AM",40,17,23,60,26,34,61,30,31,42,17,25,0,0,0,6,12,11,1,9,4,4,11,11,37,21,16,33,1,0,,,4,4,0,,,
"Aug 15, 2023 12:00 PM",62,36,26,69,37,32,83,47,36,52,28,24,0,0,0,11,18,17,1,23,11,11,18,20,31,16,15,28,4,0,,,4,4,0,,,
"Aug 15, 2023 1:00 PM",72,34,38,75,40,35,78,41,37,66,42,24,0,0,0,6,18,16,2,24,12,12,16,20,38,23,15,25,4,0,,,2,2,0,,,
"Aug 15, 2023 2:00 PM",72,45,27,90,46,44,86,53,33,59,40,19,0,0,0,19,10,10,0,32,16,16,9,28,39,22,17,17,9,0,,,6,5,1,,,
"Aug 15, 2023 3:00 PM",79,32,47,65,39,26,77,40,37,59,34,25,0,0,0,24,17,11,6,43,20,23,8,30,43,22,21,29,3,0,,,3,1,2,,,
"Aug 15, 2023 4:00 PM",134,40,94,63,30,33,89,57,32,73,43,30,0,0,0,20,35,27,8,104,51,53,30,61,58,38,20,43,12,0,,,7,5,2,,,
"Aug 15, 2023 5:00 PM",233,58,175,126,83,43,194,111,83,151,88,63,0,0,0,32,46,42,4,197,98,99,40,137,96,67,29,82,9,0,,,10,5,5,,,
"Aug 15, 2023 6:00 PM",187,49,138,137,96,41,188,127,61,141,107,34,0,0,0,35,26,21,5,204,102,101,22,148,114,88,26,46,3,0,,,12,7,5,,,
"Aug 15, 2023 7:00 PM",104,36,68,107,61,46,135,88,47,114,71,43,0,0,0,20,21,21,0,72,36,35,17,63,62,34,28,36,7,0,,,18,9,9,,,
"Aug 15, 2023 8:00 PM",97,39,58,86,39,47,105,39,66,79,36,43,0,0,0,19,13,12,1,51,25,26,15,32,36,17,19,36,4,0,,,3,2,1,,,
"Aug 15, 2023 9:00 PM",63,18,45,40,23,17,44,20,24,27,13,14,0,0,0,9,12,10,2,26,12,13,9,13,22,14,8,24,3,0,,,7,2,5,,,
"Aug 15, 2023 10:00 PM",30,5,25,16,9,7,24,5,19,18,2,16,0,0,0,1,6,6,0,18,9,9,5,12,6,4,2,12,4,0,,,4,3,1,,,
"Aug 15, 2023 11:00 PM",18,6,12,7,7,0,8,1,7,6,2,4,0,0,0,4,5,5,0,12,6,6,5,0,3,2,1,7,2,0,,,1,1,0,,,
"Aug 16, 2023 12:00 AM",6,0,6,0,0,0,1,1,0,2,1,1,0,0,0,3,2,2,0,4,2,2,2,7,1,1,0,2,1,0,,,2,2,0,,,
"Aug 16, 2023 1:00 AM",3,1,2,0,0,0,0,0,0,0,0,0,0,0,0,0,1,1,0,2,1,1,1,1,0,0,0,0,0,0,,,1,0,1,,,
"Aug 16, 2023 2:00 AM",2,2,0,1,1,0,0,0,0,0,0,0,0,0,0,0,1,1,0,5,2,3,1,0,0,0,0,1,0,0,,,0,0,0,,,
"Aug 16, 2023 3:00 AM",1,0,1,0,0,0,1,0,1,0,0,0,0,0,0,0,0,0,0,0,0,0,1,1,0,0,0,0,0,0,,,0,0,0,,,
"Aug 16, 2023 4:00 AM",6,2,4,0,0,0,0,0,0,0,0,0,0,0,0,0,2,1,1,3,1,1,2,0,1,1,0,2,0,0,,,0,0,0,,,
"Aug 16, 2023 5:00 AM",8,6,2,2,2,0,6,3,3,5,3,2,0,0,0,1,4,4,0,8,3,3,5,3,3,0,3,6,0,0,,,0,0,0,,,
"Aug 16, 2023 6:00 AM",48,26,22,19,7,12,23,6,17,20,5,15,0,0,0,4,25,25,0,8,4,4,24,18,10,1,9,41,2,0,,,2,2,0,,,
"Aug 16, 2023 7:00 AM",124,87,37,76,21,55,86,24,62,69,22,47,0,0,0,13,86,86,0,29,14,14,82,31,40,10,30,126,6,0,,,7,6,1,,,
"Aug 16, 2023 8:00 AM",233,173,60,102,23,79,138,52,86,108,38,70,0,0,0,21,153,153,0,27,13,13,149,53,80,19,61,169,7,0,,,9,6,3,,,
"Aug 16, 2023 9:00 AM",124,104,20,69,22,47,76,36,40,75,42,33,0,0,0,5,59,59,0,15,8,7,53,14,38,15,23,71,4,0,,,8,8,0,,,
"Aug 16, 2023 10:00 AM",45,34,11,63,31,32,61,34,27,42,21,21,0,0,0,9,30,29,1,16,8,8,25,17,43,28,15,29,2,0,,,2,1,1,,,
"Aug 16, 2023 11:00 AM",48,29,19,60,24,36,52,31,21,44,26,18,0,0,0,10,21,19,2,26,13,13,17,16,24,14,10,23,7,0,,,3,2,1,,,
"Aug 16, 2023 12:00 PM",61,36,25,54,33,21,67,35,32,46,31,15,0,0,0,13,12,12,0,24,11,13,11,28,36,16,20,27,1,0,,,6,4,2,,,
"Aug 16, 2023 1:00 PM",52,27,25,69,41,28,76,41,35,41,26,15,0,0,0,13,10,9,1,21,10,10,7,18,47,22,25,24,5,0,,,6,6,0,,,
"Aug 16, 2023 2:00 PM",58,25,33,63,29,34,59,36,23,42,20,22,0,0,0,15,11,8,3,44,21,22,9,26,41,25,16,26,8,0,,,10,7,3,,,
"Aug 16, 2023 3:00 PM",62,22,40,61,37,24,81,46,35,52,40,12,0,0,0,29,19,14,5,31,15,16,11,33,44,22,22,26,4,0,,,5,4,1,,,
"Aug 16, 2023 4:00 PM",101,37,64,84,45,39,92,45,47,74,37,37,0,0,0,23,23,19,4,93,46,47,23,59,47,35,12,34,6,0,,,4,2,2,,,
"Aug 16, 2023 5:00 PM",241,66,175,110,67,43,156,96,60,110,72,38,0,0,0,47,35,32,3,198,99,98,32,137,65,39,26,74,10,0,,,7,6,1,,,
"Aug 16, 2023 6:00 PM",177,38,139,132,87,45,152,106,46,129,90,39,0,0,0,13,25,22,3,211,104,105,23,116,92,81,11,36,9,0,,,11,6,5,,,
"Aug 16, 2023 7:00 PM",102,39,63,128,69,59,128,78,50,115,68,47,0,0,0,37,27,25,2,83,41,41,23,57,59,37,22,26,8,0,,,12,7,5,,,
"Aug 16, 2023 8:00 PM",103,29,74,91,40,51,77,34,43,75,33,42,0,0,0,13,28,23,5,56,27,28,21,33,38,23,15,37,8,0,,,8,4,4,,,
"Aug 16, 2023 9:00 PM",44,19,25,42,23,19,49,15,34,35,12,23,0,0,0,14,12,10,2,36,18,18,11,18,26,13,13,22,5,0,,,0,0,0,,,
"Aug 16, 2023 10:00 PM",38,11,27,21,18,3,21,8,13,13,3,10,0,0,0,6,7,5,2,18,9,9,6,10,11,6,5,6,3,0,,,5,3,2,,,
"Aug 16, 2023 11:00 PM",6,3,3,2,1,1,3,1,2,3,1,2,0,0,0,2,2,2,0,12,6,6,2,8,3,2,1,5,0,0,,,1,1,0,,,
"Aug 17, 2023 12:00 AM",6,1,5,0,0,0,3,3,0,6,6,0,0,0,0,1,3,3,0,2,1,1,2,3,4,3,1,1,2,0,,,3,2,1,,,
"Aug 17, 2023 1:00 AM",4,0,4,1,1,0,0,0,0,0,0,0,0,0,0,1,1,1,0,2,1,1,1,2,0,0,0,1,0,0,,,1,0,1,,,
"Aug 17, 2023 2:00 AM",1,1,0,1,1,0,2,2,0,2,2,0,0,0,0,0,0,0,0,0,0,0,0,0,0,0,0,2,0,0,,,0,0,0,,,
"Aug 17, 2023 3:00 AM",0,0,0,1,1,0,0,0,0,1,1,0,0,0,0,0,0,0,0,2,1,1,0,1,0,0,0,0,0,0,,,0,0,0,,,
"Aug 17, 2023 4:00 AM",4,2,2,0,0,0,0,0,0,0,0,0,0,0,0,0,0,0,0,1,0,0,0,0,0,0,0,0,0,0,,,1,0,1,,,
"Aug 17, 2023 5:00 AM",3,3,0,4,2,2,5,3,2,4,2,2,0,0,0,2,6,6,0,6,2,2,6,1,2,1,1,5,1,0,,,0,0,0,,,
"Aug 17, 2023 6:00 AM",58,33,25,21,11,10,28,14,14,14,8,6,0,0,0,6,17,17,0,14,7,7,18,19,7,5,2,40,2,0,,,2,2,0,,,
"Aug 17, 2023 7:00 AM",126,89,37,74,25,49,78,20,58,70,18,52,0,0,0,14,85,83,2,23,11,12,84,28,32,7,25,112,3,0,,,6,4,2,,,
"Aug 17, 2023 8:00 AM",222,157,65,96,32,64,126,45,81,101,45,56,0,0,0,14,134,134,0,30,15,15,135,56,72,20,52,184,8,0,,,5,5,0,,,
"Aug 17, 2023 9:00 AM",119,97,22,70,29,41,85,39,46,66,35,31,0,0,0,11,54,54,0,20,10,10,44,24,60,25,35,64,1,0,,,4,2,2,,,
"Aug 17, 2023 10:00 AM",51,30,21,85,33,52,81,55,26,70,41,29,0,0,0,11,26,25,1,11,5,6,18,24,29,11,18,31,7,0,,,4,3,1,,,
"Aug 17, 2023 11:00 AM",48,31,17,74,35,39,92,53,39,68,39,29,0,0,0,12,22,20,2,13,6,7,19,16,38,17,21,29,5,0,,,7,5,2,,,
"Aug 17, 2023 12:00 PM",61,38,23,107,63,44,97,59,38,76,44,32,0,0,0,12,18,17,1,18,9,9,15,25,56,30,26,35,8,0,,,4,4,0,,,
"Aug 17, 2023 1:00 PM",76,36,40,108,46,62,127,68,59,72,44,28,0,0,0,13,20,18,2,44,22,22,13,22,52,28,24,26,10,0,,,10,8,2,,,
"Aug 17, 2023 2:00 PM",75,33,42,92,44,48,110,68,42,70,41,29,0,0,0,13,17,15,2,44,22,22,19,42,64,41,23,23,3,0,,,3,2,1,,,
"Aug 17, 2023 3:00 PM",71,28,43,86,49,37,126,66,60,63,39,24,0,0,0,17,28,18,10,26,13,13,13,28,56,28,28,28,6,0,,,8,5,3,,,
"Aug 17, 2023 4:00 PM",121,32,89,111,49,62,141,69,72,107,54,53,0,0,0,27,23,14,9,78,38,40,16,71,67,32,35,49,11,0,,,11,7,4,,,
"Aug 17, 2023 5:00 PM",213,61,152,124,62,62,191,126,65,144,104,40,0,0,0,21,35,31,4,186,93,92,32,124,97,67,30,72,8,0,,,3,1,2,,,
"Aug 17, 2023 6:00 PM",178,57,121,114,96,18,128,110,18,118,95,23,0,0,0,23,38,35,3,162,78,82,35,112,83,68,15,39,3,0,,,10,7,3,,,
"Aug 17, 2023 7:00 PM",83,25,58,80,45,35,78,55,23,74,38,36,0,0,0,13,16,12,4,69,35,34,15,49,22,17,5,24,1,0,,,2,0,2,,,
"Aug 17, 2023 8:00 PM",72,18,54,56,12,44,63,15,48,57,8,49,0,0,0,8,12,10,2,35,16,18,9,28,27,14,13,33,2,0,,,7,4,3,,,
"Aug 17, 2023 9:00 PM",35,12,23,17,11,6,41,5,36,36,6,30,0,0,0,13,7,6,1,14,6,7,6,19,14,8,6,16,2,0,,,9,5,4,,,
"Aug 17, 2023 10:00 PM",41,7,34,23,19,4,21,3,18,22,5,17,0,0,0,8,4,4,0,24,12,12,5,12,8,6,2,13,5,0,,,8,7,1,,,
"Aug 17, 2023 11:00 PM",16,7,9,14,10,4,11,4,7,9,1,8,0,0,0,5,3,2,1,10,5,5,3,11,5,4,1,9,0,0,,,1,0,1,,,
"Aug 18, 2023 12:00 AM",5,0,5,0,0,0,3,1,2,7,5,2,0,0,0,1,3,3,0,8,4,4,3,4,2,1,1,6,0,0,,,2,0,2,,,
"Aug 18, 2023 1:00 AM",3,0,3,3,3,0,1,1,0,2,1,1,0,0,0,0,1,1,0,4,2,2,1,3,3,1,2,1,0,0,,,1,0,1,,,
"Aug 18, 2023 2:00 AM",5,2,3,0,0,0,2,1,1,3,2,1,0,0,0,0,0,0,0,0,0,0,0,2,0,0,0,1,0,0,,,0,0,0,,,
"Aug 18, 2023 3:00 AM",2,0,2,0,0,0,0,0,0,0,0,0,0,0,0,0,0,0,0,0,0,0,0,1,0,0,0,0,0,0,,,1,0,1,,,
"Aug 18, 2023 4:00 AM",2,0,2,0,0,0,1,1,0,0,0,0,0,0,0,0,0,0,0,1,0,0,0,0,0,0,0,1,0,0,,,0,0,0,,,
"Aug 18, 2023 5:00 AM",1,1,0,0,0,0,4,2,2,2,0,2,0,0,0,2,5,5,0,4,1,1,6,3,2,0,2,2,0,0,,,0,0,0,,,
"Aug 18, 2023 6:00 AM",39,21,18,14,8,6,20,11,9,13,9,4,0,0,0,1,13,13,0,10,5,5,12,13,2,1,1,25,1,0,,,1,1,0,,,
"Aug 18, 2023 7:00 AM",63,40,23,27,8,19,31,5,26,28,9,19,0,0,0,8,33,31,2,15,7,7,29,17,10,4,6,62,3,0,,,2,2,0,,,
"Aug 18, 2023 8:00 AM",75,60,15,33,9,24,37,18,19,31,13,18,0,0,0,9,47,46,1,12,6,6,43,32,13,5,8,58,5,0,,,3,2,1,,,
"Aug 18, 2023 9:00 AM",61,47,14,21,7,14,16,9,7,24,17,7,0,0,0,3,18,17,1,11,5,5,15,3,13,6,7,28,0,0,,,4,1,3,,,
"Aug 18, 2023 10:00 AM",23,12,11,10,6,4,17,6,11,14,5,9,0,0,0,3,3,3,0,4,2,2,4,10,8,7,1,13,1,0,,,1,0,1,,,
"Aug 18, 2023 11:00 AM",19,11,8,13,11,2,15,13,2,15,12,3,0,0,0,2,5,5,0,6,3,3,3,5,4,3,1,16,5,0,,,7,6,1,,,
"Aug 18, 2023 12:00 PM",45,23,22,17,8,9,20,10,10,14,5,9,0,0,0,8,11,10,1,12,6,6,7,4,11,7,4,16,2,0,,,5,3,2,,,
"Aug 18, 2023 1:00 PM",56,16,40,19,10,9,33,16,17,11,6,5,0,0,0,13,8,8,0,15,7,8,8,18,15,9,6,10,3,0,,,2,2,0,,,
"Aug 18, 2023 2:00 PM",45,25,20,21,9,12,33,22,11,19,11,8,0,0,0,8,8,8,0,22,11,11,8,18,16,12,4,12,3,0,,,4,1,3,,,
"Aug 18, 2023 3:00 PM",51,25,26,23,13,10,28,21,7,25,18,7,0,0,0,5,11,10,1,24,12,12,11,21,11,5,6,10,6,0,,,8,5,3,,,
"Aug 18, 2023 4:00 PM",69,23,46,28,15,13,25,14,11,24,13,11,0,0,0,6,19,15,4,48,24,24,16,26,14,8,6,17,4,0,,,3,2,1,,,
"Aug 18, 2023 5:00 PM",92,21,71,17,14,3,37,16,21,19,12,7,0,0,0,12,15,15,0,74,36,38,17,34,15,8,7,21,2,0,,,3,2,1,,,
"Aug 18, 2023 6:00 PM",48,11,37,8,7,1,21,18,3,15,11,4,0,0,0,10,11,9,2,51,25,26,10,25,21,19,2,8,3,0,,,3,1,2,,,
"Aug 18, 2023 7:00 PM",36,15,21,3,1,2,9,8,1,5,2,3,0,0,0,3,4,4,0,12,6,6,4,5,4,3,1,6,0,0,,,1,1,0,,,
"Aug 18, 2023 8:00 PM",19,9,10,1,1,0,5,4,1,3,3,0,0,0,0,1,4,4,0,4,2,2,4,7,1,1,0,8,0,0,,,2,1,1,,,
"Aug 18, 2023 9:00 PM",15,5,10,2,2,0,2,1,1,1,1,0,0,0,0,2,1,1,0,6,3,3,2,3,4,4,0,3,0,0,,,4,3,1,,,
"Aug 18, 2023 10:00 PM",12,4,8,1,1,0,1,1,0,1,1,0,0,0,0,0,4,3,1,4,2,2,4,1,2,2,0,2,0,0,,,1,0,1,,,
"Aug 18, 2023 11:00 PM",8,2,6,2,1,1,3,2,1,2,0,2,0,0,0,4,3,3,0,3,1,1,2,1,0,0,0,1,0,0,,,0,0,0,,,
"Aug 19, 2023 12:00 AM",1,0,1,0,0,0,0,0,0,2,1,1,0,0,0,0,1,1,0,0,0,0,1,1,1,1,0,3,0,0,,,0,0,0,,,
"Aug 19, 2023 1:00 AM",2,1,1,0,0,0,2,2,0,0,0,0,0,0,0,0,0,0,0,0,0,0,0,1,1,1,0,1,0,0,,,0,0,0,,,
"Aug 19, 2023 2:00 AM",2,1,1,1,1,0,1,1,0,1,1,0,0,0,0,0,1,1,0,0,0,0,0,0,0,0,0,2,0,0,,,0,0,0,,,
"Aug 19, 2023 3:00 AM",0,0,0,0,0,0,0,0,0,0,0,0,0,0,0,0,0,0,0,0,0,0,0,1,0,0,0,0,0,0,,,0,0,0,,,
"Aug 19, 2023 4:00 AM",3,0,3,0,0,0,0,0,0,0,0,0,0,0,0,0,1,1,0,0,0,0,1,0,0,0,0,0,0,0,,,0,0,0,,,
"Aug 19, 2023 5:00 AM",1,0,1,0,0,0,1,0,1,0,0,0,0,0,0,1,1,1,0,2,1,1,1,1,1,1,0,3,0,0,,,1,1,0,,,
"Aug 19, 2023 6:00 AM",10,6,4,6,1,5,4,2,2,2,1,1,0,0,0,0,4,4,0,4,2,2,3,0,1,1,0,5,0,0,,,0,0,0,,,
"Aug 19, 2023 7:00 AM",20,9,11,7,1,6,11,8,3,8,5,3,0,0,0,3,6,6,0,1,0,1,7,8,2,1,1,4,0,0,,,2,2,0,,,
"Aug 19, 2023 8:00 AM",20,14,6,22,18,4,13,12,1,19,18,1,0,0,0,11,6,6,0,14,7,7,4,10,4,4,0,9,0,0,,,1,1,0,,,
"Aug 19, 2023 9:00 AM",27,20,7,56,29,27,40,31,9,49,36,13,0,0,0,7,11,11,0,7,3,3,13,15,15,11,4,11,0,0,,,4,3,1,,,
"Aug 19, 2023 10:00 AM",35,18,17,73,37,36,55,34,21,44,26,18,0,0,0,17,17,16,1,21,10,11,14,18,19,10,9,18,5,0,,,10,9,1,,,
"Aug 19, 2023 11:00 AM",42,20,22,75,40,35,66,39,27,59,37,22,0,0,0,8,8,8,0,19,9,8,11,12,25,19,6,32,6,0,,,9,5,4,,,
"Aug 19, 2023 12:00 PM",44,23,21,113,52,61,122,73,49,81,55,26,0,0,0,17,16,15,1,27,13,13,14,25,44,31,13,25,4,0,,,5,2,3,,,
"Aug 19, 2023 1:00 PM",51,25,26,122,53,69,107,57,50,85,46,39,0,0,0,17,17,16,1,17,8,8,17,16,53,28,25,32,2,0,,,4,2,2,,,
"Aug 19, 2023 2:00 PM",51,27,24,87,45,42,109,60,49,61,32,29,0,0,0,30,13,13,0,27,13,13,14,35,64,27,37,37,4,0,,,2,0,2,,,
"Aug 19, 2023 3:00 PM",45,25,20,117,57,60,119,55,64,102,59,43,0,0,0,18,17,14,3,16,8,8,11,31,47,24,23,29,2,0,,,9,7,2,,,
"Aug 19, 2023 4:00 PM",61,39,22,117,54,63,120,58,62,91,41,50,0,0,0,20,14,14,0,8,4,4,15,22,73,33,40,37,7,0,,,3,0,3,,,
"Aug 19, 2023 5:00 PM",47,18,29,78,38,40,69,20,49,52,15,37,0,0,0,10,20,20,0,17,9,8,24,14,28,9,19,35,2,0,,,3,2,1,,,
"Aug 19, 2023 6:00 PM",32,13,19,49,36,13,50,26,24,37,22,15,0,0,0,13,8,7,1,21,10,10,4,12,26,10,16,18,1,0,,,4,1,3,,,
"Aug 19, 2023 7:00 PM",47,16,31,50,24,26,38,14,24,37,19,18,0,0,0,8,6,4,2,12,5,7,6,11,23,8,15,9,0,0,,,6,2,4,,,
"Aug 19, 2023 8:00 PM",36,15,21,33,14,19,36,18,18,25,13,12,0,0,0,6,8,7,1,24,11,11,7,15,8,5,3,12,2,0,,,4,2,2,,,
"Aug 19, 2023 9:00 PM",26,12,14,15,7,8,19,6,13,6,2,4,0,0,0,3,3,3,0,10,5,5,3,5,9,7,2,6,3,0,,,2,2,0,,,
"Aug 19, 2023 10:00 PM",18,6,12,12,8,4,8,1,7,16,11,5,0,0,0,6,5,4,1,4,2,2,4,6,4,1,3,9,0,0,,,2,2,0,,,
"Aug 19, 2023 11:00 PM",12,6,6,11,5,6,10,6,4,7,2,5,0,0,0,0,5,5,0,16,8,8,5,7,4,4,0,7,0,0,,,0,0,0,,,
"Aug 20, 2023 12:00 AM",13,1,12,0,0,0,1,1,0,3,1,2,0,0,0,0,5,4,1,2,1,1,2,6,0,0,0,11,0,0,,,1,1,0,,,
"Aug 20, 2023 1:00 AM",6,2,4,2,0,2,6,2,4,4,2,2,0,0,0,1,2,2,0,10,5,5,2,5,1,0,1,3,0,0,,,0,0,0,,,
"Aug 20, 2023 2:00 AM",7,4,3,1,0,1,3,2,1,1,0,1,0,0,0,0,0,0,0,0,0,0,0,3,1,1,0,2,1,0,,,0,0,0,,,
"Aug 20, 2023 3:00 AM",5,0,5,0,0,0,0,0,0,0,0,0,0,0,0,0,0,0,0,2,1,1,0,3,1,1,0,3,0,0,,,0,0,0,,,
"Aug 20, 2023 4:00 AM",2,0,2,0,0,0,1,1,0,0,0,0,0,0,0,0,1,1,0,2,1,1,1,0,0,0,0,0,0,0,,,0,0,0,,,
"Aug 20, 2023 5:00 AM",0,0,0,1,0,1,5,4,1,1,1,0,0,0,0,3,1,1,0,1,0,0,1,2,4,3,1,1,0,0,,,0,0,0,,,
"Aug 20, 2023 6:00 AM",10,7,3,11,7,4,6,4,2,8,6,2,0,0,0,0,6,6,0,2,1,1,7,3,1,1,0,9,0,0,,,1,1,0,,,
"Aug 20, 2023 7:00 AM",14,7,7,42,20,22,34,25,9,35,24,11,0,0,0,3,7,7,0,12,5,5,9,23,8,7,1,11,0,0,,,0,0,0,,,
"Aug 20, 2023 8:00 AM",32,15,17,64,40,24,59,41,18,50,36,14,0,0,0,14,9,9,0,12,6,6,8,23,17,9,8,17,1,0,,,1,0,1,,,
"Aug 20, 2023 9:00 AM",32,21,11,112,61,51,105,65,40,104,63,41,0,0,0,14,22,21,1,29,15,14,18,24,45,35,10,34,2,0,,,4,3,1,,,
"Aug 20, 2023 10:00 AM",49,25,24,178,104,74,145,94,51,153,102,51,0,0,0,14,16,16,0,14,7,7,18,47,60,31,29,24,6,0,,,5,2,3,,,
"Aug 20, 2023 11:00 AM",43,20,23,171,80,91,171,97,74,137,75,62,0,0,0,18,12,12,0,44,22,21,10,42,64,47,17,48,8,0,,,7,3,4,,,
"Aug 20, 2023 12:00 PM",47,24,23,217,98,119,222,111,111,180,81,99,0,0,0,21,20,20,0,54,26,27,22,48,87,53,34,63,18,0,,,6,6,0,,,
"Aug 20, 2023 1:00 PM",50,32,18,176,87,89,199,107,92,159,90,69,0,0,0,29,19,18,1,34,16,18,14,48,87,55,32,54,6,0,,,4,4,0,,,
"Aug 20, 2023 2:00 PM",61,30,31,218,114,104,294,186,108,224,142,82,0,0,0,40,22,20,2,26,13,13,18,41,132,85,47,40,7,0,,,13,7,6,,,
"Aug 20, 2023 3:00 PM",51,25,26,201,103,98,240,120,120,173,93,80,0,0,0,24,19,17,2,30,15,15,13,47,123,66,57,53,4,0,,,14,11,3,,,
"Aug 20, 2023 4:00 PM",49,20,29,217,97,120,251,111,140,179,79,100,0,0,0,10,26,23,3,24,11,11,18,39,114,47,67,60,9,0,,,7,5,2,,,
"Aug 20, 2023 5:00 PM",46,25,21,178,81,97,218,75,143,161,64,97,0,0,0,20,11,10,1,24,12,12,10,28,91,30,61,54,3,0,,,7,4,3,,,
"Aug 20, 2023 6:00 PM",45,17,28,133,48,85,116,43,73,87,35,52,0,0,0,29,21,20,1,33,17,16,23,23,68,27,41,57,4,0,,,5,4,1,,,
"Aug 20, 2023 7:00 PM",47,24,23,104,45,59,110,40,70,76,35,41,0,0,0,12,21,21,0,14,7,7,19,24,34,14,20,27,4,0,,,3,2,1,,,
"Aug 20, 2023 8:00 PM",41,13,28,65,27,38,63,22,41,51,20,31,0,0,0,11,9,9,0,14,7,7,8,13,26,13,13,37,1,0,,,5,3,2,,,
"Aug 20, 2023 9:00 PM",26,8,18,29,13,16,34,9,25,24,5,19,0,0,0,5,7,6,1,6,3,3,6,10,14,3,11,13,0,0,,,1,1,0,,,
"Aug 20, 2023 10:00 PM",20,7,13,7,2,5,7,1,6,8,2,6,0,0,0,4,8,8,0,16,8,8,7,7,10,5,5,10,3,0,,,3,2,1,,,
"Aug 20, 2023 11:00 PM",12,7,5,2,0,2,4,2,2,3,1,2,0,0,0,6,5,5,0,7,3,3,5,4,2,2,0,6,1,0,,,4,1,3,,,
"Aug 21, 2023 12:00 AM",2,0,2,0,0,0,0,0,0,1,1,0,0,0,0,2,0,0,0,4,2,2,0,2,1,1,0,2,0,0,,,0,0,0,,,
"Aug 21, 2023 1:00 AM",3,3,0,1,1,0,1,1,0,0,0,0,0,0,0,1,2,2,0,3,1,2,2,1,2,0,2,2,0,0,,,0,0,0,,,
"Aug 21, 2023 2:00 AM",2,1,1,0,0,0,0,0,0,0,0,0,0,0,0,0,0,0,0,0,0,0,0,0,0,0,0,0,1,0,,,0,0,0,,,
"Aug 21, 2023 3:00 AM",1,0,1,0,0,0,0,0,0,0,0,0,0,0,0,3,0,0,0,2,1,1,1,1,0,0,0,0,0,0,,,1,1,0,,,
"Aug 21, 2023 4:00 AM",4,0,4,0,0,0,0,0,0,0,0,0,0,0,0,0,1,1,0,0,0,0,1,0,1,1,0,1,0,0,,,0,0,0,,,
"Aug 21, 2023 5:00 AM",6,5,1,2,2,0,5,2,3,4,3,1,0,0,0,2,6,6,0,4,1,1,7,3,3,0,3,4,0,0,,,0,0,0,,,
"Aug 21, 2023 6:00 AM",43,29,14,11,2,9,19,8,11,14,3,11,0,0,0,5,21,21,0,10,5,5,22,11,5,1,4,28,3,0,,,2,2,0,,,
"Aug 21, 2023 7:00 AM",136,102,34,54,19,35,74,20,54,67,25,42,0,0,0,18,91,89,2,30,14,16,83,34,32,6,26,121,7,0,,,4,2,2,,,
"Aug 21, 2023 8:00 AM",174,128,46,88,17,71,122,39,83,93,38,55,0,0,0,21,134,132,2,33,16,17,141,36,83,22,61,146,6,0,,,2,2,0,,,
"Aug 21, 2023 9:00 AM",100,83,17,70,30,40,79,39,40,72,42,30,0,0,0,15,53,52,1,20,10,10,48,24,42,16,26,59,5,0,,,7,7,0,,,
"Aug 21, 2023 10:00 AM",53,37,16,65,27,38,50,28,22,54,32,22,0,0,0,8,27,27,0,15,8,7,26,21,38,23,15,32,1,0,,,6,4,2,,,
"Aug 21, 2023 11:00 AM",39,17,22,88,53,35,74,43,31,64,36,28,0,0,0,16,7,7,0,16,8,8,5,29,26,18,8,25,5,0,,,8,5,3,,,
"Aug 21, 2023 12:00 PM",59,23,36,76,37,39,92,48,44,58,29,29,0,0,0,27,19,15,4,20,10,10,14,24,53,24,29,19,1,0,,,2,1,1,,,
"Aug 21, 2023 1:00 PM",63,27,36,93,50,43,95,58,37,69,39,30,0,0,0,16,10,10,0,24,12,12,11,21,37,20,17,33,8,0,,,12,8,4,,,
"Aug 21, 2023 2:00 PM",61,26,35,83,51,32,102,60,42,56,39,17,0,0,0,18,12,11,1,33,17,16,10,31,46,30,16,27,3,0,,,10,6,4,,,
"Aug 21, 2023 3:00 PM",71,33,38,74,39,35,125,70,55,75,43,32,0,0,0,19,25,21,4,45,22,23,18,30,70,39,31,20,3,0,,,7,3,4,,,
"Aug 21, 2023 4:00 PM",114,35,79,69,35,34,139,72,67,85,48,37,0,0,0,32,30,27,3,86,42,44,23,61,59,35,24,38,4,0,,,6,3,3,,,
"Aug 21, 2023 5:00 PM",173,44,129,116,70,46,216,118,98,131,70,61,0,0,0,32,34,28,6,205,101,104,28,137,92,63,29,67,12,0,,,14,10,4,,,
"Aug 21, 2023 6:00 PM",195,50,145,128,77,51,215,133,82,158,99,59,0,0,0,23,33,29,4,204,102,102,25,108,116,80,36,55,5,0,,,11,8,3,,,
"Aug 21, 2023 7:00 PM",101,30,71,114,66,48,171,99,72,116,73,43,0,0,0,16,22,17,5,70,35,35,15,54,82,41,41,41,6,0,,,9,2,7,,,
"Aug 21, 2023 8:00 PM",77,27,50,104,50,54,126,50,76,90,40,50,0,0,0,19,21,18,3,43,21,21,14,35,45,21,24,34,4,0,,,5,2,3,,,
"Aug 21, 2023 9:00 PM",33,3,30,28,6,22,38,11,27,31,7,24,0,0,0,5,7,6,1,18,9,9,8,14,18,7,11,20,2,0,,,4,3,1,,,
"Aug 21, 2023 10:00 PM",19,6,13,17,5,12,18,2,16,20,7,13,0,0,0,2,3,2,1,20,10,10,3,7,5,4,1,12,2,0,,,5,2,3,,,
"Aug 21, 2023 11:00 PM",7,2,5,4,4,0,5,2,3,1,0,1,0,0,0,4,2,1,1,6,3,3,1,9,5,4,1,6,0,0,,,4,2,2,,,
"Aug 22, 2023 12:00 AM",5,2,3,0,0,0,2,1,1,7,2,5,0,0,0,1,3,3,0,2,1,1,3,4,3,1,2,1,0,0,,,1,0,1,,,
"Aug 22, 2023 1:00 AM",4,1,3,0,0,0,1,1,0,0,0,0,0,0,0,0,0,0,0,0,0,0,0,0,1,1,0,0,0,0,,,0,0,0,,,
"Aug 22, 2023 2:00 AM",2,1,1,0,0,0,0,0,0,0,0,0,0,0,0,0,1,1,0,10,5,5,1,0,0,0,0,1,0,0,,,1,0,1,,,
"Aug 22, 2023 3:00 AM",0,0,0,0,0,0,0,0,0,0,0,0,0,0,0,0,0,0,0,0,0,0,0,0,0,0,0,0,0,0,,,0,0,0,,,
"Aug 22, 2023 4:00 AM",4,1,3,0,0,0,0,0,0,1,0,1,0,0,0,0,0,0,0,1,0,0,0,0,0,0,0,1,0,0,,,0,0,0,,,
"Aug 22, 2023 5:00 AM",12,7,5,5,3,2,4,1,3,5,3,2,0,0,0,3,8,8,0,7,3,2,8,0,3,2,1,7,0,0,,,0,0,0,,,
"Aug 22, 2023 6:00 AM",52,33,19,17,3,14,18,6,12,20,8,12,0,0,0,8,15,14,1,9,5,4,14,14,6,3,3,47,3,0,,,3,2,1,,,
"Aug 22, 2023 7:00 AM",131,86,45,82,29,53,93,27,66,88,33,55,0,0,0,16,99,99,0,23,11,11,103,40,37,10,27,135,6,0,,,10,10,0,,,
"Aug 22, 2023 8:00 AM",256,201,55,112,25,87,159,53,106,123,46,77,0,0,0,37,158,157,1,28,14,14,150,59,89,24,65,222,8,0,,,8,8,0,,,
"Aug 22, 2023 9:00 AM",112,94,18,73,36,37,82,37,45,91,58,33,0,0,0,11,69,67,2,15,8,7,53,27,57,20,37,83,2,0,,,6,3,3,,,
"Aug 22, 2023 10:00 AM",55,39,16,66,28,38,66,29,37,68,27,41,0,0,0,10,21,21,0,14,7,7,21,12,35,15,20,33,2,0,,,2,1,1,,,
"Aug 22, 2023 11:00 AM",42,18,24,67,38,29,49,25,24,41,26,15,0,0,0,13,15,14,1,23,11,11,13,12,25,16,9,32,5,0,,,3,1,2,,,
"Aug 22, 2023 12:00 PM",73,40,33,60,30,30,70,38,32,56,32,24,0,0,0,5,19,18,1,25,13,12,16,25,38,19,19,17,4,0,,,1,1,0,,,
"Aug 22, 2023 1:00 PM",71,33,38,88,44,44,77,41,36,63,33,30,0,0,0,16,18,16,2,31,15,16,13,16,22,8,14,35,8,0,,,10,4,6,,,
"Aug 22, 2023 2:00 PM",70,33,37,60,34,26,86,47,39,50,35,15,0,0,0,9,13,12,1,44,22,22,12,32,30,20,10,28,4,0,,,12,5,7,,,
"Aug 22, 2023 3:00 PM",65,27,38,64,34,30,91,57,34,40,27,13,0,0,0,14,17,15,2,56,28,28,17,32,57,37,20,15,0,0,,,3,3,0,,,
"Aug 22, 2023 4:00 PM",130,40,90,82,46,36,118,66,52,81,44,37,0,0,0,17,28,25,3,109,54,55,24,63,65,37,28,43,7,0,,,8,7,1,,,
"Aug 22, 2023 5:00 PM",239,65,174,150,89,61,230,141,89,156,96,60,0,0,0,43,41,33,8,220,108,111,32,148,115,86,29,71,16,0,,,15,10,5,,,
"Aug 22, 2023 6:00 PM",204,55,149,159,105,54,227,147,80,153,107,46,0,0,0,31,33,30,3,201,101,99,31,144,109,73,36,63,7,0,,,10,8,2,,,
"Aug 22, 2023 7:00 PM",110,29,81,67,33,34,97,45,52,63,30,33,0,0,0,26,23,20,3,87,42,44,20,54,63,44,19,30,2,0,,,6,3,3,,,
"Aug 22, 2023 8:00 PM",73,17,56,54,31,23,64,35,29,45,22,23,0,0,0,22,16,15,1,60,29,30,16,34,32,17,15,26,2,0,,,9,6,3,,,
"Aug 22, 2023 9:00 PM",54,21,33,39,25,14,33,11,22,36,14,22,0,0,0,9,12,10,2,24,13,11,10,13,13,7,6,13,2,0,,,2,2,0,,,
"Aug 22, 2023 10:00 PM",26,11,15,9,6,3,15,2,13,16,2,14,0,0,0,0,5,5,0,11,5,6,6,11,5,5,0,12,2,0,,,0,0,0,,,
"Aug 22, 2023 11:00 PM",18,4,14,6,5,1,7,2,5,7,3,4,0,0,0,4,3,3,0,16,7,8,2,7,5,4,1,7,0,0,,,0,0,0,,,
"Aug 23, 2023 12:00 AM",7,1,6,0,0,0,2,2,0,3,3,0,0,0,0,1,3,2,1,4,2,2,3,6,3,3,0,3,0,0,,,1,0,1,,,
"Aug 23, 2023 1:00 AM",2,1,1,1,1,0,0,0,0,1,0,1,0,0,0,0,0,0,0,2,1,1,0,0,0,0,0,2,0,0,,,1,1,0,,,
"Aug 23, 2023 2:00 AM",1,1,0,0,0,0,0,0,0,0,0,0,0,0,0,0,0,0,0,2,1,1,0,1,0,0,0,1,0,0,,,0,0,0,,,
"Aug 23, 2023 3:00 AM",1,1,0,0,0,0,0,0,0,0,0,0,0,0,0,0,0,0,0,0,0,0,0,0,0,0,0,0,0,0,,,0,0,0,,,
"Aug 23, 2023 4:00 AM",7,1,6,0,0,0,1,0,1,1,0,1,0,0,0,0,1,1,0,1,0,0,1,0,0,0,0,4,0,0,,,0,0,0,,,
"Aug 23, 2023 5:00 AM",14,9,5,9,6,3,7,6,1,8,6,2,0,0,0,2,6,6,0,8,3,3,7,6,1,0,1,7,0,0,,,0,0,0,,,
"Aug 23, 2023 6:00 AM",60,37,23,18,4,14,23,10,13,11,3,8,0,0,0,13,18,18,0,14,7,7,16,18,13,4,9,36,3,0,,,1,1,0,,,
"Aug 23, 2023 7:00 AM",138,86,52,74,19,55,91,25,66,69,25,44,0,0,0,16,91,90,1,33,16,17,85,40,45,16,29,130,9,0,,,6,6,0,,,
"Aug 23, 2023 8:00 AM",247,189,58,105,25,80,149,52,97,105,43,62,0,0,0,24,155,149,6,34,17,17,144,50,88,26,62,196,9,0,,,8,7,1,,,
"Aug 23, 2023 9:00 AM",107,87,20,83,34,49,83,40,43,81,42,39,0,0,0,12,45,45,0,22,11,11,38,13,61,23,38,78,3,0,,,5,4,1,,,
"Aug 23, 2023 10:00 AM",39,29,10,79,40,39,67,39,28,55,36,19,0,0,0,10,20,20,0,17,8,8,18,15,44,33,11,36,1,0,,,7,2,5,,,
"Aug 23, 2023 11:00 AM",42,30,12,60,34,26,92,49,43,83,45,38,0,0,0,20,26,24,2,22,11,11,25,13,45,25,20,26,11,0,,,7,7,0,,,
"Aug 23, 2023 12:00 PM",66,43,23,65,33,32,64,35,29,59,32,27,0,0,0,16,17,16,1,8,4,4,14,24,49,23,26,21,7,0,0,0,6,3,3,,,
"Aug 23, 2023 1:00 PM",62,29,33,56,29,27,71,39,32,50,25,25,5,3,2,9,19,18,1,18,9,9,16,17,28,18,10,26,5,0,,,8,3,5,,,
"Aug 23, 2023 2:00 PM",75,43,32,58,29,29,66,29,37,45,29,16,3,2,1,10,18,14,4,62,30,31,11,26,33,20,13,13,1,2,,,12,6,6,,,
"Aug 23, 2023 3:00 PM",70,19,51,46,24,22,61,32,29,44,21,23,24,9,15,16,13,11,2,43,21,21,9,30,26,9,17,21,3,3,,,6,5,1,,,
"Aug 23, 2023 4:00 PM",113,33,80,46,26,20,60,36,24,45,22,23,14,5,9,19,31,24,7,85,43,41,24,57,43,24,19,27,4,5,,,5,2,3,,,
"Aug 23, 2023 5:00 PM",211,46,165,65,43,22,107,59,48,73,41,32,23,10,13,35,33,29,4,219,109,109,26,117,62,45,17,60,7,5,,,14,7,7,,,
"Aug 23, 2023 6:00 PM",175,44,131,85,64,21,149,110,39,96,68,28,10,3,7,38,34,30,4,167,84,83,32,124,93,76,17,44,4,7,,,11,5,6,,,
"Aug 23, 2023 7:00 PM",102,30,72,84,51,33,135,74,61,92,56,36,9,4,5,28,15,15,0,82,41,40,12,75,49,33,16,52,3,4,,,8,4,4,,,
"Aug 23, 2023 8:00 PM",58,14,44,54,26,28,71,33,38,53,25,28,15,6,9,18,17,13,4,52,25,26,16,35,22,15,7,31,9,3,,,9,6,3,,,
"Aug 23, 2023 9:00 PM",56,21,35,17,10,7,33,11,22,17,9,8,2,1,1,2,12,11,1,34,17,17,13,14,10,4,6,21,2,2,,,3,3,0,,,
"Aug 23, 2023 10:00 PM",27,6,21,10,6,4,14,7,7,14,6,8,5,0,5,4,6,6,0,17,9,8,6,12,4,2,2,8,2,2,,,4,3,1,,,
"Aug 23, 2023 11:00 PM",19,4,15,5,5,0,7,3,4,5,2,3,2,0,2,4,2,2,0,9,4,4,3,4,0,0,0,5,1,0,,,1,1,0,,,
"Aug 24, 2023 12:00 AM",8,2,6,1,1,0,1,1,0,5,4,1,1,1,0,2,2,2,0,2,1,1,2,0,4,4,0,2,0,1,,,0,0,0,,,
"Aug 24, 2023 1:00 AM",3,2,1,0,0,0,1,1,0,0,0,0,2,0,2,1,0,0,0,2,1,1,0,1,0,0,0,4,0,1,,,0,0,0,,,
"Aug 24, 2023 2:00 AM",4,3,1,0,0,0,0,0,0,0,0,0,0,0,0,1,0,0,0,2,1,1,0,0,0,0,0,1,0,0,,,0,0,0,,,
"Aug 24, 2023 3:00 AM",3,1,2,0,0,0,0,0,0,0,0,0,0,0,0,1,0,0,0,2,1,1,0,0,1,1,0,0,0,0,,,0,0,0,,,
"Aug 24, 2023 4:00 AM",4,1,3,0,0,0,1,1,0,0,0,0,0,0,0,0,0,0,0,0,0,0,1,0,0,0,0,2,0,0,,,0,0,0,,,
"Aug 24, 2023 5:00 AM",7,4,3,4,2,2,6,3,3,4,3,1,0,0,0,1,8,8,0,7,3,3,8,3,1,0,1,8,0,0,,,0,0,0,,,
"Aug 24, 2023 6:00 AM",49,31,18,22,14,8,28,14,14,24,17,7,0,0,0,8,24,24,0,10,5,5,24,19,8,2,6,42,2,3,,,1,1,0,,,
"Aug 24, 2023 7:00 AM",137,90,47,64,21,43,83,32,51,66,25,41,12,7,5,14,66,66,0,20,10,10,61,23,40,13,27,122,4,2,,,6,5,1,,,
"Aug 24, 2023 8:00 AM",215,161,54,106,24,82,161,48,113,109,40,69,19,14,5,28,141,140,1,35,16,18,141,51,77,22,55,183,5,6,,,11,10,1,,,
"Aug 24, 2023 9:00 AM",110,87,23,74,35,39,80,41,39,80,52,28,9,2,7,11,69,69,0,25,12,12,53,21,62,20,42,89,2,6,,,5,4,1,,,
"Aug 24, 2023 10:00 AM",49,33,16,68,21,47,53,24,29,50,25,25,7,4,3,10,32,32,0,13,6,7,24,0,30,15,15,41,3,5,,,4,2,2,,,
"Aug 24, 2023 11:00 AM",53,32,21,82,51,31,80,47,33,72,44,28,21,10,11,11,28,25,3,35,17,17,23,0,30,20,10,25,7,6,,,4,2,2,,,
"Aug 24, 2023 12:00 PM",57,34,23,76,38,38,84,36,48,78,39,39,19,9,10,16,11,11,0,25,12,13,12,0,46,24,22,22,9,2,,,2,2,0,,,
"Aug 24, 2023 1:00 PM",61,28,33,49,27,22,71,47,24,55,36,19,11,5,6,16,23,22,1,27,13,13,24,0,45,31,14,25,4,4,,,8,4,4,,,
"Aug 24, 2023 2:00 PM",54,17,37,74,42,32,96,55,41,72,44,28,16,8,8,15,22,18,4,50,24,25,18,0,48,34,14,28,3,5,,,2,1,1,,,
"Aug 24, 2023 3:00 PM",98,36,62,86,46,40,101,69,32,75,49,26,21,7,14,14,21,17,4,52,26,26,19,0,55,32,23,25,2,1,,,8,5,3,,,
"Aug 24, 2023 4:00 PM",134,48,86,100,57,43,122,73,49,90,47,43,14,4,10,10,27,20,7,103,51,52,19,0,70,44,26,41,11,5,,,8,4,4,,,
"Aug 24, 2023 5:00 PM",221,72,149,157,68,89,240,149,91,160,103,57,32,19,13,31,32,29,3,174,86,88,32,0,96,64,32,67,5,2,,,9,6,3,,,
"Aug 24, 2023 6:00 PM",183,48,135,116,80,36,188,120,68,118,88,30,16,8,8,29,23,20,3,198,98,99,22,0,121,86,35,52,11,5,,,17,7,10,,,
"Aug 24, 2023 7:00 PM",119,45,74,123,77,46,156,98,58,93,64,29,24,10,14,30,20,19,1,82,40,41,18,0,68,39,29,45,7,2,,,11,7,4,,,
"Aug 24, 2023 8:00 PM",79,34,45,84,42,42,99,38,61,66,25,41,24,17,7,19,16,13,3,65,32,33,13,0,44,13,31,44,4,2,,,6,2,4,,,
"Aug 24, 2023 9:00 PM",43,11,32,50,34,16,51,12,39,41,11,30,10,5,5,11,12,11,1,19,9,9,9,0,20,5,15,21,1,0,,,4,2,2,,,
"Aug 24, 2023 10:00 PM",39,8,31,24,21,3,30,9,21,29,3,26,6,0,6,4,12,11,1,18,9,9,10,0,11,4,7,15,3,1,,,2,2,0,,,
"Aug 24, 2023 11:00 PM",16,4,12,11,10,1,10,5,5,5,3,2,0,0,0,2,4,4,0,24,12,12,4,0,4,3,1,8,0,1,,,3,1,2,,,
"Aug 25, 2023 12:00 AM",8,3,5,1,1,0,3,3,0,3,1,2,0,0,0,1,2,2,0,8,4,4,2,0,3,1,2,4,0,0,,,1,1,0,,,
"Aug 25, 2023 1:00 AM",5,1,4,0,0,0,6,1,5,5,1,4,0,0,0,0,0,0,0,2,1,1,0,0,0,0,0,2,0,2,,,0,0,0,,,
"Aug 25, 2023 2:00 AM",7,4,3,0,0,0,2,2,0,0,0,0,0,0,0,0,2,2,0,3,1,1,2,0,2,1,1,2,0,1,,,0,0,0,,,
"Aug 25, 2023 3:00 AM",2,0,2,0,0,0,0,0,0,0,0,0,0,0,0,0,0,0,0,0,0,0,0,0,0,0,0,0,0,0,,,0,0,0,,,
"Aug 25, 2023 4:00 AM",2,0,2,0,0,0,0,0,0,0,0,0,0,0,0,0,1,1,0,2,1,1,1,0,0,0,0,2,0,0,,,0,0,0,,,
"Aug 25, 2023 5:00 AM",7,4,3,1,1,0,2,0,2,1,1,0,0,0,0,1,6,6,0,6,2,2,7,0,5,4,1,5,0,1,,,0,0,0,,,
"Aug 25, 2023 6:00 AM",45,28,17,23,13,10,37,22,15,19,12,7,4,4,0,5,11,11,0,6,3,3,11,0,10,7,3,33,3,4,,,2,2,0,,,
"Aug 25, 2023 7:00 AM",86,57,29,57,22,35,89,35,54,61,34,27,7,5,2,11,54,54,0,27,13,13,57,0,35,12,23,71,5,2,,,11,9,2,,,
"Aug 25, 2023 8:00 AM",161,113,48,83,17,66,122,41,81,84,34,50,14,7,7,17,69,65,4,20,9,11,67,0,47,13,34,97,6,4,,,6,5,1,,,
"Aug 25, 2023 9:00 AM",101,75,26,72,30,42,70,33,37,61,39,22,11,9,2,11,40,39,1,31,15,15,35,0,37,16,21,47,3,2,,,8,7,1,,,
"Aug 25, 2023 10:00 AM",56,41,15,68,29,39,63,35,28,51,25,26,9,5,4,8,27,24,3,15,7,8,25,0,32,19,13,36,3,3,,,3,2,1,,,
"Aug 25, 2023 11:00 AM",47,26,21,58,30,28,61,33,28,57,36,21,15,11,4,10,21,17,4,26,13,13,15,0,45,26,19,17,1,3,,,6,4,2,,,
"Aug 25, 2023 12:00 PM",59,28,31,75,39,36,58,36,22,47,32,15,20,11,9,19,14,13,1,29,14,15,10,0,37,24,13,19,4,2,,,7,3,4,,,
"Aug 25, 2023 1:00 PM",72,28,44,69,34,35,67,34,33,54,25,29,21,12,9,8,18,16,2,31,15,15,15,0,42,20,22,29,3,0,,,7,2,5,,,
"Aug 25, 2023 2:00 PM",59,27,32,55,23,32,63,25,38,47,21,26,13,2,11,9,10,10,0,29,14,15,9,0,34,19,15,25,1,4,,,5,2,3,,,
"Aug 25, 2023 3:00 PM",74,34,40,47,35,12,56,44,12,44,33,11,12,2,10,14,17,13,4,46,23,23,11,0,39,34,5,17,1,1,,,3,2,1,,,
"Aug 25, 2023 4:00 PM",105,38,67,62,36,26,77,43,34,53,31,22,14,5,9,36,28,25,3,108,55,53,23,0,48,28,20,30,5,1,,,6,5,1,,,
"Aug 25, 2023 5:00 PM",131,38,93,75,52,23,114,68,46,78,49,29,18,6,12,36,18,15,3,114,56,57,13,0,69,46,23,52,5,5,,,8,3,5,,,
"Aug 25, 2023 6:00 PM",75,21,54,43,28,15,62,36,26,50,32,18,14,4,10,15,12,9,3,63,31,32,11,0,24,12,12,22,4,5,,,6,3,3,,,
"Aug 25, 2023 7:00 PM",81,30,51,17,11,6,29,21,8,16,8,8,6,5,1,11,20,19,1,29,14,15,14,0,23,18,5,13,2,3,,,3,2,1,,,
"Aug 25, 2023 8:00 PM",57,21,36,9,4,5,29,13,16,17,9,8,2,2,0,9,13,12,1,21,10,11,11,0,11,6,5,17,1,1,,,7,3,4,,,
"Aug 25, 2023 9:00 PM",39,10,29,17,11,6,15,2,13,15,4,11,4,2,2,5,6,4,2,14,7,7,4,0,5,4,1,8,0,0,,,2,2,0,,,
"Aug 25, 2023 10:00 PM",23,11,12,1,0,1,8,2,6,6,1,5,0,0,0,1,4,4,0,19,9,9,5,0,3,3,0,3,3,1,,,1,1,0,,,
"Aug 25, 2023 11:00 PM",14,4,10,7,5,2,7,1,6,5,1,4,0,0,0,3,1,1,0,19,9,9,1,0,2,1,1,7,0,0,,,1,0,1,,,
"Aug 26, 2023 12:00 AM",5,2,3,0,0,0,1,0,1,2,0,2,1,1,0,0,2,2,0,6,3,3,1,0,3,1,2,3,0,0,,,0,0,0,,,
"Aug 26, 2023 1:00 AM",11,2,9,1,0,1,3,1,2,2,0,2,0,0,0,0,1,1,0,4,2,2,1,0,0,0,0,5,0,0,,,0,0,0,,,
"Aug 26, 2023 2:00 AM",9,4,5,1,1,0,0,0,0,0,0,0,2,1,1,2,1,1,0,4,2,2,1,0,0,0,0,0,0,0,,,1,0,1,,,
"Aug 26, 2023 3:00 AM",4,1,3,0,0,0,0,0,0,0,0,0,0,0,0,0,0,0,0,0,0,0,1,0,0,0,0,0,1,0,,,0,0,0,,,
"Aug 26, 2023 4:00 AM",3,0,3,0,0,0,0,0,0,0,0,0,0,0,0,1,0,0,0,2,1,1,0,0,0,0,0,4,0,0,,,0,0,0,,,
"Aug 26, 2023 5:00 AM",4,0,4,1,1,0,3,3,0,1,1,0,0,0,0,1,0,0,0,2,1,1,1,0,1,0,1,0,0,0,,,0,0,0,,,
"Aug 26, 2023 6:00 AM",7,2,5,3,2,1,6,5,1,4,3,1,0,0,0,2,3,3,0,6,3,3,3,0,1,1,0,11,0,1,,,0,0,0,,,
"Aug 26, 2023 7:00 AM",24,11,13,24,14,10,27,20,7,25,18,7,3,0,3,4,10,9,1,8,4,4,11,0,13,8,5,17,1,2,,,2,2,0,,,
"Aug 26, 2023 8:00 AM",35,18,17,61,35,26,61,42,19,43,30,13,3,3,0,10,6,6,0,10,5,5,8,0,21,15,6,19,0,1,,,4,1,3,,,
"Aug 26, 2023 9:00 AM",35,20,15,71,37,34,89,63,26,76,58,18,8,5,3,10,20,18,2,14,7,7,19,0,33,22,11,27,1,5,,,3,1,2,,,
"Aug 26, 2023 10:00 AM",46,29,17,94,48,46,99,49,50,76,42,34,13,10,3,11,17,17,0,23,12,11,18,0,34,22,12,27,3,3,,,3,3,0,,,
"Aug 26, 2023 11:00 AM",42,27,15,101,60,41,92,51,41,88,55,33,14,7,7,5,14,14,0,22,10,10,17,0,52,35,17,18,8,6,,,16,10,6,,,
"Aug 26, 2023 12:00 PM",47,25,22,100,39,61,101,55,46,96,55,41,10,3,7,24,15,15,0,22,10,10,14,0,36,20,16,20,11,4,,,16,13,3,,,
"Aug 26, 2023 1:00 PM",45,23,22,77,44,33,62,33,29,71,44,27,27,12,15,18,15,14,1,26,13,13,15,0,32,16,16,24,2,4,,,3,2,1,,,
"Aug 26, 2023 2:00 PM",47,26,21,62,38,24,65,38,27,62,34,28,13,7,6,24,18,16,2,18,9,9,12,0,27,17,10,20,1,1,,,6,4,2,,,
"Aug 26, 2023 3:00 PM",43,26,17,67,31,36,66,37,29,67,31,36,20,9,11,26,11,11,0,16,7,8,12,0,25,12,13,20,2,3,,,7,4,3,,,
"Aug 26, 2023 4:00 PM",48,25,23,58,37,21,81,42,39,59,32,27,11,7,4,13,16,16,0,19,10,9,15,0,40,24,16,24,5,2,,,8,8,0,,,
"Aug 26, 2023 5:00 PM",44,13,31,53,31,22,44,16,28,38,13,25,23,12,11,21,11,8,3,31,15,15,11,0,32,8,24,19,0,2,,,0,0,0,,,
"Aug 26, 2023 6:00 PM",32,10,22,48,25,23,46,13,33,40,11,29,9,6,3,11,3,1,2,9,4,5,3,0,13,5,8,20,4,1,,,1,0,1,,,
"Aug 26, 2023 7:00 PM",31,8,23,26,17,9,25,9,16,14,8,6,12,7,5,8,9,9,0,11,5,6,9,0,15,5,10,10,1,2,,,3,3,0,,,
"Aug 26, 2023 8:00 PM",22,9,13,5,3,2,4,1,3,9,5,4,1,1,0,1,7,7,0,3,1,2,8,0,9,4,5,5,1,0,,,5,2,3,,,
"Aug 26, 2023 9:00 PM",25,10,15,13,8,5,8,4,4,7,1,6,6,2,4,4,3,3,0,7,3,3,4,0,3,2,1,8,2,1,,,1,1,0,,,
"Aug 26, 2023 10:00 PM",14,5,9,3,2,1,8,3,5,6,2,4,1,0,1,1,2,2,0,7,3,3,3,0,3,2,1,4,2,0,,,2,2,0,,,
"Aug 26, 2023 11:00 PM",22,9,13,7,6,1,3,0,3,4,0,4,3,3,0,3,2,2,0,1,0,1,3,0,0,0,0,2,0,1,,,0,0,0,,,
"Aug 27, 2023 12:00 AM",8,2,6,0,0,0,1,1,0,6,3,3,1,1,0,1,4,4,0,8,4,4,3,,0,0,0,6,0,0,,,0,0,0,,,
"Aug 27, 2023 1:00 AM",5,0,5,2,1,1,3,0,3,3,0,3,2,0,2,0,3,3,0,3,2,1,3,,0,0,0,5,0,0,,,0,0,0,,,
"Aug 27, 2023 2:00 AM",6,2,4,0,0,0,1,1,0,0,0,0,0,0,0,0,0,0,0,2,1,1,0,,1,1,0,1,0,0,,,0,0,0,,,
"Aug 27, 2023 3:00 AM",1,0,1,1,1,0,0,0,0,0,0,0,0,0,0,0,0,0,0,2,1,1,0,,0,0,0,0,1,0,,,1,0,1,,,
"Aug 27, 2023 4:00 AM",2,1,1,1,0,1,1,1,0,0,0,0,1,0,1,0,0,0,0,0,0,0,0,,0,0,0,0,0,0,,,1,0,1,,,
"Aug 27, 2023 5:00 AM",0,0,0,3,2,1,2,2,0,0,0,0,1,1,0,0,0,0,0,2,1,1,1,,0,0,0,1,0,0,,,0,0,0,,,
"Aug 27, 2023 6:00 AM",8,4,4,2,1,1,6,2,4,3,1,2,4,3,1,0,6,6,0,2,1,1,4,,3,2,1,7,0,0,,,1,1,0,,,
"Aug 27, 2023 7:00 AM",17,6,11,24,11,13,37,24,13,35,24,11,0,0,0,3,8,7,1,8,4,4,6,,7,3,4,21,0,2,,,0,0,0,,,
"Aug 27, 2023 8:00 AM",26,17,9,56,33,23,74,48,26,62,41,21,4,2,2,2,10,9,1,12,6,6,9,,21,12,9,20,1,6,,,2,0,2,,,
"Aug 27, 2023 9:00 AM",34,20,14,96,53,43,86,50,36,65,41,24,8,8,0,7,9,9,0,14,7,7,12,,21,15,6,13,8,17,,,7,3,4,,,
"Aug 27, 2023 10:00 AM",40,27,13,101,48,53,104,59,45,77,49,28,13,4,9,5,10,10,0,4,2,2,10,,36,26,10,38,7,1,,,3,3,0,,,
"Aug 27, 2023 11:00 AM",48,27,21,72,33,39,86,40,46,72,35,37,11,9,2,9,12,12,0,26,13,13,9,,32,19,13,20,8,3,,,7,6,1,,,
"Aug 27, 2023 12:00 PM",51,23,28,96,55,41,94,47,47,86,54,32,17,10,7,16,20,19,1,30,15,15,19,,40,27,13,29,3,5,,,6,2,4,,,
"Aug 27, 2023 1:00 PM",35,15,20,125,65,60,102,55,47,86,51,35,31,11,20,13,10,9,1,15,7,7,6,,43,28,15,26,2,3,,,7,4,3,,,
"Aug 27, 2023 2:00 PM",39,27,12,106,62,44,95,51,44,76,47,29,23,11,12,21,15,13,2,11,5,6,18,,47,26,21,29,5,2,,,6,5,1,,,
"Aug 27, 2023 3:00 PM",51,23,28,149,77,72,87,47,40,98,59,39,48,35,13,40,13,11,2,24,11,11,11,,41,23,18,26,4,2,,,2,2,0,,,
"Aug 27, 2023 4:00 PM",42,26,16,103,51,52,79,36,43,94,45,49,24,15,9,17,21,21,0,8,4,4,22,,43,23,20,21,1,3,,,6,4,2,,,
"Aug 27, 2023 5:00 PM",53,20,33,98,58,40,87,32,55,84,35,49,44,18,26,15,8,7,1,20,10,10,7,,56,22,34,20,1,0,,,4,2,2,,,
"Aug 27, 2023 6:00 PM",33,16,17,69,35,34,61,23,38,54,23,31,20,13,7,16,15,13,2,14,7,7,14,,29,10,19,28,0,2,,,6,4,2,,,
"Aug 27, 2023 7:00 PM",20,10,10,49,25,24,35,16,19,32,15,17,17,6,11,8,5,5,0,21,10,11,4,,20,7,13,21,2,2,,,3,2,1,,,
"Aug 27, 2023 8:00 PM",34,10,24,36,15,21,40,15,25,25,11,14,12,1,11,7,10,9,1,12,6,6,9,,12,6,6,9,1,2,,,1,1,0,,,
"Aug 27, 2023 9:00 PM",25,11,14,13,9,4,11,5,6,12,5,7,1,1,0,5,7,7,0,6,3,3,7,,5,3,2,6,0,0,,,0,0,0,,,
"Aug 27, 2023 10:00 PM",12,3,9,5,4,1,3,1,2,2,2,0,1,0,1,1,8,8,0,4,2,2,8,,1,1,0,5,4,2,,,2,1,1,,,
"Aug 27, 2023 11:00 PM",10,3,7,5,5,0,3,3,0,1,0,1,2,0,2,1,1,1,0,10,6,4,1,,0,0,0,1,0,0,,,1,0,1,,,
"Aug 28, 2023 12:00 AM",5,0,5,0,0,0,1,1,0,1,1,0,1,1,0,0,3,3,0,4,2,2,3,,1,1,0,1,0,0,,,1,1,0,,,
"Aug 28, 2023 1:00 AM",2,0,2,0,0,0,0,0,0,0,0,0,0,0,0,0,0,0,0,0,0,0,0,,0,0,0,0,2,1,,,1,1,0,,,
"Aug 28, 2023 2:00 AM",0,0,0,0,0,0,0,0,0,0,0,0,2,2,0,0,0,0,0,6,3,3,0,,0,0,0,0,0,0,,,0,0,0,,,
"Aug 28, 2023 3:00 AM",0,0,0,1,0,1,1,0,1,1,0,1,0,0,0,0,0,0,0,2,1,1,0,0,1,0,1,1,0,0,,,0,0,0,,,
"Aug 28, 2023 4:00 AM",5,0,5,0,0,0,1,0,1,1,0,1,1,1,0,0,1,1,0,1,0,0,1,0,0,0,0,1,0,0,,,0,0,0,,,
"Aug 28, 2023 5:00 AM",9,7,2,3,1,2,2,0,2,1,0,1,0,0,0,1,5,3,2,7,3,2,5,0,1,0,1,4,0,0,,,0,0,0,,,
"Aug 28, 2023 6:00 AM",47,31,16,21,9,12,33,15,18,20,8,12,5,2,3,9,26,25,1,8,4,4,23,0,5,3,2,41,5,5,,,4,4,0,,,
"Aug 28, 2023 7:00 AM",115,78,37,49,11,38,85,24,61,54,14,40,8,4,4,9,83,82,1,33,16,17,82,0,35,7,28,112,3,3,,,9,6,3,,,
"Aug 28, 2023 8:00 AM",239,172,67,61,15,46,124,42,82,90,41,49,24,14,10,21,122,119,3,23,11,11,121,0,68,16,52,184,4,5,,,9,7,2,,,
"Aug 28, 2023 9:00 AM",101,80,21,45,13,32,65,26,39,46,26,20,18,12,6,8,60,60,0,24,12,12,49,0,35,13,22,73,1,1,,,5,5,0,,,
"Aug 28, 2023 10:00 AM",58,34,24,43,20,23,66,35,31,41,23,18,15,9,6,7,24,24,0,22,11,11,22,0,25,16,9,25,3,4,,,4,3,1,,,
"Aug 28, 2023 11:00 AM",35,17,18,54,31,23,66,37,29,45,29,16,24,5,19,16,15,12,3,8,4,4,12,0,36,28,8,15,3,1,,,4,3,1,,,
"Aug 28, 2023 12:00 PM",57,38,19,87,38,49,94,47,47,66,32,34,19,8,11,14,10,10,0,22,11,11,7,0,45,19,26,28,4,5,,,8,5,3,,,
"Aug 28, 2023 1:00 PM",68,30,38,62,31,31,71,31,40,57,28,29,15,8,7,10,12,12,0,27,13,14,8,0,22,13,9,25,4,2,,,3,2,1,,,
"Aug 28, 2023 2:00 PM",64,25,39,70,30,40,48,28,20,40,30,10,9,5,4,14,9,9,0,24,12,12,11,0,23,10,13,19,3,4,,,9,6,3,,,
"Aug 28, 2023 3:00 PM",76,31,45,45,25,20,60,39,21,45,30,15,19,7,12,48,20,16,4,52,27,25,13,0,40,26,14,19,5,1,,,5,3,2,,,
"Aug 28, 2023 4:00 PM",140,41,99,54,36,18,71,49,22,69,41,28,17,6,11,21,31,26,5,96,47,49,25,0,51,37,14,53,6,4,,,5,3,2,,,
"Aug 28, 2023 5:00 PM",200,52,148,77,55,22,129,67,62,93,49,44,22,10,12,23,46,38,8,212,105,106,36,0,73,51,22,58,14,3,,,20,13,7,,,
"Aug 28, 2023 6:00 PM",167,41,126,89,61,28,132,94,38,100,65,35,24,10,14,24,24,18,6,183,90,93,18,0,87,71,16,41,5,6,,,16,8,8,,,
"Aug 28, 2023 7:00 PM",106,31,75,62,36,26,74,41,33,56,33,23,8,3,5,26,18,18,0,78,39,39,15,0,40,18,22,22,3,4,,,7,3,4,,,
"Aug 28, 2023 8:00 PM",66,19,47,49,29,20,48,20,28,41,17,24,5,0,5,13,12,10,2,38,18,19,10,0,21,7,14,26,4,2,,,4,4,0,,,
"Aug 28, 2023 9:00 PM",34,7,27,10,7,3,26,14,12,13,8,5,0,0,0,9,10,10,0,27,13,14,12,0,9,5,4,11,0,0,,,1,1,0,,,
"Aug 28, 2023 10:00 PM",22,9,13,10,4,6,8,3,5,6,4,2,1,0,1,1,8,8,0,6,3,3,7,0,3,1,2,4,1,0,,,2,2,0,,,
"Aug 28, 2023 11:00 PM",9,1,8,2,2,0,5,1,4,6,4,2,3,0,3,1,4,4,0,10,5,5,4,0,3,2,1,2,0,0,,,0,0,0,,,
"Aug 29, 2023 12:00 AM",7,1,6,0,0,0,1,1,0,1,1,0,0,0,0,0,1,1,0,6,3,3,3,0,2,2,0,2,0,0,,,0,0,0,,,
"Aug 29, 2023 1:00 AM",2,1,1,0,0,0,3,2,1,0,0,0,0,0,0,0,0,0,0,0,0,0,0,0,0,0,0,0,0,0,,,0,0,0,,,
"Aug 29, 2023 2:00 AM",2,2,0,1,1,0,0,0,0,0,0,0,1,0,1,0,0,0,0,0,0,0,0,0,1,1,0,1,0,0,,,0,0,0,,,
"Aug 29, 2023 3:00 AM",1,1,0,1,0,1,1,0,1,1,0,1,0,0,0,0,0,0,0,0,0,0,0,0,0,0,0,1,0,0,,,0,0,0,,,
"Aug 29, 2023 4:00 AM",3,1,2,0,0,0,0,0,0,0,0,0,0,0,0,0,2,2,0,0,0,0,2,0,1,0,1,1,0,0,,,1,1,0,,,
"Aug 29, 2023 5:00 AM",12,7,5,5,2,3,4,2,2,6,4,2,0,0,0,1,8,8,0,7,3,3,8,0,3,1,2,2,0,0,,,0,0,0,,,
"Aug 29, 2023 6:00 AM",60,36,24,20,6,14,34,7,27,24,7,17,0,0,0,7,25,25,0,15,7,7,24,0,13,3,10,44,1,5,,,3,2,1,,,
"Aug 29, 2023 7:00 AM",157,106,51,61,19,42,90,28,62,63,25,38,11,8,3,17,109,109,0,42,21,21,102,0,43,13,30,142,9,5,,,9,8,1,,,
"Aug 29, 2023 8:00 AM",268,209,59,113,20,93,179,57,122,138,51,87,40,27,13,37,172,170,2,38,19,19,167,0,110,29,81,242,10,13,,,9,9,0,,,
"Aug 29, 2023 9:00 AM",116,85,31,64,36,28,86,42,44,62,37,25,10,9,1,10,64,62,2,30,15,15,56,0,62,22,40,80,3,5,,,5,2,3,,,
"Aug 29, 2023 10:00 AM",57,40,17,57,31,26,64,36,28,63,38,25,14,10,4,6,24,24,0,19,9,9,23,0,31,17,14,28,3,4,,,6,4,2,,,
"Aug 29, 2023 11:00 AM",45,26,19,74,35,39,102,58,44,67,35,32,14,9,5,17,14,11,3,10,5,5,12,0,30,22,8,31,4,7,,,3,2,1,,,
"Aug 29, 2023 12:00 PM",54,30,24,59,28,31,80,35,45,41,26,15,14,8,6,19,19,16,3,22,10,11,16,0,40,23,17,23,4,2,,,5,2,3,,,
"Aug 29, 2023 1:00 PM",80,38,42,93,57,36,85,44,41,68,42,26,16,7,9,10,10,9,1,34,17,17,9,0,42,23,19,29,9,5,,,8,8,0,,,
"Aug 29, 2023 2:00 PM",65,22,43,56,23,33,74,45,29,55,27,28,24,14,10,25,16,16,0,31,15,16,15,0,49,29,20,22,5,2,,,5,2,3,,,
"Aug 29, 2023 3:00 PM",82,30,52,63,34,29,63,39,24,51,35,16,31,11,20,19,26,24,2,44,22,22,25,0,37,28,9,26,3,0,,,8,4,4,,,
"Aug 29, 2023 4:00 PM",136,35,101,86,56,30,105,64,41,89,54,35,27,8,19,24,28,24,4,96,48,47,26,0,74,50,24,53,7,3,,,7,4,3,,,
"Aug 29, 2023 5:00 PM",239,56,183,125,64,61,160,95,65,136,84,52,30,13,17,30,41,40,1,233,115,117,38,0,87,61,26,75,16,11,,,16,12,4,,,
"Aug 29, 2023 6:00 PM",219,60,159,124,82,42,188,134,54,137,93,44,20,9,11,33,43,41,2,212,105,107,40,0,105,86,19,59,9,11,,,11,6,5,,,
"Aug 29, 2023 7:00 PM",98,35,63,99,61,38,117,83,34,98,63,35,13,2,11,27,21,17,4,95,47,48,18,0,57,39,18,27,2,9,,,7,4,3,,,
"Aug 29, 2023 8:00 PM",81,25,56,57,31,26,89,45,44,75,37,38,7,4,3,15,14,12,2,56,27,27,12,0,41,30,11,35,8,7,,,7,4,3,,,
"Aug 29, 2023 9:00 PM",46,9,37,27,22,5,37,8,29,23,2,21,10,2,8,9,7,7,0,17,9,8,5,0,12,6,6,26,3,3,,,3,2,1,,,
"Aug 29, 2023 10:00 PM",27,5,22,12,10,2,8,3,5,9,2,7,2,1,1,5,18,17,1,17,8,9,17,0,4,3,1,8,3,1,,,0,0,0,,,
"Aug 29, 2023 11:00 PM",3,0,3,6,4,2,8,3,5,5,1,4,1,0,1,0,2,2,0,4,2,2,2,0,5,5,0,2,1,0,,,1,0,1,,,
"Aug 30, 2023 12:00 AM",6,2,4,0,0,0,1,0,1,4,1,3,0,0,0,1,1,1,0,2,1,1,0,0,3,2,1,4,0,0,,,0,0,0,,,
"Aug 30, 2023 1:00 AM",2,0,2,0,0,0,2,0,2,1,0,1,0,0,0,0,0,0,0,0,0,0,0,0,0,0,0,3,0,0,,,0,0,0,,,
"Aug 30, 2023 2:00 AM",3,2,1,0,0,0,0,0,0,0,0,0,1,0,1,0,0,0,0,2,1,1,0,0,0,0,0,1,0,0,,,0,0,0,,,
"Aug 30, 2023 3:00 AM",0,0,0,0,0,0,1,1,0,1,1,0,0,0,0,0,0,0,0,2,1,1,0,0,0,0,0,0,1,0,,,0,0,0,,,
"Aug 30, 2023 4:00 AM",5,1,4,1,0,1,0,0,0,1,0,1,2,2,0,0,0,0,0,1,0,0,0,0,2,1,1,0,0,0,,,0,0,0,,,
"Aug 30, 2023 5:00 AM",10,7,3,8,6,2,8,6,2,6,5,1,2,2,0,1,6,6,0,5,2,2,6,0,1,0,1,7,0,0,,,0,0,0,,,
"Aug 30, 2023 6:00 AM",56,34,22,19,10,9,30,14,16,21,12,9,3,1,2,4,21,21,0,17,9,8,19,0,7,3,4,42,1,5,,,1,1,0,,,
"Aug 30, 2023 7:00 AM",144,91,53,84,25,59,92,25,67,75,29,46,14,12,2,14,119,119,0,44,22,22,116,0,49,14,35,118,8,6,,,11,9,2,,,
"Aug 30, 2023 8:00 AM",271,205,66,110,31,79,176,59,117,134,56,78,35,24,11,35,135,128,7,84,43,39,132,0,98,28,70,238,4,7,,,18,15,3,,,
"Aug 30, 2023 9:00 AM",137,108,29,72,26,46,98,44,54,58,35,23,20,11,9,9,77,77,0,30,15,15,68,0,65,27,38,85,3,6,,,9,8,1,,,
"Aug 30, 2023 10:00 AM",60,45,15,42,24,18,86,50,36,45,29,16,13,9,4,12,35,35,0,10,5,5,27,0,38,20,18,29,2,1,,,1,1,0,,,
"Aug 30, 2023 11:00 AM",54,26,28,76,29,47,89,35,54,58,25,33,23,10,13,9,14,13,1,8,4,4,18,0,40,25,15,28,3,3,,,4,3,1,,,
"Aug 30, 2023 12:00 PM",62,41,21,60,30,30,100,49,51,50,25,25,21,15,6,7,27,26,1,22,11,11,21,0,45,27,18,32,2,0,,,5,2,3,,,
"Aug 30, 2023 1:00 PM",77,22,55,81,44,37,107,58,49,79,51,28,9,5,4,18,20,17,3,37,18,19,16,0,62,35,27,27,4,5,,,8,3,5,,,
"Aug 30, 2023 2:00 PM",54,29,25,69,33,36,69,38,31,48,27,21,22,8,14,22,14,12,2,50,25,25,9,0,33,21,12,26,3,7,,,16,6,10,,,
"Aug 30, 2023 3:00 PM",93,42,51,57,28,29,58,31,27,46,23,23,21,13,8,16,23,22,1,43,20,22,15,0,42,23,19,19,3,2,,,1,1,0,,,
"Aug 30, 2023 4:00 PM",128,41,87,61,38,23,95,52,43,69,35,34,13,7,6,33,31,24,7,127,63,64,26,0,60,37,23,43,4,7,,,5,3,2,,,
"Aug 30, 2023 5:00 PM",258,69,189,111,65,46,150,103,47,111,74,37,28,11,17,38,43,40,3,242,120,119,39,0,73,54,19,71,13,6,,,13,10,3,,,
"Aug 30, 2023 6:00 PM",229,55,174,111,75,36,153,112,41,129,91,38,19,7,12,31,35,29,6,216,109,107,29,0,83,67,16,58,10,3,,,5,1,4,,,
"Aug 30, 2023 7:00 PM",107,35,72,87,52,35,89,59,30,68,42,26,10,2,8,11,30,26,4,88,43,43,23,0,55,39,16,25,3,7,,,17,9,8,,,
"Aug 30, 2023 8:00 PM",86,24,62,80,36,44,73,32,41,69,29,40,11,5,6,9,16,14,2,61,30,30,15,0,34,18,16,32,5,3,,,9,4,5,,,
"Aug 30, 2023 9:00 PM",36,13,23,29,22,7,25,12,13,23,14,9,5,2,3,4,12,10,2,17,8,8,11,0,12,6,6,13,3,2,,,4,3,1,,,
"Aug 30, 2023 10:00 PM",31,7,24,16,11,5,14,4,10,12,4,8,0,0,0,1,10,10,0,14,7,7,9,0,8,4,4,8,3,0,,,5,3,2,,,
"Aug 30, 2023 11:00 PM",11,3,8,9,6,3,8,3,5,6,5,1,0,0,0,1,4,4,0,9,4,4,4,0,2,1,1,6,0,0,,,3,1,2,,,
"Aug 31, 2023 12:00 AM",12,1,11,0,0,0,2,1,1,1,0,1,0,0,0,2,4,4,0,4,2,2,5,0,4,2,2,2,1,1,,,0,0,0,,,
"Aug 31, 2023 1:00 AM",2,0,2,0,0,0,0,0,0,0,0,0,0,0,0,0,1,1,0,2,1,1,1,0,1,1,0,0,0,0,,,0,0,0,,,
"Aug 31, 2023 2:00 AM",4,3,1,1,1,0,2,1,1,1,1,0,0,0,0,0,0,0,0,0,0,0,0,0,0,0,0,3,0,0,,,0,0,0,,,
"Aug 31, 2023 3:00 AM",0,0,0,1,0,1,1,0,1,1,0,1,0,0,0,0,0,0,0,0,0,0,0,0,1,0,1,0,0,0,,,0,0,0,,,
"Aug 31, 2023 4:00 AM",5,1,4,0,0,0,0,0,0,0,0,0,0,0,0,0,1,1,0,0,0,0,1,0,0,0,0,1,0,0,,,0,0,0,,,
"Aug 31, 2023 5:00 AM",8,5,3,6,1,5,4,1,3,2,1,1,1,1,0,1,4,4,0,7,3,3,4,0,1,0,1,5,0,0,,,0,0,0,,,
"Aug 31, 2023 6:00 AM",44,25,19,21,9,12,30,16,14,20,10,10,0,0,0,6,23,23,0,15,8,7,24,0,8,5,3,24,1,3,,,2,2,0,,,
"Aug 31, 2023 7:00 AM",147,104,43,43,12,31,59,15,44,49,17,32,13,9,4,18,86,85,1,35,17,18,83,0,21,8,13,117,7,2,,,9,8,1,,,
"Aug 31, 2023 8:00 AM",194,143,51,60,11,49,105,24,81,61,16,45,25,12,13,27,132,124,8,54,27,27,126,0,76,17,59,202,8,4,,,11,9,2,,,
"Aug 31, 2023 9:00 AM",78,64,14,32,11,21,40,19,21,37,19,18,11,7,4,8,42,41,1,9,4,4,40,0,25,8,17,53,1,3,,,2,1,1,,,
"Aug 31, 2023 10:00 AM",55,41,14,22,9,13,28,15,13,15,13,2,9,7,2,11,26,25,1,12,6,6,21,0,15,7,8,27,3,0,,,7,5,2,,,
"Aug 31, 2023 11:00 AM",49,32,17,31,12,19,29,17,12,14,7,7,10,4,6,10,11,11,0,8,4,4,8,0,14,12,2,17,0,1,,,4,3,1,,,
"Aug 31, 2023 12:00 PM",44,23,21,23,17,6,39,21,18,25,16,9,14,9,5,5,14,13,1,14,7,7,10,0,16,10,6,13,4,1,,,3,1,2,,,
"Aug 31, 2023 1:00 PM",49,24,25,24,12,12,48,25,23,26,14,12,13,9,4,6,16,14,2,23,12,11,14,0,26,16,10,17,2,2,,,5,3,2,,,
"Aug 31, 2023 2:00 PM",49,20,29,23,14,9,37,22,15,26,18,8,12,6,6,16,13,11,2,24,11,13,13,0,20,14,6,13,0,0,,,5,4,1,,,
"Aug 31, 2023 3:00 PM",72,25,47,20,11,9,39,20,19,22,15,7,6,3,3,16,24,22,2,56,27,27,18,0,14,9,5,20,1,0,,,3,1,2,,,
"Aug 31, 2023 4:00 PM",106,30,76,36,23,13,69,42,27,61,30,31,18,6,12,22,22,21,1,84,42,42,21,0,34,27,7,41,5,4,,,7,3,4,,,
"Aug 31, 2023 5:00 PM",207,52,155,110,55,55,155,112,43,125,103,22,23,13,10,45,44,39,5,138,67,70,39,0,99,67,32,47,6,6,,,6,4,2,,,
"Aug 31, 2023 6:00 PM",167,46,121,93,71,22,114,83,31,93,64,29,20,3,17,31,20,18,2,185,93,92,17,0,64,53,11,35,4,5,,,9,5,4,,,
"Aug 31, 2023 7:00 PM",112,44,68,53,29,24,73,48,25,52,34,18,14,4,10,26,17,14,3,83,41,42,16,0,36,27,9,22,5,3,,,4,2,2,,,
"Aug 31, 2023 8:00 PM",65,19,46,49,23,26,59,27,32,57,29,28,4,3,1,15,13,12,1,48,23,24,12,0,20,15,5,40,2,1,,,2,0,2,,,
"Aug 31, 2023 9:00 PM",53,22,31,41,31,10,39,7,32,34,8,26,5,2,3,5,15,14,1,14,7,7,14,0,21,13,8,9,2,3,,,8,4,4,,,
"Aug 31, 2023 10:00 PM",33,11,22,18,15,3,24,3,21,26,2,24,3,0,3,4,6,4,2,15,7,7,4,0,5,5,0,13,1,0,,,2,1,1,,,
"Aug 31, 2023 11:00 PM",20,2,18,8,8,0,12,1,11,12,1,11,2,1,1,0,5,4,1,3,2,1,4,0,3,1,2,4,0,0,,,0,0,0,,,
"Sep 1, 2023 12:00 AM",12,4,8,0,0,0,0,0,0,7,0,7,2,1,1,0,3,3,0,5,2,2,3,0,1,1,0,6,0,0,,,1,0,1,,,
"Sep 1, 2023 1:00 AM",10,0,10,4,4,0,4,2,2,5,1,4,0,0,0,0,0,0,0,4,2,2,0,0,1,1,0,1,0,1,,,0,0,0,,,
"Sep 1, 2023 2:00 AM",4,1,3,0,0,0,0,0,0,0,0,0,0,0,0,0,1,1,0,4,2,2,1,0,0,0,0,2,1,1,,,1,1,0,,,
"Sep 1, 2023 3:00 AM",1,1,0,1,0,1,0,0,0,1,0,1,0,0,0,0,0,0,0,2,1,1,0,0,0,0,0,1,1,0,,,0,0,0,,,
"Sep 1, 2023 4:00 AM",2,1,1,0,0,0,1,0,1,0,0,0,0,0,0,0,0,0,0,1,0,0,1,0,1,0,1,0,0,0,,,0,0,0,,,
"Sep 1, 2023 5:00 AM",6,3,3,1,0,1,4,2,2,2,1,1,1,1,0,1,4,4,0,7,3,3,4,0,4,1,3,6,1,0,,,0,0,0,,,
"Sep 1, 2023 6:00 AM",44,26,18,14,7,7,25,10,15,20,10,10,3,2,1,6,14,14,0,10,5,5,14,0,7,3,4,33,2,4,,,2,2,0,,,
"Sep 1, 2023 7:00 AM",110,69,41,63,29,34,54,22,32,52,27,25,7,4,3,20,66,65,1,37,19,18,61,0,43,17,26,73,2,5,,,10,8,2,,,
"Sep 1, 2023 8:00 AM",206,143,63,98,34,64,147,56,91,109,48,61,36,19,17,31,106,98,8,37,18,19,94,0,83,24,59,139,5,6,,,18,16,2,,,
"Sep 1, 2023 9:00 AM",100,75,25,75,35,40,92,51,41,70,41,29,14,9,5,12,56,55,1,32,16,16,50,0,48,27,21,61,4,7,,,11,5,6,,,
"Sep 1, 2023 10:00 AM",48,32,16,72,36,36,70,40,30,61,40,21,17,12,5,13,19,19,0,12,6,6,13,0,28,19,9,29,2,3,,,0,0,0,,,
"Sep 1, 2023 11:00 AM",41,18,23,68,36,32,82,50,32,65,31,34,10,7,3,11,23,21,2,30,14,15,18,0,45,32,13,15,4,3,,,4,3,1,,,
"Sep 1, 2023 12:00 PM",63,28,35,98,39,59,114,50,64,80,37,43,25,18,7,8,22,20,2,29,14,15,20,0,45,20,25,38,4,7,,,7,4,3,,,
"Sep 1, 2023 1:00 PM",89,38,51,83,45,38,113,62,51,66,35,31,19,11,8,10,19,18,1,38,19,19,15,0,47,23,24,26,6,4,,,10,5,5,,,
"Sep 1, 2023 2:00 PM",79,37,42,65,31,34,92,49,43,53,30,23,16,10,6,13,21,20,1,50,25,25,22,0,46,29,17,20,2,5,,,9,6,3,,,
"Sep 1, 2023 3:00 PM",73,35,38,73,47,26,114,71,43,77,53,24,9,6,3,19,19,18,1,48,24,24,16,0,51,27,24,36,3,4,,,5,5,0,,,
"Sep 1, 2023 4:00 PM",120,37,83,110,52,58,137,82,55,91,56,35,25,5,20,17,25,21,4,82,40,41,23,0,55,32,23,41,5,1,,,8,6,2,,,
"Sep 1, 2023 5:00 PM",178,56,122,135,76,59,154,87,67,119,71,48,22,10,12,36,24,16,8,134,67,67,20,0,74,53,21,66,11,9,,,15,10,5,,,
"Sep 1, 2023 6:00 PM",119,41,78,115,64,51,130,73,57,109,59,50,23,9,14,19,22,20,2,97,48,49,18,0,84,51,33,40,3,7,,,3,2,1,,,
"Sep 1, 2023 7:00 PM",81,28,53,84,42,42,92,50,42,69,41,28,14,7,7,28,19,17,2,43,22,21,16,0,33,20,13,31,6,4,,,7,5,2,,,
"Sep 1, 2023 8:00 PM",76,30,46,34,13,21,37,9,28,34,13,21,16,7,9,12,14,12,2,34,16,18,13,0,15,6,9,25,4,2,,,6,5,1,,,
"Sep 1, 2023 9:00 PM",41,10,31,41,27,14,34,11,23,24,7,17,2,2,0,10,7,7,0,14,7,7,6,0,12,8,4,17,2,6,,,5,2,3,,,
"Sep 1, 2023 10:00 PM",20,6,14,11,5,6,15,9,6,11,5,6,1,0,1,2,9,9,0,18,9,9,9,0,6,4,2,5,2,1,,,1,1,0,,,
"Sep 1, 2023 11:00 PM",25,7,18,8,6,2,12,5,7,6,1,5,4,4,0,4,5,4,1,4,2,2,4,0,4,4,0,5,1,0,,,1,1,0,,,
"Sep 2, 2023 12:00 AM",10,0,10,0,0,0,3,2,1,4,0,4,1,1,0,4,3,2,1,13,6,7,2,0,3,2,1,4,0,0,,,0,0,0,,,
"Sep 2, 2023 1:00 AM",9,3,6,5,5,0,2,1,1,5,3,2,0,0,0,0,2,1,1,7,3,4,0,0,3,1,2,3,0,0,,,2,0,2,,,
"Sep 2, 2023 2:00 AM",7,4,3,0,0,0,1,1,0,1,1,0,1,0,1,0,0,0,0,3,1,1,0,0,1,1,0,3,1,2,,,0,0,0,,,
"Sep 2, 2023 3:00 AM",0,0,0,0,0,0,0,0,0,0,0,0,0,0,0,0,1,1,0,2,1,1,1,0,1,1,0,0,0,1,,,0,0,0,,,
"Sep 2, 2023 4:00 AM",1,0,1,1,1,0,5,4,1,1,1,0,0,0,0,0,1,1,0,2,1,1,1,0,1,0,1,1,0,0,,,0,0,0,,,
"Sep 2, 2023 5:00 AM",3,0,3,1,1,0,7,5,2,3,1,2,0,0,0,2,0,0,0,2,1,1,0,0,0,0,0,2,0,0,,,0,0,0,,,
"Sep 2, 2023 6:00 AM",7,5,2,14,8,6,11,6,5,9,5,4,0,0,0,2,3,3,0,8,4,4,4,0,0,0,0,23,2,2,,,0,0,0,,,
"Sep 2, 2023 7:00 AM",22,13,9,39,28,11,38,30,8,33,27,6,2,0,2,4,6,6,0,12,6,6,7,0,7,4,3,16,2,2,,,1,1,0,,,
"Sep 2, 2023 8:00 AM",25,13,12,65,41,24,60,40,20,54,43,11,9,1,8,7,12,12,0,13,6,6,15,0,24,17,7,15,1,5,,,3,0,3,,,
"Sep 2, 2023 9:00 AM",38,26,12,105,57,48,107,66,41,92,63,29,15,12,3,11,17,15,2,10,4,5,16,0,39,22,17,34,3,10,,,7,4,3,,,
"Sep 2, 2023 10:00 AM",53,28,25,133,65,68,123,64,59,91,52,39,19,11,8,5,23,23,0,18,8,9,23,0,55,30,25,46,10,5,,,8,7,1,,,
"Sep 2, 2023 11:00 AM",65,39,26,132,66,66,135,76,59,90,48,42,28,11,17,25,17,17,0,28,13,13,15,0,68,38,30,37,12,4,,,9,7,2,,,
"Sep 2, 2023 12:00 PM",54,31,23,194,69,125,176,103,73,129,84,45,45,25,20,24,24,23,1,29,14,14,16,0,68,40,28,38,9,7,,,13,6,7,,,
"Sep 2, 2023 1:00 PM",55,21,34,162,82,80,188,119,69,143,93,50,23,10,13,11,14,14,0,31,15,16,9,0,81,48,33,47,12,6,,,16,7,9,,,
"Sep 2, 2023 2:00 PM",66,42,24,192,104,88,199,117,82,118,73,45,28,12,16,27,12,11,1,32,16,16,11,0,85,57,28,42,7,7,,,11,6,5,,,
"Sep 2, 2023 3:00 PM",58,25,33,195,97,98,234,134,100,159,93,66,34,22,12,28,18,17,1,36,17,18,18,0,112,63,49,36,7,7,,,10,7,3,,,
"Sep 2, 2023 4:00 PM",52,22,30,217,103,114,228,107,121,171,89,82,25,7,18,25,13,12,1,20,10,10,8,0,119,63,56,43,9,5,,,12,7,5,,,
"Sep 2, 2023 5:00 PM",59,28,31,175,89,86,206,70,136,135,46,89,35,9,26,23,16,13,3,33,16,16,14,0,95,46,49,70,4,5,,,6,4,2,,,
"Sep 2, 2023 6:00 PM",58,28,30,122,71,51,100,38,62,82,39,43,21,12,9,13,4,3,1,14,7,7,3,0,69,38,31,32,0,6,,,8,2,6,,,
"Sep 2, 2023 7:00 PM",41,17,24,62,26,36,72,19,53,45,11,34,14,13,1,25,21,19,2,15,8,7,22,0,49,11,38,28,4,0,,,6,5,1,,,
"Sep 2, 2023 8:00 PM",36,14,22,26,19,7,33,17,16,27,14,13,11,9,2,8,10,10,0,16,7,7,15,0,19,13,6,17,1,4,,,1,0,1,,,
"Sep 2, 2023 9:00 PM",24,8,16,29,14,15,31,8,23,21,6,15,8,4,4,5,7,7,0,2,1,1,6,0,7,3,4,10,0,1,,,1,0,1,,,
"Sep 2, 2023 10:00 PM",18,6,12,12,3,9,15,2,13,15,1,14,4,1,3,0,7,7,0,9,4,5,8,0,6,2,4,9,2,1,,,1,0,1,,,
"Sep 2, 2023 11:00 PM",15,5,10,5,2,3,16,3,13,12,4,8,2,1,1,3,7,6,1,4,2,2,2,0,6,3,3,9,0,0,,,0,0,0,,,
"Sep 3, 2023 12:00 AM",7,1,6,1,0,1,2,2,0,6,3,3,2,0,2,1,7,7,0,11,5,5,9,0,5,2,3,3,0,0,,,0,0,0,,,
"Sep 3, 2023 1:00 AM",8,1,7,8,4,4,5,1,4,4,2,2,0,0,0,0,1,0,1,7,3,3,0,0,2,0,2,4,0,0,,,0,0,0,,,
"Sep 3, 2023 2:00 AM",4,1,3,1,1,0,2,2,0,2,2,0,1,0,1,0,1,1,0,2,1,1,0,0,1,0,1,0,0,1,,,0,0,0,,,
"Sep 3, 2023 3:00 AM",2,1,1,0,0,0,0,0,0,0,0,0,0,0,0,2,0,0,0,2,1,1,1,0,0,0,0,0,0,1,,,0,0,0,,,
"Sep 3, 2023 4:00 AM",1,1,0,0,0,0,1,0,1,0,0,0,1,1,0,1,0,0,0,0,0,0,0,0,0,0,0,0,0,0,,,0,0,0,,,
"Sep 3, 2023 5:00 AM",0,0,0,0,0,0,3,3,0,0,0,0,0,0,0,2,1,1,0,1,0,0,0,0,0,0,0,2,0,1,,,0,0,0,,,
"Sep 3, 2023 6:00 AM",5,3,2,15,6,9,11,9,2,12,9,3,2,2,0,1,3,3,0,2,1,1,3,0,4,4,0,5,1,1,,,1,1,0,,,
"Sep 3, 2023 7:00 AM",19,11,8,31,19,12,24,15,9,23,17,6,5,5,0,6,4,4,0,14,7,7,5,0,7,4,3,14,2,3,,,0,0,0,,,
"Sep 3, 2023 8:00 AM",24,12,12,72,46,26,71,42,29,68,49,19,9,4,5,8,10,9,1,14,7,7,11,0,35,24,11,19,1,9,,,3,1,2,,,
"Sep 3, 2023 9:00 AM",43,26,17,147,84,63,126,92,34,127,100,27,12,5,7,10,22,20,2,8,3,4,15,0,37,25,12,54,5,11,,,8,4,4,,,
"Sep 3, 2023 10:00 AM",36,23,13,201,120,81,181,118,63,183,120,63,24,17,7,26,21,18,3,8,4,4,16,0,95,70,25,33,7,8,,,10,10,0,,,
"Sep 3, 2023 11:00 AM",51,26,25,258,147,111,225,151,74,213,139,74,30,12,18,22,19,18,1,39,20,18,14,0,103,69,34,52,9,12,,,10,8,2,,,
"Sep 3, 2023 12:00 PM",78,41,37,296,142,154,315,178,137,236,133,103,54,23,31,33,20,19,1,33,16,16,19,0,118,82,36,61,12,8,,,8,5,3,,,
"Sep 3, 2023 1:00 PM",56,28,28,232,113,119,323,165,158,203,105,98,56,27,29,28,32,31,1,38,19,18,30,0,157,97,60,50,15,5,,,8,3,5,,,
"Sep 3, 2023 2:00 PM",54,30,24,281,157,124,417,279,138,236,148,88,53,38,15,18,17,17,0,35,17,17,13,0,193,119,74,59,5,7,,,19,12,7,,,
"Sep 3, 2023 3:00 PM",58,30,28,263,145,118,411,230,181,247,141,106,31,21,10,23,29,24,5,27,14,13,21,0,181,104,77,69,15,5,,,15,8,7,,,
"Sep 3, 2023 4:00 PM",58,31,27,270,133,137,438,194,244,213,107,106,46,20,26,20,11,11,0,26,12,12,10,0,140,62,78,67,9,8,,,11,9,2,,,
"Sep 3, 2023 5:00 PM",75,33,42,215,105,110,293,89,204,179,72,107,36,12,24,24,27,26,1,23,12,10,30,0,121,43,78,85,8,10,,,5,2,3,,,
"Sep 3, 2023 6:00 PM",49,15,34,162,61,101,200,64,136,138,47,91,24,13,11,18,20,20,0,22,11,11,17,0,114,53,61,66,7,5,,,3,2,1,,,
"Sep 3, 2023 7:00 PM",46,17,29,125,50,75,128,32,96,85,26,59,14,10,4,15,15,12,3,25,11,12,11,0,58,21,37,61,4,4,,,5,2,3,,,
"Sep 3, 2023 8:00 PM",45,22,23,61,19,42,87,18,69,57,19,38,13,10,3,6,13,13,0,15,7,7,10,0,51,7,44,33,4,5,,,7,5,2,,,
"Sep 3, 2023 9:00 PM",20,6,14,22,7,15,27,9,18,22,9,13,9,3,6,3,3,3,0,9,4,5,4,0,11,5,6,21,1,0,,,0,0,0,,,
"Sep 3, 2023 10:00 PM",12,5,7,7,5,2,7,3,4,4,3,1,2,0,2,1,6,6,0,14,7,7,7,0,2,1,1,8,3,0,,,2,2,0,,,
"Sep 3, 2023 11:00 PM",10,3,7,2,1,1,2,0,2,3,1,2,1,1,0,2,1,1,0,2,1,1,1,0,1,1,0,3,0,0,,,0,0,0,,,
"Sep 4, 2023 12:00 AM",4,2,2,0,0,0,0,0,0,1,0,1,0,0,0,0,1,1,0,4,2,2,1,0,0,0,0,1,1,0,,,3,2,1,,,
"Sep 4, 2023 1:00 AM",5,1,4,1,1,0,8,1,7,1,1,0,0,0,0,0,0,0,0,1,0,0,0,0,0,0,0,5,0,0,,,0,0,0,,,
"Sep 4, 2023 2:00 AM",5,1,4,0,0,0,0,0,0,0,0,0,0,0,0,0,0,0,0,0,0,0,0,0,0,0,0,0,0,0,,,0,0,0,,,
"Sep 4, 2023 3:00 AM",0,0,0,0,0,0,1,1,0,1,1,0,0,0,0,0,0,0,0,0,0,0,1,0,0,0,0,1,1,0,,,0,0,0,,,
"Sep 4, 2023 4:00 AM",0,0,0,0,0,0,2,1,1,0,0,0,0,0,0,0,0,0,0,2,1,1,0,0,0,0,0,2,0,0,,,1,1,0,,,
"Sep 4, 2023 5:00 AM",7,4,3,0,0,0,1,1,0,1,1,0,1,0,1,2,5,5,0,3,1,1,5,0,0,0,0,4,0,0,,,0,0,0,,,
"Sep 4, 2023 6:00 AM",45,28,17,20,7,13,37,11,26,23,9,14,5,3,2,4,21,21,0,12,6,6,21,0,8,3,5,39,2,3,,,4,4,0,,,
"Sep 4, 2023 7:00 AM",120,86,34,87,35,52,96,31,65,78,30,48,11,9,2,23,104,100,4,28,14,14,94,0,55,19,36,123,5,9,,,13,11,2,,,
"Sep 4, 2023 8:00 AM",277,196,81,105,39,66,168,59,109,125,57,68,41,17,24,44,161,154,7,55,27,28,155,0,112,28,84,247,8,6,,,22,17,5,,,
"Sep 4, 2023 9:00 AM",130,102,28,75,30,45,87,46,41,73,42,31,19,6,13,14,69,66,3,24,12,12,59,0,47,21,26,65,5,3,,,7,3,4,,,
"Sep 4, 2023 10:00 AM",55,38,17,104,56,48,73,41,32,72,46,26,8,5,3,6,29,27,2,30,14,15,26,0,35,19,16,32,4,3,,,4,2,2,,,
"Sep 4, 2023 11:00 AM",41,18,23,99,45,54,104,62,42,64,32,32,21,13,8,21,26,25,1,19,9,9,20,0,56,36,20,23,1,4,,,5,3,2,,,
"Sep 4, 2023 12:00 PM",48,28,20,99,50,49,139,83,56,77,44,33,28,16,12,19,21,18,3,28,14,14,19,0,60,35,25,22,4,3,,,11,8,3,,,
"Sep 4, 2023 1:00 PM",75,35,40,111,61,50,151,82,69,103,52,51,34,15,19,13,24,22,2,33,16,17,19,0,80,52,28,29,7,3,,,9,4,5,,,
"Sep 4, 2023 2:00 PM",95,43,52,128,63,65,176,84,92,100,46,54,21,14,7,17,10,9,1,38,18,20,10,0,76,41,35,36,2,6,,,10,6,4,,,
"Sep 4, 2023 3:00 PM",88,31,57,118,67,51,198,132,66,82,54,28,27,10,17,28,28,22,6,54,27,27,13,0,103,61,42,59,1,2,,,9,5,4,,,
"Sep 4, 2023 4:00 PM",161,49,112,158,80,78,284,163,121,136,83,53,33,18,15,16,39,35,4,106,52,54,35,0,145,87,58,68,6,10,,,12,9,3,,,
"Sep 4, 2023 5:00 PM",225,56,169,172,111,61,392,239,153,206,118,88,35,18,17,31,53,48,5,239,120,119,42,0,193,130,63,96,17,8,,,22,11,11,,,
"Sep 4, 2023 6:00 PM",198,52,146,211,120,91,413,235,178,178,124,54,16,3,13,32,38,34,4,210,105,103,35,0,165,112,53,85,14,9,,,16,7,9,,,
"Sep 4, 2023 7:00 PM",108,33,75,221,120,101,243,98,145,143,71,72,24,12,12,18,30,26,4,76,38,37,24,0,100,55,45,90,3,8,,,14,7,7,,,
"Sep 4, 2023 8:00 PM",77,25,52,108,39,69,153,40,113,93,29,64,13,12,1,10,21,17,4,36,18,18,16,0,51,16,35,60,5,2,,,6,3,3,,,
"Sep 4, 2023 9:00 PM",42,10,32,44,16,28,43,10,33,38,10,28,4,1,3,8,9,9,0,28,14,14,8,0,22,4,18,30,0,1,,,6,0,6,,,
"Sep 4, 2023 10:00 PM",25,7,18,14,8,6,15,7,8,13,5,8,2,0,2,5,6,5,1,22,11,11,5,0,16,7,9,10,0,1,,,0,0,0,,,
"Sep 4, 2023 11:00 PM",14,4,10,2,1,1,6,5,1,2,2,0,1,0,1,3,2,2,0,12,6,6,2,0,2,2,0,2,0,0,,,0,0,0,,,
"Sep 5, 2023 12:00 AM",7,0,7,0,0,0,0,0,0,3,2,1,1,0,1,1,2,1,1,4,2,2,2,0,1,1,0,1,0,0,,,1,1,0,,,
"Sep 5, 2023 1:00 AM",2,0,2,2,0,2,1,1,0,0,0,0,0,0,0,0,0,0,0,8,4,4,0,0,1,1,0,1,0,0,,,0,0,0,,,
"Sep 5, 2023 2:00 AM",2,2,0,0,0,0,0,0,0,0,0,0,0,0,0,0,1,1,0,0,0,0,1,0,0,0,0,1,0,0,,,0,0,0,,,
"Sep 5, 2023 3:00 AM",0,0,0,0,0,0,0,0,0,0,0,0,0,0,0,0,0,0,0,0,0,0,0,0,0,0,0,0,1,0,,,0,0,0,,,
"Sep 5, 2023 4:00 AM",3,1,2,0,0,0,0,0,0,0,0,0,0,0,0,0,0,0,0,1,0,0,0,0,0,0,0,3,0,0,,,0,0,0,,,
"Sep 5, 2023 5:00 AM",11,6,5,7,4,3,10,7,3,7,5,2,5,2,3,2,7,7,0,9,4,4,7,0,5,4,1,8,1,1,,,0,0,0,,,
"Sep 5, 2023 6:00 AM",67,36,31,42,22,20,53,23,30,36,16,20,0,0,0,13,28,28,0,13,6,7,28,0,14,4,10,47,1,6,,,4,3,1,,,
"Sep 5, 2023 7:00 AM",169,121,48,83,24,59,108,32,76,79,31,48,20,14,6,22,106,105,1,44,21,23,105,0,53,16,37,157,12,6,,,11,11,0,,,
"Sep 5, 2023 8:00 AM",340,246,94,135,26,109,229,72,157,167,62,105,44,17,27,50,250,241,9,59,31,28,214,0,130,41,89,287,7,12,,,27,25,2,,,
"Sep 5, 2023 9:00 AM",164,132,32,112,44,68,108,47,61,105,54,51,21,15,6,13,85,83,2,23,11,12,75,0,66,18,48,98,4,8,,,8,4,4,,,
"Sep 5, 2023 10:00 AM",65,44,21,56,29,27,73,40,33,60,35,25,10,6,4,12,29,26,3,13,6,7,20,0,39,21,18,31,7,10,,,6,4,2,,,
"Sep 5, 2023 11:00 AM",36,22,14,93,55,38,92,62,30,81,52,29,14,10,4,13,18,18,0,14,7,7,14,0,37,28,9,22,8,3,,,8,4,4,,,
"Sep 5, 2023 12:00 PM",54,22,32,84,52,32,80,47,33,53,30,23,21,7,14,19,23,21,2,37,18,18,16,0,46,33,13,34,9,7,,,13,8,5,,,
"Sep 5, 2023 1:00 PM",87,37,50,115,60,55,124,64,60,87,48,39,25,9,16,5,27,23,4,36,17,19,19,0,41,21,20,39,5,2,,,12,8,4,,,
"Sep 5, 2023 2:00 PM",86,37,49,95,54,41,123,72,51,82,47,35,36,20,16,26,12,10,2,32,16,16,11,0,63,45,18,38,3,3,,,14,10,4,,,
"Sep 5, 2023 3:00 PM",82,27,55,96,42,54,160,87,73,79,44,35,30,15,15,21,37,31,6,73,37,35,23,0,76,53,23,41,3,1,,,16,4,12,,,
"Sep 5, 2023 4:00 PM",178,51,127,116,74,42,209,136,73,129,78,51,29,13,16,33,33,30,3,120,60,59,32,0,118,71,47,59,7,4,,,11,6,5,,,
"Sep 5, 2023 5:00 PM",263,62,201,179,105,74,301,192,109,171,102,69,39,8,31,59,59,51,8,296,148,147,48,0,146,101,45,90,20,12,,,12,8,4,,,
"Sep 5, 2023 6:00 PM",240,79,161,184,118,66,335,221,114,173,119,54,32,16,16,39,38,31,7,232,113,118,34,0,161,118,43,75,11,5,,,18,7,11,,,
"Sep 5, 2023 7:00 PM",154,44,110,178,93,85,246,106,140,137,67,70,15,6,9,23,25,19,6,107,52,54,20,0,111,62,49,68,7,3,,,6,5,1,,,
"Sep 5, 2023 8:00 PM",90,31,59,84,35,49,107,32,75,57,20,37,12,7,5,12,17,15,2,75,38,37,15,0,45,13,32,51,4,3,,,5,4,1,,,
"Sep 5, 2023 9:00 PM",52,15,37,24,11,13,31,9,22,18,6,12,2,1,1,9,8,7,1,29,14,14,6,0,18,6,12,14,3,1,,,3,1,2,,,
"Sep 5, 2023 10:00 PM",39,7,32,7,5,2,15,3,12,6,2,4,0,0,0,2,10,10,0,27,13,14,12,0,6,3,3,13,1,0,,,3,1,2,,,
"Sep 5, 2023 11:00 PM",12,2,10,5,4,1,15,2,13,9,0,9,4,1,3,1,3,1,2,6,3,3,1,0,1,0,1,3,0,0,,,0,0,0,,,
"Sep 6, 2023 12:00 AM",5,0,5,0,0,0,2,1,1,2,1,1,1,0,1,0,4,2,2,3,2,1,3,0,5,2,3,2,0,1,,,1,0,1,,,
"Sep 6, 2023 1:00 AM",0,0,0,0,0,0,0,0,0,0,0,0,0,0,0,0,1,1,0,4,2,2,1,0,0,0,0,0,0,0,,,0,0,0,,,
"Sep 6, 2023 2:00 AM",1,1,0,0,0,0,0,0,0,0,0,0,3,1,2,0,1,1,0,0,0,0,1,0,0,0,0,1,0,1,,,0,0,0,,,
"Sep 6, 2023 3:00 AM",2,1,1,0,0,0,0,0,0,0,0,0,0,0,0,0,0,0,0,0,0,0,0,0,0,0,0,0,0,0,,,0,0,0,,,
"Sep 6, 2023 4:00 AM",2,0,2,0,0,0,0,0,0,0,0,0,0,0,0,0,1,1,0,0,0,0,1,0,0,0,0,1,0,0,,,1,1,0,,,
"Sep 6, 2023 5:00 AM",8,5,3,8,8,0,8,7,1,7,6,1,0,0,0,3,7,7,0,5,2,2,7,0,0,0,0,5,0,0,,,0,0,0,,,
"Sep 6, 2023 6:00 AM",68,38,30,37,21,16,41,17,24,38,20,18,3,0,3,6,25,25,0,12,6,6,24,0,16,7,9,36,2,3,,,0,0,0,,,
"Sep 6, 2023 7:00 AM",156,102,54,75,30,45,123,42,81,83,25,58,9,4,5,24,113,111,2,45,22,21,105,0,61,26,35,149,4,10,,,9,8,1,,,
"Sep 6, 2023 8:00 AM",343,257,86,129,41,88,203,56,147,144,57,87,54,23,31,42,218,207,11,63,30,32,197,0,123,25,98,280,9,14,,,29,21,8,,,
"Sep 6, 2023 9:00 AM",165,142,23,113,59,54,110,59,51,92,59,33,21,12,9,13,72,71,1,15,8,7,60,0,61,22,39,84,7,8,,,10,8,2,,,
"Sep 6, 2023 10:00 AM",53,32,21,100,44,56,68,37,31,70,38,32,16,9,7,13,33,32,1,9,5,4,30,0,34,18,16,37,4,6,,,9,5,4,,,
"Sep 6, 2023 11:00 AM",54,27,27,83,44,39,78,47,31,67,41,26,14,10,4,17,21,19,2,24,12,12,17,0,41,23,18,23,7,3,,,4,4,0,,,
"Sep 6, 2023 12:00 PM",68,36,32,114,59,55,98,45,53,85,47,38,21,11,10,18,30,29,1,28,14,14,17,0,36,24,12,29,8,4,,,12,9,3,,,
"Sep 6, 2023 1:00 PM",99,40,59,121,59,62,123,68,55,98,49,49,26,14,12,16,29,25,4,58,29,28,24,0,68,37,31,31,4,4,,,11,9,2,,,
"Sep 6, 2023 2:00 PM",73,26,47,110,66,44,147,94,53,91,58,33,30,20,10,16,16,12,4,67,33,34,10,0,64,39,25,32,2,7,,,17,11,6,,,
"Sep 6, 2023 3:00 PM",94,34,60,131,76,55,161,118,43,91,56,35,23,9,14,32,32,29,3,73,37,36,25,0,84,54,30,36,7,3,,,11,7,4,,,
"Sep 6, 2023 4:00 PM",172,54,118,144,85,59,243,150,93,124,75,49,24,15,9,33,31,26,5,118,58,60,27,0,140,102,38,61,9,8,,,9,4,5,,,
"Sep 6, 2023 5:00 PM",269,76,193,207,120,87,372,227,145,172,108,64,52,12,40,46,40,33,7,249,125,123,31,0,160,112,48,103,12,11,,,13,5,8,,,
"Sep 6, 2023 6:00 PM",207,51,156,224,148,76,512,350,162,203,144,59,24,8,16,26,40,39,1,244,120,123,42,0,220,182,38,93,9,8,,,18,12,6,,,
"Sep 6, 2023 7:00 PM",118,36,82,218,103,115,404,173,231,164,84,80,19,12,7,20,29,24,5,100,49,50,22,0,143,68,75,113,2,4,,,11,10,1,,,
"Sep 6, 2023 8:00 PM",104,33,71,114,40,74,203,46,157,82,25,57,16,4,12,14,26,22,4,47,24,23,18,0,85,24,61,82,5,3,,,8,2,6,,,
"Sep 6, 2023 9:00 PM",61,15,46,52,21,31,52,10,42,35,10,25,5,1,4,6,16,14,2,31,14,17,14,0,27,10,17,37,3,2,,,2,1,1,,,
"Sep 6, 2023 10:00 PM",32,6,26,21,15,6,26,8,18,19,11,8,2,0,2,4,15,12,3,25,12,12,10,0,9,5,4,23,1,1,,,0,0,0,,,
"Sep 6, 2023 11:00 PM",19,6,13,10,10,0,17,8,9,4,1,3,2,0,2,2,4,4,0,9,4,5,5,0,9,3,6,9,1,0,,,0,0,0,,,
"Sep 7, 2023 12:00 AM",11,2,9,0,0,0,3,2,1,6,4,2,0,0,0,1,0,0,0,8,4,4,0,0,0,0,0,1,0,0,,,1,1,0,,,
"Sep 7, 2023 1:00 AM",6,3,3,2,1,1,1,0,1,3,0,3,0,0,0,0,1,1,0,2,1,1,1,0,1,1,0,0,0,1,,,0,0,0,,,
"Sep 7, 2023 2:00 AM",3,2,1,0,0,0,3,0,3,3,0,3,0,0,0,0,2,1,1,4,2,2,1,0,0,0,0,4,0,0,,,0,0,0,,,
"Sep 7, 2023 3:00 AM",1,0,1,0,0,0,1,1,0,0,0,0,0,0,0,0,0,0,0,0,0,0,0,0,0,0,0,1,0,0,,,0,0,0,,,
"Sep 7, 2023 4:00 AM",4,2,2,0,0,0,0,0,0,0,0,0,0,0,0,0,0,0,0,2,1,1,0,0,0,0,0,0,0,0,,,0,0,0,,,
"Sep 7, 2023 5:00 AM",7,3,4,8,1,7,3,1,2,3,1,2,1,0,1,5,8,8,0,6,2,2,8,0,0,0,0,6,0,0,,,0,0,0,,,
"Sep 7, 2023 6:00 AM",55,31,24,23,11,12,43,22,21,26,12,14,2,1,1,15,27,27,0,14,7,7,25,0,8,2,6,40,1,4,,,1,0,1,,,
"Sep 7, 2023 7:00 AM",155,96,59,64,18,46,115,39,76,71,22,49,14,6,8,17,94,93,1,32,16,16,90,0,51,18,33,152,4,1,,,9,7,2,,,
"Sep 7, 2023 8:00 AM",293,213,80,114,26,88,214,69,145,131,55,76,39,23,16,51,178,166,12,57,27,29,165,0,124,29,95,252,6,14,,,23,18,5,,,
"Sep 7, 2023 9:00 AM",122,99,23,77,30,47,112,54,58,88,49,39,16,8,8,22,72,71,1,19,10,9,64,0,54,19,35,86,4,7,,,10,7,3,,,
"Sep 7, 2023 10:00 AM",68,51,17,94,53,41,77,43,34,67,42,25,14,10,4,20,34,33,1,24,12,12,33,0,38,22,16,45,4,1,,,7,6,1,,,
"Sep 7, 2023 11:00 AM",52,26,26,61,32,29,69,40,29,62,33,29,15,5,10,10,21,20,1,14,7,7,17,0,30,14,16,29,4,4,,,5,3,2,,,
"Sep 7, 2023 12:00 PM",57,29,28,77,37,40,75,32,43,58,30,28,13,6,7,11,19,16,3,24,12,12,17,0,39,21,18,27,4,3,,,3,2,1,,,
"Sep 7, 2023 1:00 PM",69,35,34,90,44,46,74,35,39,68,35,33,29,17,12,16,22,19,3,63,30,31,18,0,39,23,16,28,6,3,,,10,5,5,,,
"Sep 7, 2023 2:00 PM",77,24,53,79,40,39,66,41,25,52,30,22,15,7,8,25,16,13,3,52,26,26,12,0,41,26,15,30,4,5,,,6,4,2,,,
"Sep 7, 2023 3:00 PM",84,32,52,98,42,56,91,45,46,55,28,27,24,10,14,15,38,34,4,67,33,34,24,0,37,17,20,35,7,1,,,13,7,6,,,
"Sep 7, 2023 4:00 PM",163,56,107,85,52,33,153,104,49,99,64,35,39,15,24,30,32,30,2,115,57,58,28,0,85,59,26,44,7,6,,,7,4,3,,,
"Sep 7, 2023 5:00 PM",253,62,191,143,94,49,235,147,88,121,76,45,30,6,24,45,44,34,10,223,112,111,29,0,120,87,33,86,13,1,,,18,13,5,,,
"Sep 7, 2023 6:00 PM",206,40,166,157,106,51,231,159,72,137,96,41,26,6,20,46,38,31,7,183,91,91,35,0,112,90,22,59,9,5,,,13,7,6,,,
"Sep 7, 2023 7:00 PM",139,49,90,107,56,51,188,97,91,99,57,42,14,6,8,36,20,14,6,118,59,59,13,0,86,45,41,40,5,2,,,14,6,8,,,
"Sep 7, 2023 8:00 PM",93,45,48,68,38,30,118,42,76,54,24,30,9,5,4,19,15,12,3,53,26,27,14,0,41,23,18,37,4,3,,,2,2,0,,,
"Sep 7, 2023 9:00 PM",45,15,30,32,13,19,33,15,18,30,9,21,4,2,2,4,7,5,2,18,9,9,5,0,22,11,11,21,2,2,,,8,3,5,,,
"Sep 7, 2023 10:00 PM",38,10,28,18,11,7,21,8,13,15,7,8,7,3,4,7,22,18,4,33,16,16,16,0,7,3,4,14,1,1,,,0,0,0,,,
"Sep 7, 2023 11:00 PM",17,2,15,2,2,0,10,4,6,9,4,5,1,1,0,4,2,2,0,10,5,5,1,0,5,2,3,11,0,1,,,1,1,0,,,
"Sep 8, 2023 12:00 AM",8,3,5,0,0,0,0,0,0,5,1,4,8,5,3,2,4,4,0,14,7,7,4,0,1,1,0,4,1,1,,,1,1,0,,,
"Sep 8, 2023 1:00 AM",11,3,8,2,2,0,1,1,0,0,0,0,2,2,0,2,0,0,0,8,4,4,0,0,1,0,1,1,0,1,,,1,1,0,,,
"Sep 8, 2023 2:00 AM",2,2,0,4,3,1,0,0,0,0,0,0,0,0,0,3,0,0,0,2,1,1,0,0,0,0,0,2,0,0,,,0,0,0,,,
"Sep 8, 2023 3:00 AM",0,0,0,0,0,0,0,0,0,0,0,0,1,0,1,1,0,0,0,0,0,0,1,0,0,0,0,0,0,0,,,0,0,0,,,
"Sep 8, 2023 4:00 AM",4,2,2,0,0,0,0,0,0,0,0,0,0,0,0,0,0,0,0,1,0,0,0,0,0,0,0,2,0,0,,,0,0,0,,,
"Sep 8, 2023 5:00 AM",9,4,5,3,2,1,4,1,3,7,3,4,0,0,0,2,5,5,0,5,2,2,5,0,3,1,2,10,0,0,,,0,0,0,,,
"Sep 8, 2023 6:00 AM",42,22,20,31,14,17,47,23,24,29,14,15,4,3,1,12,16,16,0,14,7,7,15,0,15,10,5,32,2,5,,,1,1,0,,,
"Sep 8, 2023 7:00 AM",120,76,44,77,32,45,118,44,74,70,31,39,11,5,6,17,67,63,4,33,16,17,64,0,45,20,25,85,5,5,,,6,5,1,,,
"Sep 8, 2023 8:00 AM",221,156,65,109,38,71,174,64,110,114,52,62,51,24,27,43,113,104,9,55,27,27,102,0,88,24,64,150,9,12,,,14,12,2,,,
"Sep 8, 2023 9:00 AM",112,86,26,83,34,49,113,71,42,69,39,30,28,18,10,24,56,54,2,32,16,16,51,0,52,21,31,66,4,6,,,5,4,1,,,
"Sep 8, 2023 10:00 AM",54,30,24,76,43,33,95,50,45,61,39,22,14,8,6,12,21,20,1,21,11,10,16,0,36,21,15,43,4,3,,,2,2,0,,,
"Sep 8, 2023 11:00 AM",52,32,20,86,51,35,100,49,51,73,40,33,26,10,16,11,21,20,1,12,6,6,17,0,40,22,18,27,13,2,,,4,4,0,,,
"Sep 8, 2023 12:00 PM",71,33,38,124,57,67,105,67,38,97,63,34,15,10,5,23,18,18,0,32,15,15,17,0,50,30,20,17,11,5,,,12,5,7,,,
"Sep 8, 2023 1:00 PM",123,49,74,117,63,54,131,67,64,103,48,55,20,8,12,18,21,21,0,41,20,21,18,0,60,29,31,31,6,7,,,9,4,5,,,
"Sep 8, 2023 2:00 PM",73,38,35,143,83,60,141,100,41,108,71,37,22,8,14,25,21,18,3,44,22,22,14,0,80,56,24,31,2,4,,,10,7,3,,,
"Sep 8, 2023 3:00 PM",94,36,58,167,101,66,182,115,67,134,90,44,21,10,11,25,32,28,4,64,30,31,23,0,95,61,34,46,7,5,,,12,8,4,,,
"Sep 8, 2023 4:00 PM",145,47,98,199,104,95,256,169,87,156,92,64,27,15,12,23,34,30,4,116,57,57,28,0,120,75,45,45,11,5,,,9,5,4,,,
"Sep 8, 2023 5:00 PM",165,57,108,230,134,96,394,252,142,195,127,68,25,9,16,27,37,33,4,122,60,62,30,0,165,119,46,80,14,5,,,14,9,5,,,
"Sep 8, 2023 6:00 PM",134,39,95,209,108,101,439,255,184,175,95,80,30,13,17,38,26,22,4,105,51,53,19,0,157,98,59,81,6,6,,,8,4,4,,,
"Sep 8, 2023 7:00 PM",99,32,67,156,70,86,326,122,204,125,60,65,20,15,5,17,18,15,3,61,30,31,16,0,100,40,60,93,11,3,,,8,4,4,,,
"Sep 8, 2023 8:00 PM",70,27,43,115,51,64,134,32,102,96,33,63,15,7,8,5,11,11,0,16,8,8,11,0,75,20,55,68,3,2,,,6,5,1,,,
"Sep 8, 2023 9:00 PM",41,14,27,27,11,16,44,4,40,26,8,18,10,3,7,6,10,8,2,16,8,8,9,0,19,5,14,30,0,0,,,3,2,1,,,
"Sep 8, 2023 10:00 PM",30,9,21,14,8,6,27,2,25,16,5,11,7,4,3,11,11,9,2,20,10,10,9,0,7,2,5,18,5,0,,,1,1,0,,,
"Sep 8, 2023 11:00 PM",25,10,15,14,12,2,22,8,14,13,7,6,5,3,2,2,4,4,0,17,8,8,3,0,13,7,6,18,1,3,,,2,1,1,,,
"Sep 9, 2023 12:00 AM",14,2,12,0,0,0,0,0,0,9,5,4,7,5,2,2,6,5,1,5,2,3,5,0,3,0,3,12,0,1,,,0,0,0,,,
"Sep 9, 2023 1:00 AM",9,0,9,4,4,0,7,4,3,2,2,0,1,0,1,2,2,2,0,8,4,4,2,0,1,1,0,1,2,1,,,1,0,1,,,
"Sep 9, 2023 2:00 AM",8,4,4,1,0,1,2,1,1,2,1,1,1,0,1,0,1,1,0,0,0,0,1,0,2,0,2,1,0,1,,,0,0,0,,,
"Sep 9, 2023 3:00 AM",4,0,4,2,2,0,1,1,0,1,0,1,1,0,1,0,0,0,0,4,2,2,2,0,2,0,2,2,0,2,,,0,0,0,,,
"Sep 9, 2023 4:00 AM",4,1,3,0,0,0,4,4,0,0,0,0,0,0,0,0,0,0,0,0,0,0,0,0,0,0,0,0,1,0,,,0,0,0,,,
"Sep 9, 2023 5:00 AM",1,1,0,1,0,1,3,2,1,1,0,1,1,1,0,2,2,2,0,2,1,1,3,0,1,0,1,1,1,1,,,0,0,0,,,
"Sep 9, 2023 6:00 AM",15,8,7,13,9,4,14,12,2,7,5,2,1,1,0,4,1,1,0,12,6,6,1,0,8,8,0,9,0,3,,,0,0,0,,,
"Sep 9, 2023 7:00 AM",28,15,13,48,32,16,46,28,18,37,28,9,4,1,3,7,11,11,0,4,2,2,14,0,11,4,7,29,1,5,,,1,1,0,,,
"Sep 9, 2023 8:00 AM",42,19,23,72,36,36,110,74,36,61,35,26,10,2,8,18,18,17,1,13,5,8,15,0,25,19,6,28,4,3,,,6,1,5,,,
"Sep 9, 2023 9:00 AM",48,32,16,116,75,41,181,113,68,130,100,30,19,10,9,14,16,14,2,12,5,5,10,0,60,37,23,34,4,6,,,7,6,1,,,
"Sep 9, 2023 10:00 AM",69,31,38,155,83,72,193,117,76,143,87,56,33,17,16,13,13,12,1,17,9,8,13,0,89,56,33,51,8,8,,,13,8,5,,,
"Sep 9, 2023 11:00 AM",68,33,35,174,81,93,204,97,107,146,85,61,32,15,17,23,21,19,2,35,18,17,20,0,87,41,46,42,4,7,,,2,2,0,,,
"Sep 9, 2023 12:00 PM",62,31,31,198,111,87,190,117,73,180,110,70,46,22,24,19,30,29,1,27,13,13,26,0,115,66,49,58,12,9,,,11,6,5,,,
"Sep 9, 2023 1:00 PM",71,46,25,217,111,106,206,116,90,174,107,67,29,12,17,24,26,25,1,35,17,18,21,0,100,49,51,40,11,6,,,8,7,1,,,
"Sep 9, 2023 2:00 PM",57,24,33,161,101,60,182,117,65,129,85,44,16,9,7,21,13,12,1,44,21,23,10,0,87,64,23,49,5,2,,,6,3,3,,,
"Sep 9, 2023 3:00 PM",48,17,31,179,105,74,215,123,92,159,88,71,33,13,20,17,16,13,3,20,10,10,11,0,90,62,28,38,2,3,,,5,4,1,,,
"Sep 9, 2023 4:00 PM",51,26,25,170,84,86,196,86,110,145,70,75,24,11,13,17,25,22,3,17,8,8,24,0,94,52,42,65,12,7,,,10,9,1,,,
"Sep 9, 2023 5:00 PM",55,31,24,242,107,135,234,118,116,163,73,90,26,16,10,18,15,14,1,25,12,12,15,0,112,53,59,55,3,4,,,6,6,0,,,
"Sep 9, 2023 6:00 PM",50,24,26,142,67,75,194,67,127,136,51,85,22,10,12,16,13,12,1,20,9,9,12,0,105,35,70,47,4,3,,,10,4,6,,,
"Sep 9, 2023 7:00 PM",52,24,28,115,60,55,147,61,86,87,40,47,11,6,5,3,15,14,1,19,9,9,11,0,54,22,32,47,4,3,,,6,3,3,,,
"Sep 9, 2023 8:00 PM",42,16,26,62,23,39,90,19,71,40,10,30,4,1,3,17,7,7,0,18,9,9,7,0,36,11,25,37,2,2,,,2,2,0,,,
"Sep 9, 2023 9:00 PM",25,8,17,22,8,14,26,5,21,13,5,8,1,1,0,5,10,9,1,10,5,5,11,0,8,2,6,19,1,2,,,2,1,1,,,
"Sep 9, 2023 10:00 PM",24,8,16,20,9,11,21,5,16,22,6,16,2,0,2,1,9,8,1,12,6,6,8,0,8,2,6,14,2,1,,,3,1,2,,,
"Sep 9, 2023 11:00 PM",15,6,9,12,5,7,8,2,6,9,2,7,4,2,2,6,6,6,0,12,5,6,6,0,4,1,3,5,0,0,,,2,0,2,,,
"Sep 10, 2023 12:00 AM",13,6,7,0,0,0,1,0,1,8,2,6,1,0,1,1,3,3,0,2,1,1,3,0,4,2,2,6,0,0,,,1,0,1,,,
"Sep 10, 2023 1:00 AM",6,2,4,6,3,3,5,2,3,5,3,2,2,0,2,1,2,2,0,7,3,4,2,0,1,0,1,4,1,0,,,0,0,0,,,
"Sep 10, 2023 2:00 AM",6,2,4,0,0,0,1,1,0,1,1,0,0,0,0,0,0,0,0,0,0,0,0,0,1,0,1,2,0,0,,,0,0,0,,,
"Sep 10, 2023 3:00 AM",3,1,2,1,1,0,0,0,0,0,0,0,0,0,0,0,1,1,0,0,0,0,1,0,0,0,0,1,0,1,,,0,0,0,,,
"Sep 10, 2023 4:00 AM",3,0,3,1,0,1,2,1,1,1,1,0,3,0,3,2,1,1,0,1,0,0,2,0,1,1,0,4,0,0,,,0,0,0,,,
"Sep 10, 2023 5:00 AM",1,1,0,2,1,1,2,2,0,2,2,0,1,1,0,2,0,0,0,2,1,1,0,0,1,1,0,3,0,0,,,0,0,0,,,
"Sep 10, 2023 6:00 AM",13,6,7,2,1,1,3,2,1,1,1,0,0,0,0,1,3,3,0,0,0,0,3,0,2,1,1,8,1,0,,,1,1,0,,,
"Sep 10, 2023 7:00 AM",17,8,9,21,13,8,27,16,11,25,14,11,0,0,0,6,8,8,0,6,3,3,9,0,5,2,3,11,0,2,,,2,1,1,,,
"Sep 10, 2023 8:00 AM",24,12,12,76,49,27,80,60,20,74,53,21,2,2,0,2,8,8,0,14,7,6,8,0,30,23,7,17,2,3,,,3,2,1,,,
"Sep 10, 2023 9:00 AM",21,11,10,129,80,49,135,86,49,106,69,37,11,6,5,5,19,16,3,20,10,9,12,0,42,29,13,35,3,16,,,5,4,1,,,
"Sep 10, 2023 10:00 AM",57,29,28,106,53,53,171,103,68,85,56,29,22,15,7,12,19,18,1,18,9,9,16,0,71,51,20,55,4,2,,,5,4,1,,,
"Sep 10, 2023 11:00 AM",56,25,31,173,101,72,224,128,96,155,95,60,20,8,12,12,12,12,0,26,13,13,13,0,57,31,26,45,8,5,,,15,12,3,,,
"Sep 10, 2023 12:00 PM",43,20,23,176,69,107,158,58,100,132,50,82,41,15,26,15,23,20,3,14,7,7,15,0,65,26,39,49,10,12,,,14,11,3,,,
"Sep 10, 2023 1:00 PM",54,31,23,142,68,74,118,62,56,105,62,43,22,13,9,27,13,13,0,34,17,17,11,0,44,17,27,33,4,6,,,10,6,4,,,
"Sep 10, 2023 2:00 PM",49,26,23,100,54,46,96,54,42,101,64,37,23,12,11,17,17,16,1,30,15,15,12,0,33,15,18,27,7,3,,,15,5,10,,,
"Sep 10, 2023 3:00 PM",58,30,28,113,48,65,98,35,63,93,31,62,25,11,14,29,18,16,2,13,7,6,11,0,47,20,27,28,6,3,,,10,9,1,,,
"Sep 10, 2023 4:00 PM",52,28,24,122,65,57,98,38,60,90,41,49,20,12,8,15,12,10,2,23,11,12,9,0,43,18,25,31,9,3,,,6,2,4,,,
"Sep 10, 2023 5:00 PM",63,34,29,57,26,31,60,20,40,46,11,35,17,5,12,26,11,7,4,14,7,7,7,0,45,12,33,28,4,5,,,5,4,1,,,
"Sep 10, 2023 6:00 PM",62,27,35,43,22,21,54,24,30,37,17,20,8,3,5,29,12,10,2,18,8,9,12,0,28,16,12,22,8,0,,,4,2,2,,,
"Sep 10, 2023 7:00 PM",44,18,26,52,28,24,39,19,20,48,19,29,8,6,2,10,14,14,0,16,8,8,13,0,35,21,14,18,2,1,,,1,0,1,,,
"Sep 10, 2023 8:00 PM",25,12,13,26,14,12,19,6,13,19,8,11,8,4,4,6,8,7,1,6,3,3,9,0,2,0,2,11,2,1,,,4,4,0,,,
"Sep 10, 2023 9:00 PM",22,8,14,3,3,0,6,3,3,14,7,7,4,2,2,3,3,2,1,6,3,3,2,0,9,2,7,6,1,1,,,1,1,0,,,
"Sep 10, 2023 10:00 PM",30,7,23,9,4,5,7,2,5,6,1,5,1,0,1,0,5,5,0,15,8,7,5,0,7,4,3,10,1,0,,,2,2,0,,,
"Sep 10, 2023 11:00 PM",8,1,7,0,0,0,5,2,3,4,1,3,2,1,1,4,4,4,0,10,5,5,5,0,6,3,3,2,1,0,,,1,0,1,,,
"Sep 11, 2023 12:00 AM",3,0,3,0,0,0,2,0,2,1,0,1,3,0,3,0,0,0,0,4,2,2,0,0,1,0,1,1,0,1,,,1,1,0,,,
"Sep 11, 2023 1:00 AM",2,1,1,1,1,0,1,0,1,1,0,1,0,0,0,0,2,2,0,0,0,0,2,0,0,0,0,2,1,0,,,0,0,0,,,
"Sep 11, 2023 2:00 AM",2,1,1,1,0,1,0,0,0,0,0,0,0,0,0,0,0,0,0,2,1,1,0,0,1,1,0,0,0,1,,,0,0,0,,,
"Sep 11, 2023 3:00 AM",0,0,0,0,0,0,0,0,0,0,0,0,0,0,0,0,0,0,0,0,0,0,0,0,0,0,0,0,0,0,,,0,0,0,,,
"Sep 11, 2023 4:00 AM",3,0,3,0,0,0,0,0,0,0,0,0,0,0,0,0,1,1,0,0,0,0,1,0,0,0,0,1,0,0,,,0,0,0,,,
"Sep 11, 2023 5:00 AM",11,6,5,0,0,0,2,1,1,1,0,1,0,0,0,2,4,4,0,3,1,1,5,0,2,2,0,6,0,0,,,0,0,0,,,
"Sep 11, 2023 6:00 AM",46,31,15,18,5,13,22,6,16,13,3,10,5,3,2,8,22,22,0,10,5,5,20,0,8,3,5,38,2,4,,,1,1,0,,,
"Sep 11, 2023 7:00 AM",117,86,31,71,27,44,98,29,69,65,16,49,12,7,5,17,111,110,1,30,14,15,106,0,45,14,31,124,3,6,,,9,7,2,,,
"Sep 11, 2023 8:00 AM",300,230,70,92,28,64,168,53,115,122,54,68,42,20,22,50,176,169,7,54,28,26,148,0,103,26,77,251,6,8,,,15,14,1,,,
"Sep 11, 2023 9:00 AM",156,130,26,42,15,27,78,32,46,40,19,21,13,8,5,7,83,80,3,21,10,10,57,0,48,21,27,67,2,5,,,4,3,1,,,
"Sep 11, 2023 10:00 AM",61,44,17,29,13,16,29,14,15,23,14,9,9,8,1,7,29,27,2,19,9,9,19,0,29,19,10,22,2,1,,,5,5,0,,,
"Sep 11, 2023 11:00 AM",41,28,13,31,19,12,39,24,15,25,16,9,10,6,4,13,14,12,2,22,11,11,6,0,18,9,9,16,1,3,,,4,3,1,,,
"Sep 11, 2023 12:00 PM",63,31,32,26,16,10,29,12,17,18,8,10,6,3,3,10,20,16,4,20,10,10,16,0,23,13,10,19,2,1,,,5,5,0,,,
"Sep 11, 2023 1:00 PM",51,23,28,16,8,8,25,16,9,9,7,2,14,8,6,3,15,11,4,33,16,16,8,0,12,7,5,13,1,2,,,1,0,1,,,
"Sep 11, 2023 2:00 PM",49,14,35,14,8,6,14,9,5,15,8,7,7,5,2,23,16,10,6,20,10,10,6,0,10,6,4,18,3,0,,,3,2,1,,,
"Sep 11, 2023 3:00 PM",68,15,53,14,9,5,27,14,13,13,10,3,7,1,6,12,23,16,7,32,16,16,11,0,14,13,1,24,1,0,,,4,3,1,,,
"Sep 11, 2023 4:00 PM",127,24,103,32,25,7,52,38,14,44,28,16,14,3,11,14,32,26,6,73,35,35,21,0,29,25,4,30,7,1,,,7,4,3,,,
"Sep 11, 2023 5:00 PM",184,38,146,37,31,6,79,59,20,66,42,24,15,6,9,28,35,23,12,230,115,115,21,0,54,45,9,47,4,2,,,3,0,3,,,
"Sep 11, 2023 6:00 PM",157,42,115,29,25,4,60,46,14,40,29,11,11,4,7,17,22,16,6,181,91,90,15,0,35,30,5,30,1,3,,,2,0,2,,,
"Sep 11, 2023 7:00 PM",86,14,72,24,17,7,28,22,6,22,13,9,4,2,2,11,11,10,1,61,30,30,9,0,20,16,4,12,4,5,,,2,0,2,,,
"Sep 11, 2023 8:00 PM",45,6,39,3,3,0,10,6,4,8,3,5,7,4,3,7,20,15,5,40,20,20,14,0,7,7,0,5,1,1,,,1,1,0,,,
"Sep 11, 2023 9:00 PM",27,4,23,7,7,0,8,6,2,9,8,1,3,2,1,4,3,0,3,19,9,9,2,0,3,2,1,6,0,0,,,1,1,0,,,
"Sep 11, 2023 10:00 PM",13,1,12,1,1,0,4,3,1,3,1,2,0,0,0,1,7,7,0,6,3,3,7,0,4,4,0,3,0,0,,,0,0,0,,,
"Sep 11, 2023 11:00 PM",10,2,8,2,2,0,3,1,2,0,0,0,1,1,0,1,3,2,1,8,4,4,2,0,0,0,0,2,0,0,,,0,0,0,,,
"Sep 12, 2023 12:00 AM",7,0,7,0,0,0,0,0,0,0,0,0,1,1,0,1,0,0,0,2,1,1,0,0,0,0,0,2,0,0,,,0,0,0,,,
"Sep 12, 2023 1:00 AM",3,2,1,1,1,0,2,2,0,0,0,0,0,0,0,0,0,0,0,0,0,0,0,0,1,1,0,0,0,0,,,0,0,0,,,
"Sep 12, 2023 2:00 AM",2,1,1,0,0,0,0,0,0,0,0,0,0,0,0,0,0,0,0,0,0,0,0,0,0,0,0,0,0,0,,,0,0,0,,,
"Sep 12, 2023 3:00 AM",2,1,1,0,0,0,0,0,0,0,0,0,0,0,0,0,0,0,0,0,0,0,1,0,1,1,0,0,0,0,,,0,0,0,,,
"Sep 12, 2023 4:00 AM",1,0,1,0,0,0,0,0,0,0,0,0,0,0,0,1,0,0,0,3,1,1,0,0,0,0,0,3,0,0,,,0,0,0,,,
"Sep 12, 2023 5:00 AM",5,5,0,3,1,2,3,1,2,1,0,1,0,0,0,0,8,8,0,4,2,2,7,0,2,2,0,5,0,0,,,0,0,0,,,
"Sep 12, 2023 6:00 AM",55,30,25,18,10,8,26,7,19,21,10,11,1,1,0,11,22,22,0,10,5,5,21,0,7,2,5,30,2,5,,,0,0,0,,,
"Sep 12, 2023 7:00 AM",167,112,55,59,12,47,75,13,62,47,11,36,17,12,5,23,94,92,2,41,20,21,92,0,44,11,33,150,4,7,,,16,13,3,,,
"Sep 12, 2023 8:00 AM",351,268,83,93,24,69,168,57,111,126,53,73,32,14,18,72,219,208,11,61,30,30,196,0,101,23,78,297,3,12,,,22,19,3,,,
"Sep 12, 2023 9:00 AM",161,137,24,63,28,35,91,45,46,70,39,31,12,7,5,9,108,103,5,20,10,10,82,0,59,22,37,94,6,6,,,5,3,2,,,
"Sep 12, 2023 10:00 AM",77,57,20,70,39,31,79,54,25,53,34,19,9,3,6,5,42,41,1,14,7,7,31,0,47,37,10,34,3,6,,,5,4,1,,,
"Sep 12, 2023 11:00 AM",66,42,24,78,48,30,83,50,33,55,36,19,15,10,5,7,39,33,6,10,5,5,22,0,35,18,17,23,2,1,,,7,3,4,,,
"Sep 12, 2023 12:00 PM",74,38,36,71,41,30,81,37,44,52,33,19,12,8,4,21,21,20,1,30,14,16,18,0,50,30,20,33,5,3,,,8,7,1,,,
"Sep 12, 2023 1:00 PM",83,33,50,81,39,42,74,34,40,52,23,29,18,7,11,16,19,19,0,49,25,24,17,0,43,20,23,34,6,4,,,2,1,1,,,
"Sep 12, 2023 2:00 PM",81,34,47,58,30,28,74,44,30,52,32,20,17,9,8,29,17,12,5,51,25,25,10,0,34,23,11,29,7,5,,,8,4,4,,,
"Sep 12, 2023 3:00 PM",105,30,75,54,27,27,53,28,25,43,27,16,17,5,12,21,36,28,8,66,32,33,23,0,44,24,20,34,7,0,,,5,2,3,,,
"Sep 12, 2023 4:00 PM",167,56,111,79,54,25,109,69,40,79,52,27,38,19,19,34,47,31,16,131,65,66,28,0,65,50,15,46,6,7,,,9,2,7,,,
"Sep 12, 2023 5:00 PM",285,78,207,103,68,35,152,98,54,127,84,43,34,10,24,34,55,40,15,276,138,137,37,0,86,68,18,80,19,8,,,17,8,9,,,
"Sep 12, 2023 6:00 PM",266,71,195,142,90,52,203,136,67,149,87,62,26,15,11,37,43,33,10,234,118,115,33,0,116,93,23,66,11,11,,,12,2,10,,,
"Sep 12, 2023 7:00 PM",146,48,98,109,65,44,122,75,47,94,57,37,24,14,10,27,31,26,5,112,57,55,24,0,60,45,15,47,9,9,,,12,7,5,,,
"Sep 12, 2023 8:00 PM",71,23,48,35,18,17,58,29,29,42,22,20,13,4,9,13,17,13,4,63,30,31,12,0,26,13,13,24,5,2,,,5,3,2,,,
"Sep 12, 2023 9:00 PM",45,9,36,32,10,22,37,11,26,24,7,17,1,1,0,6,18,17,1,30,14,16,13,0,22,12,10,21,1,1,,,3,2,1,,,
"Sep 12, 2023 10:00 PM",32,9,23,10,9,1,11,8,3,8,6,2,2,2,0,4,12,10,2,34,17,17,9,0,12,3,9,6,1,0,,,1,1,0,,,
"Sep 12, 2023 11:00 PM",20,4,16,5,3,2,3,2,1,0,0,0,3,0,3,1,2,1,1,19,10,9,1,0,2,2,0,1,1,0,,,0,0,0,,,
"Sep 13, 2023 12:00 AM",4,2,2,0,0,0,0,0,0,0,0,0,0,0,0,1,0,0,0,8,4,4,0,0,1,1,0,3,0,1,,,2,2,0,,,
"Sep 13, 2023 1:00 AM",5,1,4,0,0,0,0,0,0,0,0,0,0,0,0,0,1,1,0,0,0,0,1,0,0,0,0,0,0,0,,,0,0,0,,,
"Sep 13, 2023 2:00 AM",2,2,0,0,0,0,0,0,0,0,0,0,0,0,0,0,2,2,0,2,1,1,2,0,3,2,1,0,0,0,,,0,0,0,,,
"Sep 13, 2023 3:00 AM",1,0,1,1,1,0,0,0,0,1,0,1,2,1,1,0,0,0,0,0,0,0,0,0,0,0,0,0,0,0,,,0,0,0,,,
"Sep 13, 2023 4:00 AM",5,1,4,0,0,0,2,2,0,2,2,0,0,0,0,0,1,1,0,1,0,0,1,0,0,0,0,3,0,0,,,1,1,0,,,
"Sep 13, 2023 5:00 AM",10,4,6,11,10,1,10,8,2,11,9,2,0,0,0,2,6,6,0,8,3,4,6,0,1,1,0,7,0,0,,,0,0,0,,,
"Sep 13, 2023 6:00 AM",47,28,19,19,7,12,25,5,20,21,7,14,5,4,1,11,18,17,1,13,6,7,15,0,11,3,8,50,2,2,,,3,2,1,,,
"Sep 13, 2023 7:00 AM",174,123,51,91,26,65,102,28,74,82,25,57,13,9,4,19,122,120,2,24,12,12,113,0,51,17,34,139,2,6,,,12,9,3,,,
"Sep 13, 2023 8:00 AM",344,266,78,119,30,89,190,57,133,147,62,85,69,36,33,62,224,214,10,81,40,40,203,0,119,29,90,286,5,11,,,18,17,1,,,
"Sep 13, 2023 9:00 AM",169,148,21,67,28,39,89,41,48,69,40,29,22,14,8,14,103,102,1,18,8,9,82,0,51,18,33,85,7,5,,,11,7,4,,,
"Sep 13, 2023 10:00 AM",82,62,20,62,27,35,70,42,28,55,36,19,15,5,10,9,39,38,1,20,10,10,26,0,30,17,13,37,1,4,,,6,3,3,,,
"Sep 13, 2023 11:00 AM",49,34,15,66,28,38,83,39,44,65,29,36,11,7,4,11,27,24,3,28,14,14,16,0,29,22,7,22,5,1,,,5,4,1,,,
"Sep 13, 2023 12:00 PM",75,34,41,58,26,32,89,44,45,60,28,32,16,8,8,22,25,25,0,28,14,14,15,0,29,14,15,38,6,1,,,4,4,0,,,
"Sep 13, 2023 1:00 PM",96,39,57,80,44,36,112,65,47,89,61,28,32,14,18,17,33,29,4,55,26,28,23,0,66,38,28,29,5,3,,,8,8,0,,,
"Sep 13, 2023 2:00 PM",76,25,51,59,29,30,53,21,32,41,20,21,16,8,8,27,25,19,6,57,27,29,18,0,33,12,21,25,2,1,,,3,1,2,,,
"Sep 13, 2023 3:00 PM",102,36,66,25,16,9,46,35,11,27,19,8,10,4,6,19,29,23,6,76,37,38,13,0,22,14,8,31,3,1,,,5,2,3,,,
"Sep 13, 2023 4:00 PM",163,38,125,51,27,24,65,37,28,56,33,23,21,15,6,32,36,24,12,120,60,60,26,0,63,44,19,43,4,4,,,1,1,0,,,
"Sep 13, 2023 5:00 PM",283,64,219,55,42,13,111,63,48,96,58,38,20,4,16,25,39,27,12,248,121,126,27,0,60,49,11,64,9,3,,,4,4,0,,,
"Sep 13, 2023 6:00 PM",203,53,150,52,45,7,92,70,22,70,54,16,12,2,10,22,37,26,11,207,102,104,26,0,84,67,17,34,5,3,,,9,2,7,,,
"Sep 13, 2023 7:00 PM",96,18,78,35,17,18,56,43,13,32,19,13,6,3,3,16,20,17,3,98,49,48,20,0,42,37,5,21,2,2,,,4,2,2,,,
"Sep 13, 2023 8:00 PM",75,17,58,20,16,4,31,20,11,17,12,5,1,0,1,8,11,7,4,57,28,28,7,0,17,14,3,18,5,2,,,1,1,0,,,
"Sep 13, 2023 9:00 PM",35,10,25,13,10,3,13,9,4,12,9,3,3,0,3,1,10,8,2,30,15,15,10,0,9,8,1,9,3,1,,,1,1,0,,,
"Sep 13, 2023 10:00 PM",26,7,19,0,0,0,5,4,1,2,2,0,2,2,0,3,6,5,1,28,14,14,5,0,4,2,2,7,0,0,,,0,0,0,,,
"Sep 13, 2023 11:00 PM",7,2,5,2,2,0,7,6,1,2,1,1,1,0,1,4,1,1,0,5,2,2,0,0,4,4,0,0,0,0,,,1,0,1,,,
"Sep 14, 2023 12:00 AM",4,0,4,0,0,0,1,1,0,5,2,3,0,0,0,0,2,2,0,10,5,5,0,0,1,0,1,2,0,0,,,0,0,0,,,
"Sep 14, 2023 1:00 AM",4,1,3,1,1,0,0,0,0,0,0,0,0,0,0,1,0,0,0,0,0,0,0,0,0,0,0,1,0,0,,,0,0,0,,,
"Sep 14, 2023 2:00 AM",2,2,0,2,2,0,0,0,0,1,1,0,0,0,0,0,2,2,0,2,1,1,2,0,0,0,0,2,0,0,,,0,0,0,,,
"Sep 14, 2023 3:00 AM",1,0,1,1,1,0,0,0,0,0,0,0,0,0,0,0,0,0,0,2,1,1,0,0,0,0,0,0,0,2,,,0,0,0,,,
"Sep 14, 2023 4:00 AM",3,1,2,0,0,0,0,0,0,0,0,0,0,0,0,0,0,0,0,2,1,1,0,0,0,0,0,1,0,0,,,0,0,0,,,
"Sep 14, 2023 5:00 AM",8,5,3,2,0,2,5,2,3,4,2,2,0,0,0,2,6,6,0,6,2,2,6,0,1,0,1,8,0,0,,,0,0,0,,,
"Sep 14, 2023 6:00 AM",44,28,16,19,10,9,21,6,15,14,6,8,3,2,1,7,22,22,0,12,6,6,19,0,10,3,7,31,2,2,,,1,1,0,,,
"Sep 14, 2023 7:00 AM",139,93,46,46,16,30,71,21,50,45,17,28,11,9,2,18,85,84,1,38,19,19,83,0,49,18,31,131,2,7,,,12,10,2,,,
"Sep 14, 2023 8:00 AM",285,217,68,120,31,89,169,53,116,142,55,87,30,15,15,52,212,202,10,63,32,31,178,0,93,23,70,243,5,10,,,20,18,2,,,
"Sep 14, 2023 9:00 AM",157,143,14,83,32,51,88,36,52,73,37,36,19,14,5,13,89,86,3,13,6,7,70,0,64,25,39,76,4,8,,,3,2,1,,,
"Sep 14, 2023 10:00 AM",77,56,21,64,32,32,68,38,30,45,31,14,11,1,10,15,45,44,1,23,11,11,33,0,32,18,14,37,6,3,,,3,3,0,,,
"Sep 14, 2023 11:00 AM",64,41,23,77,31,46,67,26,41,68,25,43,23,11,12,11,29,26,3,13,6,7,21,0,21,9,12,37,4,8,,,7,5,2,,,
"Sep 14, 2023 12:00 PM",73,26,47,80,41,39,79,43,36,52,33,19,18,8,10,13,23,19,4,24,12,12,19,0,40,16,24,21,3,2,,,5,4,1,,,
"Sep 14, 2023 1:00 PM",82,43,39,57,30,27,63,34,29,50,26,24,16,6,10,13,34,26,8,50,25,24,19,0,30,18,12,25,7,1,,,7,6,1,,,
"Sep 14, 2023 2:00 PM",75,18,57,45,25,20,55,28,27,44,24,20,23,13,10,12,19,14,5,46,22,23,9,0,34,20,14,23,3,3,,,7,3,4,,,
"Sep 14, 2023 3:00 PM",123,47,76,59,31,28,75,47,28,47,32,15,21,14,7,26,31,24,7,83,42,41,13,0,45,22,23,33,6,1,,,5,4,1,,,
"Sep 14, 2023 4:00 PM",146,41,105,71,47,24,89,54,35,69,41,28,18,9,9,36,38,25,13,103,51,52,20,0,52,35,17,48,8,7,,,7,5,2,,,
"Sep 14, 2023 5:00 PM",255,64,191,85,55,30,125,77,48,84,53,31,25,4,21,24,48,33,15,239,118,121,34,0,80,61,19,66,3,5,,,6,5,1,,,
"Sep 14, 2023 6:00 PM",183,36,147,56,42,14,80,66,14,68,47,21,13,4,9,14,25,21,4,171,85,86,22,0,69,58,11,38,3,4,,,9,4,5,,,
"Sep 14, 2023 7:00 PM",92,30,62,29,18,11,45,31,14,33,20,13,10,3,7,13,15,10,5,82,40,40,7,0,25,24,1,20,2,0,,,6,4,2,,,
"Sep 14, 2023 8:00 PM",64,20,44,19,13,6,19,14,5,14,10,4,1,1,0,8,11,9,2,35,17,18,9,0,10,6,4,12,3,0,,,0,0,0,,,
"Sep 14, 2023 9:00 PM",33,8,25,8,6,2,15,11,4,12,8,4,6,4,2,5,5,4,1,22,11,11,3,0,4,3,1,6,1,0,,,1,1,0,,,
"Sep 14, 2023 10:00 PM",29,4,25,5,2,3,8,3,5,4,1,3,2,1,1,2,9,7,2,20,10,10,8,0,4,4,0,11,0,0,,,0,0,0,,,
"Sep 14, 2023 11:00 PM",10,2,8,1,1,0,3,1,2,1,0,1,2,1,1,1,2,2,0,6,3,3,2,0,2,2,0,2,0,0,,,0,0,0,,,
"Sep 15, 2023 12:00 AM",9,1,8,0,0,0,1,1,0,1,0,1,0,0,0,1,4,4,0,5,2,2,3,0,0,0,0,2,0,0,,,0,0,0,,,
"Sep 15, 2023 1:00 AM",5,1,4,0,0,0,1,0,1,0,0,0,0,0,0,0,0,0,0,4,2,2,0,0,0,0,0,1,0,1,,,0,0,0,,,
"Sep 15, 2023 2:00 AM",2,2,0,0,0,0,0,0,0,0,0,0,0,0,0,0,1,0,1,2,1,1,0,0,0,0,0,1,0,0,,,0,0,0,,,
"Sep 15, 2023 3:00 AM",2,0,2,0,0,0,0,0,0,1,1,0,0,0,0,0,0,0,0,0,0,0,0,0,0,0,0,0,0,0,,,0,0,0,,,
"Sep 15, 2023 4:00 AM",4,1,3,0,0,0,0,0,0,0,0,0,0,0,0,0,2,1,1,1,0,0,1,0,0,0,0,1,0,0,,,0,0,0,,,
"Sep 15, 2023 5:00 AM",7,6,1,1,0,1,0,0,0,0,0,0,0,0,0,0,5,5,0,5,2,2,4,0,0,0,0,6,0,0,,,0,0,0,,,
"Sep 15, 2023 6:00 AM",32,21,11,7,2,5,7,4,3,5,3,2,3,1,2,4,10,9,1,8,4,4,9,0,0,0,0,18,1,3,,,0,0,0,,,
"Sep 15, 2023 7:00 AM",62,38,24,13,3,10,17,5,12,14,5,9,7,6,1,11,32,30,2,22,11,11,30,0,6,3,3,49,2,2,,,3,2,1,,,
"Sep 15, 2023 8:00 AM",126,89,37,21,4,17,42,13,29,32,15,17,8,3,5,14,59,52,7,21,10,10,47,0,26,6,20,66,2,2,,,8,7,1,,,
"Sep 15, 2023 9:00 AM",54,45,9,13,4,9,18,11,7,17,12,5,10,8,2,7,26,25,1,10,4,4,18,0,12,8,4,35,1,1,,,3,2,1,,,
"Sep 15, 2023 10:00 AM",34,21,13,6,1,5,10,5,5,8,4,4,8,7,1,2,10,10,0,4,2,2,7,0,5,1,4,11,0,0,,,0,0,0,,,
"Sep 15, 2023 11:00 AM",23,16,7,6,3,3,11,10,1,14,13,1,21,12,9,4,13,12,1,3,1,1,6,0,8,6,2,7,0,0,,,0,0,0,,,
"Sep 15, 2023 12:00 PM",40,21,19,2,1,1,64,8,56,65,1,64,0,0,0,3,6,5,1,18,9,9,4,0,59,12,47,6,0,0,,,0,0,0,,,
"Sep 15, 2023 1:00 PM",53,25,28,8,7,1,14,9,5,8,6,2,5,1,4,3,8,6,2,22,10,12,6,0,22,7,15,10,0,1,,,3,2,1,,,
"Sep 15, 2023 2:00 PM",40,14,26,12,9,3,13,9,4,12,8,4,1,1,0,4,10,8,2,18,9,9,6,0,10,7,3,10,2,0,,,1,0,1,,,
"Sep 15, 2023 3:00 PM",50,19,31,15,9,6,52,40,12,50,41,9,2,2,0,7,9,7,2,27,13,14,6,0,30,30,0,17,0,0,,,1,0,1,,,
"Sep 15, 2023 4:00 PM",63,12,51,9,5,4,30,26,4,35,29,6,10,5,5,8,7,6,1,43,21,22,8,0,16,15,1,10,0,1,,,0,0,0,,,
"Sep 15, 2023 5:00 PM",93,29,64,15,10,5,28,12,16,29,13,16,8,1,7,3,14,10,4,52,25,27,9,0,16,9,7,20,6,0,,,4,2,2,,,
"Sep 15, 2023 6:00 PM",65,26,39,15,12,3,25,19,6,26,16,10,1,0,1,14,12,9,3,49,24,24,10,0,18,17,1,16,4,0,,,3,1,2,,,
"Sep 15, 2023 7:00 PM",58,25,33,6,4,2,13,10,3,9,6,3,4,2,2,8,3,3,0,40,20,20,4,0,6,5,1,3,1,0,,,6,4,2,,,
"Sep 15, 2023 8:00 PM",48,16,32,6,6,0,8,7,1,6,4,2,3,0,3,6,4,4,0,8,4,4,4,0,6,5,1,12,1,0,,,0,0,0,,,
"Sep 15, 2023 9:00 PM",16,6,10,8,6,2,10,4,6,11,4,7,0,0,0,3,11,9,2,10,4,5,9,0,1,0,1,1,0,0,,,2,1,1,,,
"Sep 15, 2023 10:00 PM",12,7,5,5,5,0,4,3,1,2,1,1,4,1,3,2,2,2,0,8,4,4,2,0,3,3,0,4,2,0,,,1,1,0,,,
"Sep 15, 2023 11:00 PM",6,2,4,2,2,0,4,3,1,2,1,1,2,0,2,2,3,3,0,12,6,6,3,0,1,1,0,0,0,0,,,1,0,1,,,
"Sep 16, 2023 12:00 AM",6,0,6,0,0,0,1,1,0,2,0,2,1,1,0,0,0,0,0,4,2,2,0,0,0,0,0,5,0,0,,,0,0,0,,,
"Sep 16, 2023 1:00 AM",5,2,3,1,0,1,1,0,1,1,0,1,1,1,0,0,0,0,0,2,1,1,0,0,0,0,0,1,0,0,,,0,0,0,,,
"Sep 16, 2023 2:00 AM",3,3,0,1,1,0,0,0,0,0,0,0,2,0,2,0,0,0,0,1,0,0,0,0,0,0,0,1,0,0,,,0,0,0,,,
"Sep 16, 2023 3:00 AM",1,1,0,0,0,0,0,0,0,0,0,0,0,0,0,0,0,0,0,0,0,0,1,0,0,0,0,0,0,0,,,0,0,0,,,
"Sep 16, 2023 4:00 AM",5,0,5,0,0,0,0,0,0,0,0,0,0,0,0,0,1,1,0,0,0,0,1,0,0,0,0,0,0,0,,,2,1,1,,,
"Sep 16, 2023 5:00 AM",4,1,3,1,0,1,1,0,1,1,0,1,0,0,0,0,2,2,0,2,1,1,2,0,0,0,0,0,0,0,,,0,0,0,,,
"Sep 16, 2023 6:00 AM",10,4,6,1,0,1,2,0,2,1,0,1,0,0,0,0,2,2,0,4,2,2,2,0,1,1,0,3,0,0,,,0,0,0,,,
"Sep 16, 2023 7:00 AM",16,7,9,12,6,6,18,14,4,14,8,6,3,3,0,2,4,4,0,2,1,1,3,0,4,2,2,12,1,1,,,1,0,1,,,
"Sep 16, 2023 8:00 AM",45,26,19,21,14,7,26,15,11,19,13,6,6,3,3,10,6,6,0,9,4,5,6,0,5,2,3,17,1,2,,,0,0,0,,,
"Sep 16, 2023 9:00 AM",25,12,13,27,17,10,40,28,12,37,29,8,3,2,1,13,16,15,1,8,4,4,13,0,15,8,7,8,4,0,,,4,3,1,,,
"Sep 16, 2023 10:00 AM",37,18,19,57,30,27,44,26,18,44,31,13,10,6,4,15,9,9,0,13,6,7,8,0,13,9,4,14,2,3,,,6,3,3,,,
"Sep 16, 2023 11:00 AM",35,22,13,41,18,23,49,29,20,40,22,18,18,13,5,7,9,8,1,10,5,5,7,0,32,21,11,18,2,3,,,6,5,1,,,
"Sep 16, 2023 12:00 PM",37,21,16,57,20,37,72,38,34,62,30,32,14,7,7,11,13,12,1,4,2,2,11,0,16,7,9,25,3,3,,,5,4,1,,,
"Sep 16, 2023 1:00 PM",34,18,16,37,17,20,44,19,25,27,13,14,9,6,3,7,7,6,1,15,7,8,5,0,24,10,14,21,3,2,,,2,2,0,,,
"Sep 16, 2023 2:00 PM",20,8,12,31,19,12,31,12,19,28,18,10,4,1,3,4,9,9,0,12,6,6,5,0,10,3,7,14,2,2,,,0,0,0,,,
"Sep 16, 2023 3:00 PM",39,18,21,19,10,9,35,19,16,28,12,16,5,4,1,7,10,7,3,12,6,6,7,0,15,11,4,23,2,1,,,3,2,1,,,
"Sep 16, 2023 4:00 PM",40,21,19,35,19,16,41,12,29,30,11,19,9,6,3,10,11,8,3,21,10,11,7,0,26,11,15,11,1,3,,,5,3,2,,,
"Sep 16, 2023 5:00 PM",46,26,20,39,22,17,47,23,24,36,21,15,14,6,8,22,16,13,3,10,5,5,14,0,20,8,12,16,1,0,,,8,6,2,,,
"Sep 16, 2023 6:00 PM",33,11,22,25,13,12,35,17,18,31,14,17,11,4,7,15,7,6,1,10,5,5,6,0,21,9,12,23,1,1,,,1,1,0,,,
"Sep 16, 2023 7:00 PM",42,14,28,4,2,2,20,9,11,11,5,6,4,3,1,8,14,14,0,18,9,9,11,0,14,12,2,16,2,3,,,1,1,0,,,
"Sep 16, 2023 8:00 PM",18,10,8,7,6,1,11,5,6,12,7,5,3,1,2,1,6,6,0,4,2,2,6,0,5,1,4,8,0,0,,,3,1,2,,,
"Sep 16, 2023 9:00 PM",17,5,12,1,1,0,5,1,4,4,2,2,4,2,2,2,6,5,1,12,6,6,5,0,5,3,2,3,0,0,,,0,0,0,,,
"Sep 16, 2023 10:00 PM",17,8,9,7,5,2,5,1,4,5,1,4,0,0,0,0,4,4,0,3,1,1,4,0,2,2,0,7,3,0,,,1,1,0,,,
"Sep 16, 2023 11:00 PM",8,3,5,5,3,2,7,4,3,6,1,5,1,1,0,5,2,2,0,6,3,3,2,0,4,2,2,7,0,0,,,0,0,0,,,
"Sep 17, 2023 12:00 AM",6,1,5,1,0,1,4,2,2,4,0,4,4,2,2,0,2,1,1,4,2,2,1,0,1,0,1,1,0,0,,,0,0,0,,,
"Sep 17, 2023 1:00 AM",8,2,6,2,2,0,1,1,0,1,1,0,0,0,0,0,0,0,0,2,1,1,0,0,1,1,0,4,2,1,,,0,0,0,,,
"Sep 17, 2023 2:00 AM",5,0,5,0,0,0,2,2,0,1,1,0,4,0,4,0,0,0,0,2,1,1,0,0,0,0,0,1,0,0,,,0,0,0,,,
"Sep 17, 2023 3:00 AM",3,0,3,1,1,0,1,1,0,0,0,0,0,0,0,0,0,0,0,0,0,0,1,0,1,1,0,0,0,1,,,0,0,0,,,
"Sep 17, 2023 4:00 AM",2,0,2,0,0,0,2,1,1,0,0,0,0,0,0,0,0,0,0,0,0,0,0,0,0,0,0,0,0,0,,,0,0,0,,,
"Sep 17, 2023 5:00 AM",0,0,0,1,0,1,0,0,0,0,0,0,1,1,0,0,0,0,0,2,1,1,1,0,0,0,0,2,0,0,,,0,0,0,,,
"Sep 17, 2023 6:00 AM",5,5,0,1,0,1,0,0,0,1,0,1,0,0,0,1,3,3,0,0,0,0,3,0,0,0,0,2,0,0,,,1,1,0,,,
"Sep 17, 2023 7:00 AM",7,3,4,4,2,2,2,2,0,2,2,0,0,0,0,3,6,6,0,6,3,3,4,0,2,1,1,5,0,1,,,1,0,1,,,
"Sep 17, 2023 8:00 AM",17,11,6,14,6,8,11,7,4,11,5,6,4,2,2,2,6,6,0,4,2,2,4,0,3,2,1,12,0,1,,,2,1,1,,,
"Sep 17, 2023 9:00 AM",19,11,8,15,5,10,18,13,5,18,12,6,4,2,2,5,7,6,1,2,1,1,6,0,8,6,2,9,1,2,,,1,1,0,,,
"Sep 17, 2023 10:00 AM",26,17,9,41,19,22,40,23,17,24,16,8,9,7,2,10,9,6,3,6,3,3,2,0,25,11,14,10,3,2,,,4,3,1,,,
"Sep 17, 2023 11:00 AM",28,13,15,43,21,22,37,16,21,34,18,16,8,7,1,10,9,9,0,18,8,8,7,0,12,4,8,16,1,4,,,4,3,1,,,
"Sep 17, 2023 12:00 PM",29,11,18,42,11,31,35,17,18,27,17,10,16,6,10,6,12,12,0,13,6,6,7,0,16,9,7,20,1,3,,,9,4,5,,,
"Sep 17, 2023 1:00 PM",44,21,23,64,30,34,53,25,28,30,12,18,7,2,5,4,18,18,0,17,8,9,12,0,7,3,4,32,4,1,,,3,1,2,,,
"Sep 17, 2023 2:00 PM",24,19,5,28,17,11,22,12,10,24,14,10,6,1,5,3,10,7,3,8,4,4,7,0,12,8,4,14,0,0,,,3,3,0,,,
"Sep 17, 2023 3:00 PM",19,8,11,19,9,10,14,5,9,14,5,9,2,2,0,4,6,6,0,10,5,5,4,0,15,7,8,14,1,1,,,0,0,0,,,
"Sep 17, 2023 4:00 PM",21,6,15,23,16,7,19,10,9,20,11,9,3,1,2,5,7,5,2,11,5,5,5,0,11,4,7,7,2,3,,,1,1,0,,,
"Sep 17, 2023 5:00 PM",29,13,16,13,7,6,18,4,14,10,3,7,4,3,1,5,3,2,1,8,4,3,2,0,6,2,4,15,0,1,,,0,0,0,,,
"Sep 17, 2023 6:00 PM",21,7,14,9,4,5,7,4,3,13,6,7,2,0,2,3,3,2,1,5,2,2,2,0,2,1,1,8,2,0,,,5,3,2,,,
"Sep 17, 2023 7:00 PM",15,8,7,11,8,3,11,7,4,8,5,3,5,4,1,5,7,5,2,6,3,3,3,0,4,3,1,7,1,0,,,4,3,1,,,
"Sep 17, 2023 8:00 PM",23,7,16,6,1,5,12,4,8,6,1,5,2,1,1,2,4,4,0,4,2,2,4,0,6,3,3,13,1,0,,,0,0,0,,,
"Sep 17, 2023 9:00 PM",8,1,7,7,6,1,9,4,5,5,3,2,3,0,3,5,5,5,0,4,2,2,2,0,2,1,1,7,1,0,,,1,1,0,,,
"Sep 17, 2023 10:00 PM",12,4,8,3,2,1,7,5,2,6,4,2,0,0,0,1,4,4,0,6,3,3,4,0,1,1,0,4,0,0,,,0,0,0,,,
"Sep 17, 2023 11:00 PM",4,1,3,1,1,0,2,1,1,3,2,1,4,1,3,1,0,0,0,2,1,1,0,0,0,0,0,2,0,0,,,0,0,0,,,
"Sep 18, 2023 12:00 AM",4,0,4,0,0,0,0,0,0,1,0,1,0,0,0,0,2,2,0,4,2,2,1,0,0,0,0,3,0,0,,,0,0,0,,,
"Sep 18, 2023 1:00 AM",3,2,1,0,0,0,0,0,0,1,0,1,0,0,0,0,0,0,0,2,1,1,0,0,0,0,0,0,0,1,,,0,0,0,,,
"Sep 18, 2023 2:00 AM",0,0,0,0,0,0,1,0,1,0,0,0,0,0,0,0,0,0,0,0,0,0,0,0,1,0,1,1,1,0,,,0,0,0,,,
"Sep 18, 2023 3:00 AM",1,1,0,0,0,0,0,0,0,0,0,0,0,0,0,0,0,0,0,2,1,1,0,0,0,0,0,0,0,0,,,0,0,0,,,
"Sep 18, 2023 4:00 AM",1,0,1,0,0,0,0,0,0,0,0,0,0,0,0,0,3,3,0,0,0,0,3,0,0,0,0,2,0,0,,,0,0,0,,,
"Sep 18, 2023 5:00 AM",7,6,1,0,0,0,4,1,3,3,1,2,0,0,0,0,4,4,0,3,1,1,4,0,0,0,0,9,0,0,,,0,0,0,,,
"Sep 18, 2023 6:00 AM",47,30,17,15,1,14,16,1,15,11,1,10,5,3,2,4,17,17,0,4,2,2,16,0,5,0,5,33,0,3,,,0,0,0,,,
"Sep 18, 2023 7:00 AM",119,92,27,47,17,30,64,16,48,44,12,32,5,4,1,14,95,92,3,24,12,12,75,0,30,12,18,116,3,5,,,10,9,1,,,
"Sep 18, 2023 8:00 AM",289,217,72,96,30,66,147,38,109,107,51,56,31,16,15,44,188,184,4,66,34,32,158,0,83,20,63,204,7,10,,,21,16,5,,,
"Sep 18, 2023 9:00 AM",171,147,24,54,18,36,56,23,33,51,25,26,11,5,6,18,102,101,1,20,9,9,73,0,36,14,22,70,7,7,,,8,5,3,,,
"Sep 18, 2023 10:00 AM",66,50,16,46,27,19,53,37,16,45,33,12,13,9,4,11,56,55,1,13,6,6,37,0,36,23,13,29,2,2,,,4,2,2,,,
"Sep 18, 2023 11:00 AM",53,31,22,60,25,35,59,22,37,40,15,25,13,6,7,6,34,29,5,17,8,9,20,0,27,8,19,15,3,2,,,2,2,0,,,
"Sep 18, 2023 12:00 PM",57,28,29,52,22,30,68,30,38,51,29,22,18,11,7,14,32,27,5,30,15,15,20,0,32,22,10,23,3,3,,,10,5,5,,,
"Sep 18, 2023 1:00 PM",74,34,40,60,35,25,63,34,29,47,29,18,15,3,12,15,24,23,1,41,19,21,20,0,26,15,11,24,5,4,,,2,1,1,,,
"Sep 18, 2023 2:00 PM",66,27,39,33,19,14,54,32,22,31,15,16,16,14,2,11,24,18,6,43,21,22,15,0,31,16,15,22,3,2,,,2,2,0,,,
"Sep 18, 2023 3:00 PM",91,27,64,46,23,23,51,25,26,29,17,12,9,4,5,35,34,24,10,71,36,35,17,0,38,28,10,25,1,5,,,7,1,6,,,
"Sep 18, 2023 4:00 PM",154,50,104,60,31,29,87,59,28,61,37,24,23,12,11,15,38,26,12,99,49,50,20,0,57,38,19,36,6,4,,,9,5,4,,,
"Sep 18, 2023 5:00 PM",247,65,182,92,59,33,129,77,52,101,59,42,33,16,17,31,58,40,18,254,127,127,29,0,69,47,22,72,5,3,,,3,3,0,,,
"Sep 18, 2023 6:00 PM",201,46,155,96,60,36,139,93,46,99,62,37,16,5,11,23,50,33,17,173,84,88,29,0,71,59,12,53,10,7,,,13,7,6,,,
"Sep 18, 2023 7:00 PM",138,31,107,54,31,23,75,43,32,60,32,28,12,7,5,26,25,17,8,92,45,46,13,0,37,27,10,30,2,3,,,13,9,4,,,
"Sep 18, 2023 8:00 PM",76,15,61,30,19,11,33,21,12,24,14,10,7,2,5,3,19,14,5,56,28,28,15,0,12,9,3,29,3,3,,,2,1,1,,,
"Sep 18, 2023 9:00 PM",33,5,28,14,7,7,15,5,10,11,6,5,3,2,1,11,7,5,2,21,10,11,5,0,4,3,1,7,1,0,,,6,6,0,,,
"Sep 18, 2023 10:00 PM",29,14,15,6,3,3,8,3,5,7,2,5,0,0,0,0,4,4,0,21,10,11,4,0,3,3,0,6,0,0,,,1,0,1,,,
"Sep 18, 2023 11:00 PM",11,2,9,2,2,0,5,3,2,1,0,1,3,0,3,2,3,3,0,10,5,5,3,0,2,2,0,2,0,0,,,1,0,1,,,
"Sep 19, 2023 12:00 AM",13,2,11,0,0,0,1,1,0,1,1,0,0,0,0,0,0,0,0,2,1,1,0,0,1,0,1,4,0,0,,,0,0,0,,,
"Sep 19, 2023 1:00 AM",2,0,2,0,0,0,0,0,0,1,0,1,0,0,0,0,1,1,0,2,1,1,0,0,0,0,0,0,0,0,,,0,0,0,,,
"Sep 19, 2023 2:00 AM",3,2,1,0,0,0,0,0,0,0,0,0,0,0,0,0,0,0,0,0,0,0,0,0,0,0,0,1,0,0,,,0,0,0,,,
"Sep 19, 2023 3:00 AM",1,0,1,0,0,0,0,0,0,0,0,0,0,0,0,0,0,0,0,0,0,0,0,0,0,0,0,0,0,0,,,0,0,0,,,
"Sep 19, 2023 4:00 AM",6,1,5,0,0,0,0,0,0,0,0,0,0,0,0,0,1,1,0,0,0,0,1,0,0,0,0,0,0,0,,,1,1,0,,,
"Sep 19, 2023 5:00 AM",10,8,2,0,0,0,1,0,1,0,0,0,0,0,0,2,5,5,0,6,3,3,6,0,1,1,0,5,0,0,,,0,0,0,,,
"Sep 19, 2023 6:00 AM",39,27,12,10,1,9,11,1,10,10,2,8,1,1,0,8,19,19,0,8,4,4,17,0,7,4,3,30,0,2,,,2,2,0,,,
"Sep 19, 2023 7:00 AM",125,82,43,40,8,32,49,8,41,39,12,27,9,6,3,12,83,82,1,24,12,12,77,0,15,6,9,123,7,5,,,8,8,0,,,
"Sep 19, 2023 8:00 AM",268,214,54,62,17,45,111,31,80,84,37,47,30,16,14,29,212,205,7,24,12,12,178,0,75,19,56,234,3,11,,,24,20,4,,,
"Sep 19, 2023 9:00 AM",153,130,23,43,15,28,47,19,28,39,20,19,14,11,3,9,95,93,2,17,8,8,68,0,31,8,23,56,3,6,,,3,2,1,,,
"Sep 19, 2023 10:00 AM",57,42,15,21,8,13,30,11,19,28,13,15,10,5,5,10,41,36,5,11,5,5,23,0,11,6,5,20,2,1,,,1,0,1,,,
"Sep 19, 2023 11:00 AM",40,31,9,16,7,9,25,7,18,21,12,9,11,4,7,5,28,27,1,14,8,6,16,0,6,0,6,23,3,0,,,1,1,0,,,
"Sep 19, 2023 12:00 PM",41,15,26,28,13,15,20,10,10,14,5,9,15,10,5,9,20,15,5,16,8,8,10,0,12,10,2,19,0,0,,,3,2,1,,,
"Sep 19, 2023 1:00 PM",69,27,42,23,12,11,23,14,9,19,13,6,8,4,4,7,19,16,3,24,12,12,14,0,8,6,2,19,1,1,,,3,1,2,,,
"Sep 19, 2023 2:00 PM",68,34,34,33,17,16,29,21,8,10,8,2,9,6,3,9,19,13,6,41,19,21,9,0,14,9,5,21,4,3,,,5,2,3,,,
"Sep 19, 2023 3:00 PM",88,26,62,27,21,6,38,22,16,23,17,6,8,4,4,16,17,15,2,55,27,27,9,0,22,14,8,20,2,2,,,2,2,0,,,
"Sep 19, 2023 4:00 PM",152,43,109,52,32,20,59,37,22,53,31,22,25,6,19,21,31,25,6,107,52,52,21,0,50,37,13,27,6,4,,,6,4,2,,,
"Sep 19, 2023 5:00 PM",216,48,168,65,38,27,115,69,46,83,46,37,20,8,12,23,42,28,14,221,109,111,27,0,54,40,14,55,8,13,,,12,7,5,,,
"Sep 19, 2023 6:00 PM",201,45,156,85,63,22,99,77,22,86,63,23,20,5,15,20,42,30,12,185,91,93,26,0,54,46,8,33,3,2,,,15,9,6,,,
"Sep 19, 2023 7:00 PM",123,34,89,37,24,13,48,40,8,37,24,13,6,2,4,23,24,14,10,99,49,49,14,0,29,25,4,24,5,7,,,13,8,5,,,
"Sep 19, 2023 8:00 PM",83,24,59,22,14,8,35,13,22,13,6,7,5,1,4,4,13,8,5,58,29,29,8,0,12,7,5,21,2,3,,,7,4,3,,,
"Sep 19, 2023 9:00 PM",40,12,28,4,3,1,10,4,6,5,1,4,2,1,1,4,5,3,2,22,11,11,5,0,7,5,2,12,4,3,,,4,1,3,,,
"Sep 19, 2023 10:00 PM",35,6,29,3,2,1,4,1,3,4,1,3,2,2,0,5,7,6,1,32,16,16,6,0,2,0,2,7,1,0,,,3,3,0,,,
"Sep 19, 2023 11:00 PM",11,0,11,2,2,0,2,0,2,0,0,0,3,2,1,4,5,4,1,2,1,1,4,0,3,2,1,1,0,1,,,0,0,0,,,
"Sep 20, 2023 12:00 AM",5,0,5,0,0,0,0,0,0,0,0,0,7,5,2,0,1,1,0,4,2,2,1,0,1,1,0,0,0,1,,,0,0,0,,,
"Sep 20, 2023 1:00 AM",5,1,4,0,0,0,0,0,0,0,0,0,0,0,0,0,0,0,0,0,0,0,0,0,1,1,0,0,0,0,,,0,0,0,,,
"Sep 20, 2023 2:00 AM",6,5,1,1,1,0,0,0,0,0,0,0,1,0,1,0,0,0,0,0,0,0,0,0,0,0,0,1,0,0,,,0,0,0,,,
"Sep 20, 2023 3:00 AM",0,0,0,0,0,0,0,0,0,0,0,0,0,0,0,0,0,0,0,0,0,0,0,0,0,0,0,0,0,0,,,0,0,0,,,
"Sep 20, 2023 4:00 AM",2,0,2,1,1,0,0,0,0,1,1,0,0,0,0,0,2,2,0,0,0,0,2,0,0,0,0,1,0,0,,,0,0,0,,,
"Sep 20, 2023 5:00 AM",10,6,4,7,7,0,7,7,0,7,7,0,2,2,0,4,5,5,0,5,2,2,5,0,1,1,0,6,0,0,,,0,0,0,,,
"Sep 20, 2023 6:00 AM",37,27,10,13,5,8,13,5,8,12,4,8,5,3,2,5,15,15,0,18,9,9,13,0,6,4,2,33,1,2,,,0,0,0,,,
"Sep 20, 2023 7:00 AM",124,87,37,54,14,40,76,15,61,51,17,34,9,6,3,16,83,80,3,34,17,17,73,0,33,11,22,123,2,5,,,12,11,1,,,
"Sep 20, 2023 8:00 AM",303,240,63,92,24,68,146,37,109,126,49,77,36,19,17,35,231,217,14,45,23,22,200,0,93,16,77,242,8,7,,,15,12,3,,,
"Sep 20, 2023 9:00 AM",160,132,28,62,23,39,84,41,43,70,36,34,20,14,6,12,108,105,3,25,12,13,81,0,46,16,30,85,3,8,,,3,2,1,,,
"Sep 20, 2023 10:00 AM",79,68,11,60,30,30,44,17,27,34,19,15,11,4,7,6,51,51,0,4,2,2,36,0,35,13,22,27,0,5,,,1,1,0,,,
"Sep 20, 2023 11:00 AM",54,31,23,40,18,22,47,30,17,35,19,16,18,10,8,10,30,26,4,24,12,12,21,0,24,13,11,18,1,0,,,1,1,0,,,
"Sep 20, 2023 12:00 PM",68,30,38,35,25,10,40,21,19,28,17,11,24,13,11,10,34,31,3,31,15,16,21,0,19,14,5,19,6,2,,,4,3,1,,,
"Sep 20, 2023 1:00 PM",104,51,53,59,26,33,70,37,33,42,25,17,20,7,13,9,20,19,1,54,27,27,14,0,26,13,13,32,5,3,,,8,6,2,,,
"Sep 20, 2023 2:00 PM",81,32,49,55,30,25,68,37,31,41,25,16,18,11,7,12,22,21,1,35,16,19,20,0,38,24,14,23,0,2,,,10,5,5,,,
"Sep 20, 2023 3:00 PM",102,35,67,51,27,24,60,34,26,39,25,14,17,7,10,19,38,29,9,71,35,35,20,0,35,24,11,27,1,3,,,9,4,5,,,
"Sep 20, 2023 4:00 PM",186,50,136,58,33,25,105,58,47,60,32,28,19,9,10,20,36,28,8,96,46,49,25,0,53,42,11,52,0,4,,,4,1,3,,,
"Sep 20, 2023 5:00 PM",264,64,200,99,65,34,126,72,54,107,66,41,27,9,18,31,49,35,14,267,132,134,35,0,87,54,33,62,10,11,,,8,3,5,,,
"Sep 20, 2023 6:00 PM",199,48,151,77,56,21,118,84,34,76,55,21,18,8,10,23,41,29,12,181,91,89,25,0,79,62,17,46,6,4,,,10,8,2,,,
"Sep 20, 2023 7:00 PM",138,41,97,54,34,20,71,52,19,52,37,15,12,7,5,15,30,19,11,99,49,49,19,0,43,34,9,33,3,2,,,4,1,3,,,
"Sep 20, 2023 8:00 PM",69,13,56,21,9,12,34,19,15,29,16,13,4,2,2,1,11,10,1,44,22,22,9,0,14,8,6,19,5,4,,,4,3,1,,,
"Sep 20, 2023 9:00 PM",50,11,39,19,16,3,13,8,5,7,3,4,4,1,3,5,7,7,0,40,19,21,4,0,6,6,0,9,6,0,,,6,5,1,,,
"Sep 20, 2023 10:00 PM",36,12,24,8,8,0,12,7,5,5,1,4,0,0,0,2,4,4,0,25,12,13,5,0,11,9,2,5,2,1,,,3,1,2,,,
"Sep 20, 2023 11:00 PM",12,1,11,2,1,1,8,5,3,1,0,1,1,1,0,0,3,2,1,6,3,3,2,0,4,4,0,4,0,0,,,0,0,0,,,
"Sep 21, 2023 12:00 AM",11,0,11,0,0,0,2,2,0,1,0,1,3,1,2,0,2,2,0,8,4,4,2,0,0,0,0,0,0,0,,,0,0,0,,,
"Sep 21, 2023 1:00 AM",3,1,2,1,1,0,2,2,0,0,0,0,0,0,0,1,0,0,0,4,2,2,0,0,3,3,0,1,0,1,,,0,0,0,,,
"Sep 21, 2023 2:00 AM",6,3,3,0,0,0,1,1,0,0,0,0,0,0,0,0,0,0,0,2,1,1,0,0,0,0,0,2,0,0,,,0,0,0,,,
"Sep 21, 2023 3:00 AM",0,0,0,0,0,0,0,0,0,0,0,0,0,0,0,0,0,0,0,0,0,0,1,0,0,0,0,0,0,0,,,0,0,0,,,
"Sep 21, 2023 4:00 AM",2,0,2,0,0,0,0,0,0,0,0,0,0,0,0,0,0,0,0,1,0,0,1,0,0,0,0,1,0,0,,,0,0,0,,,
"Sep 21, 2023 5:00 AM",11,6,5,4,0,4,5,1,4,5,3,2,1,1,0,3,6,6,0,9,4,4,5,0,1,0,1,9,0,0,,,0,0,0,,,
"Sep 21, 2023 6:00 AM",50,33,17,13,4,9,17,4,13,14,5,9,4,0,4,8,23,23,0,9,4,5,21,0,11,3,8,34,2,3,,,4,3,1,,,
"Sep 21, 2023 7:00 AM",167,120,47,51,19,32,65,21,44,50,18,32,10,7,3,18,88,86,2,34,17,17,80,0,34,13,21,121,2,7,,,11,9,2,,,
"Sep 21, 2023 8:00 AM",303,249,54,111,42,69,181,60,121,132,58,74,39,25,14,37,220,210,10,47,23,23,185,0,94,32,62,249,2,8,,,14,12,2,,,
"Sep 21, 2023 9:00 AM",159,138,21,64,35,29,80,42,38,66,40,26,20,16,4,15,108,106,2,24,12,12,77,0,52,21,31,102,2,8,,,6,5,1,,,
"Sep 21, 2023 10:00 AM",93,66,27,54,28,26,57,28,29,49,28,21,13,6,7,9,49,47,2,20,10,10,37,0,23,15,8,38,2,5,,,5,4,1,,,
"Sep 21, 2023 11:00 AM",55,31,24,56,24,32,49,24,25,45,18,27,16,5,11,13,23,21,2,19,10,9,14,0,32,14,18,26,4,4,,,3,2,1,,,
"Sep 21, 2023 12:00 PM",69,25,44,69,34,35,58,30,28,57,30,27,16,8,8,12,27,23,4,43,21,22,21,0,35,21,14,34,6,4,,,6,3,3,,,
"Sep 21, 2023 1:00 PM",103,53,50,75,36,39,80,47,33,60,36,24,20,9,11,7,25,23,2,24,12,12,20,0,40,28,12,32,7,1,,,8,5,3,,,
"Sep 21, 2023 2:00 PM",106,50,56,60,30,30,85,42,43,60,32,28,21,12,9,17,28,24,4,63,31,32,20,0,49,24,25,39,6,3,,,8,5,3,,,
"Sep 21, 2023 3:00 PM",122,46,76,56,33,23,81,47,34,43,25,18,16,7,9,34,40,35,5,70,35,35,26,0,47,27,20,27,4,2,,,8,6,2,,,
"Sep 21, 2023 4:00 PM",160,49,111,84,45,39,112,75,37,84,45,39,28,9,19,21,38,26,12,134,67,65,22,0,67,45,22,55,8,1,,,7,4,3,,,
"Sep 21, 2023 5:00 PM",285,59,226,119,75,44,155,84,71,117,68,49,24,8,16,40,50,32,18,234,116,118,29,0,90,65,25,69,5,12,,,10,5,5,,,
"Sep 21, 2023 6:00 PM",227,45,182,83,57,26,152,105,47,101,63,38,23,6,17,23,47,34,13,194,96,97,33,0,85,63,22,52,9,8,,,6,2,4,,,
"Sep 21, 2023 7:00 PM",147,42,105,35,19,16,57,31,26,38,21,17,5,2,3,18,24,21,3,84,41,42,17,0,42,29,13,32,7,5,,,10,7,3,,,
"Sep 21, 2023 8:00 PM",85,32,53,22,11,11,30,19,11,16,9,7,2,0,2,2,16,11,5,53,25,27,12,0,16,10,6,20,3,4,,,6,5,1,,,
"Sep 21, 2023 9:00 PM",46,12,34,6,2,4,13,4,9,14,8,6,1,0,1,4,11,7,4,35,18,17,5,0,3,2,1,16,1,0,,,6,2,4,,,
"Sep 21, 2023 10:00 PM",40,6,34,10,8,2,10,6,4,9,4,5,1,0,1,1,9,7,2,28,14,14,6,0,7,7,0,6,3,2,,,1,0,1,,,
"Sep 21, 2023 11:00 PM",24,5,19,8,7,1,8,7,1,10,7,3,0,0,0,4,3,3,0,10,5,5,2,0,3,3,0,6,0,0,,,0,0,0,,,
"Sep 22, 2023 12:00 AM",17,3,14,0,0,0,2,2,0,0,0,0,0,0,0,3,3,3,0,14,7,7,2,0,1,1,0,1,1,0,,,0,0,0,,,
"Sep 22, 2023 1:00 AM",9,1,8,4,4,0,2,2,0,3,2,1,1,1,0,1,0,0,0,2,1,1,0,0,2,2,0,0,1,1,,,0,0,0,,,
"Sep 22, 2023 2:00 AM",3,3,0,0,0,0,1,0,1,0,0,0,0,0,0,1,2,2,0,0,0,0,1,0,1,0,1,1,0,0,,,0,0,0,,,
"Sep 22, 2023 3:00 AM",0,0,0,0,0,0,0,0,0,0,0,0,0,0,0,0,0,0,0,0,0,0,0,0,0,0,0,0,0,0,,,0,0,0,,,
"Sep 22, 2023 4:00 AM",4,1,3,0,0,0,0,0,0,0,0,0,0,0,0,0,1,1,0,0,0,0,1,0,1,1,0,2,0,0,,,0,0,0,,,
"Sep 22, 2023 5:00 AM",8,4,4,4,3,1,4,3,1,3,3,0,0,0,0,3,8,7,1,5,2,2,7,0,2,2,0,6,1,0,,,0,0,0,,,
"Sep 22, 2023 6:00 AM",41,23,18,12,3,9,14,8,6,11,4,7,6,4,2,6,11,11,0,18,9,9,10,0,7,4,3,31,1,1,,,4,2,2,,,
"Sep 22, 2023 7:00 AM",99,68,31,56,25,31,61,26,35,42,18,24,10,7,3,12,59,55,4,27,14,13,51,0,24,11,13,90,2,1,,,7,6,1,,,
"Sep 22, 2023 8:00 AM",230,176,54,82,25,57,113,37,76,93,41,52,31,15,16,32,157,147,10,32,15,16,121,0,66,21,45,160,5,9,,,14,10,4,,,
"Sep 22, 2023 9:00 AM",129,105,24,68,22,46,78,38,40,70,40,30,25,19,6,10,58,58,0,22,11,11,41,0,35,17,18,63,4,9,,,5,4,1,,,
"Sep 22, 2023 10:00 AM",62,37,25,45,28,17,43,20,23,35,23,12,13,4,9,10,41,40,1,26,13,13,23,0,20,13,7,25,3,1,,,4,2,2,,,
"Sep 22, 2023 11:00 AM",55,27,28,44,27,17,35,19,16,38,24,14,8,6,2,8,34,31,3,16,7,9,21,0,17,10,7,15,3,0,,,0,0,0,,,
"Sep 22, 2023 12:00 PM",80,33,47,53,28,25,55,29,26,40,22,18,20,6,14,10,28,22,6,46,22,24,16,0,23,12,11,28,3,0,,,5,3,2,,,
"Sep 22, 2023 1:00 PM",104,43,61,41,22,19,61,36,25,42,23,19,24,10,14,9,28,25,3,54,26,27,11,0,37,31,6,29,1,0,,,5,2,3,,,
"Sep 22, 2023 2:00 PM",98,38,60,44,26,18,60,37,23,42,20,22,17,8,9,23,29,26,3,29,13,16,19,0,37,18,19,31,2,4,,,12,8,4,,,
"Sep 22, 2023 3:00 PM",111,29,82,49,16,33,83,41,42,53,27,26,14,8,6,19,34,23,11,52,26,26,18,0,38,18,20,29,0,2,,,7,4,3,,,
"Sep 22, 2023 4:00 PM",148,35,113,55,37,18,76,48,28,59,41,18,16,4,12,16,33,23,10,97,47,50,21,0,38,23,15,31,6,4,,,7,5,2,,,
"Sep 22, 2023 5:00 PM",183,55,128,71,47,24,104,56,48,69,35,34,24,7,17,22,40,33,7,130,63,66,34,0,50,29,21,57,6,4,,,6,5,1,,,
"Sep 22, 2023 6:00 PM",142,53,89,49,31,18,83,53,30,62,37,25,20,7,13,22,16,12,4,94,43,49,13,0,54,39,15,38,4,4,,,9,6,3,,,
"Sep 22, 2023 7:00 PM",87,28,59,28,14,14,48,30,18,24,13,11,6,2,4,12,19,15,4,36,18,18,14,0,27,19,8,36,2,4,,,6,4,2,,,
"Sep 22, 2023 8:00 PM",55,20,35,12,7,5,18,6,12,20,7,13,5,2,3,3,14,13,1,26,13,13,14,0,12,8,4,18,5,3,,,7,5,2,,,
"Sep 22, 2023 9:00 PM",43,15,28,8,6,2,13,6,7,3,2,1,5,2,3,8,8,7,1,21,9,10,6,0,3,3,0,3,2,1,,,2,1,1,,,
"Sep 22, 2023 10:00 PM",29,9,20,8,5,3,9,4,5,7,3,4,4,1,3,1,4,4,0,18,9,9,5,0,3,2,1,9,2,0,,,2,2,0,,,
"Sep 22, 2023 11:00 PM",19,6,13,7,3,4,7,6,1,8,2,6,2,2,0,2,2,2,0,19,9,9,1,0,3,2,1,5,1,1,,,1,0,1,,,
"Sep 23, 2023 12:00 AM",14,3,11,0,0,0,1,0,1,5,1,4,5,0,5,1,6,6,0,10,4,4,5,0,1,1,0,4,0,0,,,0,0,0,,,
"Sep 23, 2023 1:00 AM",12,3,9,1,1,0,1,1,0,1,1,0,0,0,0,0,3,3,0,8,4,4,2,0,1,1,0,2,0,1,,,2,0,2,,,
"Sep 23, 2023 2:00 AM",6,3,3,0,0,0,4,3,1,1,0,1,1,0,1,0,1,1,0,0,0,0,1,0,0,0,0,1,0,0,,,2,1,1,,,
"Sep 23, 2023 3:00 AM",3,0,3,0,0,0,0,0,0,0,0,0,0,0,0,0,0,0,0,2,1,1,0,0,0,0,0,0,0,0,,,0,0,0,,,
"Sep 23, 2023 4:00 AM",5,3,2,0,0,0,0,0,0,0,0,0,0,0,0,2,0,0,0,0,0,0,0,0,0,0,0,1,0,0,,,1,0,1,,,
"Sep 23, 2023 5:00 AM",3,0,3,2,0,2,1,0,1,1,0,1,2,2,0,1,0,0,0,4,2,2,0,0,1,1,0,2,1,1,,,0,0,0,,,
"Sep 23, 2023 6:00 AM",9,7,2,6,1,5,7,4,3,4,0,4,0,0,0,2,6,6,0,8,4,4,7,0,2,1,1,8,1,2,,,1,1,0,,,
"Sep 23, 2023 7:00 AM",24,13,11,26,15,11,26,19,7,23,15,8,4,2,2,4,10,10,0,13,6,7,8,0,10,6,4,13,0,1,,,1,1,0,,,
"Sep 23, 2023 8:00 AM",37,22,15,53,32,21,59,39,20,38,30,8,7,2,5,10,14,14,0,14,7,7,13,0,18,10,8,18,1,4,,,5,3,2,,,
"Sep 23, 2023 9:00 AM",50,27,23,96,50,46,93,61,32,81,57,24,12,7,5,20,24,22,2,23,11,11,23,0,34,24,10,22,5,14,,,9,4,5,,,
"Sep 23, 2023 10:00 AM",56,29,27,124,61,63,89,44,45,85,46,39,25,12,13,15,27,23,4,20,9,10,20,0,33,22,11,33,5,9,,,7,4,3,,,
"Sep 23, 2023 11:00 AM",63,32,31,139,85,54,126,78,48,115,82,33,24,13,11,24,12,12,0,16,8,8,12,0,59,29,30,28,8,8,,,9,7,2,,,
"Sep 23, 2023 12:00 PM",72,35,37,188,62,126,168,88,80,157,84,73,67,39,28,19,24,23,1,24,12,12,15,0,61,36,25,32,8,2,,,6,4,2,,,
"Sep 23, 2023 1:00 PM",67,41,26,110,61,49,120,73,47,109,61,48,31,20,11,19,21,19,2,18,8,9,17,0,60,34,26,29,7,7,,,6,3,3,,,
"Sep 23, 2023 2:00 PM",51,23,28,75,40,35,104,54,50,85,47,38,20,6,14,17,15,13,2,20,10,10,10,0,39,16,23,23,3,6,,,7,4,3,,,
"Sep 23, 2023 3:00 PM",71,36,35,59,25,34,70,33,37,54,20,34,20,13,7,17,18,16,2,25,13,12,16,0,41,31,10,15,4,3,,,8,6,2,,,
"Sep 23, 2023 4:00 PM",47,25,22,73,38,35,98,42,56,68,23,45,15,5,10,24,16,15,1,25,12,13,15,0,56,28,28,28,7,3,,,7,5,2,,,
"Sep 23, 2023 5:00 PM",47,15,32,51,37,14,59,15,44,37,13,24,19,5,14,20,9,8,1,32,16,16,8,0,35,11,24,31,4,2,,,6,4,2,,,
"Sep 23, 2023 6:00 PM",50,17,33,47,27,20,63,24,39,39,10,29,12,2,10,7,10,10,0,23,11,11,12,0,24,9,15,22,2,1,,,2,1,1,,,
"Sep 23, 2023 7:00 PM",43,20,23,16,9,7,21,4,17,11,4,7,10,5,5,5,13,12,1,21,10,10,14,0,10,6,4,18,0,1,,,5,2,3,,,
"Sep 23, 2023 8:00 PM",45,19,26,4,3,1,5,3,2,4,2,2,5,1,4,3,10,9,1,9,5,4,8,0,3,2,1,5,1,0,,,2,2,0,,,
"Sep 23, 2023 9:00 PM",20,6,14,6,3,3,5,3,2,2,2,0,0,0,0,1,2,1,1,0,0,0,0,0,2,2,0,3,0,0,,,1,0,1,,,
"Sep 23, 2023 10:00 PM",15,6,9,5,2,3,9,4,5,6,2,4,2,2,0,2,7,6,1,16,8,8,6,0,2,1,1,9,1,0,,,0,0,0,,,
"Sep 23, 2023 11:00 PM",17,4,13,4,2,2,7,2,5,6,2,4,4,3,1,3,7,6,1,6,3,3,5,0,3,2,1,5,0,0,,,1,1,0,,,
"Sep 24, 2023 12:00 AM",6,2,4,0,0,0,2,0,2,2,0,2,4,1,3,0,3,3,0,6,2,2,2,0,2,1,1,6,0,0,,,2,2,0,,,
"Sep 24, 2023 1:00 AM",8,2,6,3,2,1,6,5,1,3,2,1,0,0,0,0,2,2,0,8,4,4,3,0,2,2,0,1,1,0,,,0,0,0,,,
"Sep 24, 2023 2:00 AM",6,3,3,1,1,0,3,2,1,2,1,1,0,0,0,0,2,2,0,2,1,1,2,0,0,0,0,2,0,0,,,0,0,0,,,
"Sep 24, 2023 3:00 AM",3,1,2,1,1,0,4,4,0,2,2,0,0,0,0,0,0,0,0,2,1,1,0,0,2,1,1,1,0,1,,,1,0,1,,,
"Sep 24, 2023 4:00 AM",2,1,1,1,1,0,3,2,1,1,1,0,1,0,1,0,0,0,0,0,0,0,0,0,0,0,0,2,1,0,,,0,0,0,,,
"Sep 24, 2023 5:00 AM",3,1,2,1,0,1,2,1,1,2,2,0,0,0,0,2,0,0,0,4,2,2,0,0,1,0,1,0,0,0,,,0,0,0,,,
"Sep 24, 2023 6:00 AM",8,7,1,4,3,1,6,5,1,5,4,1,0,0,0,1,1,1,0,0,0,0,1,0,1,1,0,5,0,0,,,0,0,0,,,
"Sep 24, 2023 7:00 AM",11,3,8,12,7,5,21,13,8,8,6,2,1,1,0,3,5,5,0,4,2,2,5,0,9,5,4,9,0,2,,,0,0,0,,,
"Sep 24, 2023 8:00 AM",31,21,10,51,33,18,62,43,19,41,30,11,5,5,0,3,6,6,0,10,5,5,6,0,18,14,4,19,2,2,,,2,1,1,,,
"Sep 24, 2023 9:00 AM",17,9,8,100,47,53,84,50,34,68,36,32,12,5,7,16,13,11,2,6,3,3,10,0,31,22,9,27,2,3,,,1,0,1,,,
"Sep 24, 2023 10:00 AM",39,20,19,82,40,42,71,31,40,63,31,32,13,10,3,7,16,14,2,12,6,6,13,0,40,19,21,27,2,4,,,3,2,1,,,
"Sep 24, 2023 11:00 AM",23,8,15,61,35,26,62,33,29,45,22,23,9,5,4,11,12,12,0,6,3,3,13,0,28,13,15,20,1,1,,,2,2,0,,,
"Sep 24, 2023 12:00 PM",27,13,14,59,29,30,44,19,25,36,21,15,12,6,6,5,12,11,1,20,10,10,9,0,13,4,9,22,5,0,,,8,6,2,,,
"Sep 24, 2023 1:00 PM",48,28,20,45,19,26,48,24,24,36,18,18,5,2,3,19,17,16,1,24,12,12,13,0,26,20,6,17,2,0,,,3,0,3,,,
"Sep 24, 2023 2:00 PM",23,15,8,43,25,18,45,26,19,36,22,14,21,11,10,10,7,6,1,11,5,6,3,0,17,6,11,16,3,4,,,2,1,1,,,
"Sep 24, 2023 3:00 PM",43,29,14,48,23,25,26,14,12,38,16,22,8,6,2,7,9,8,1,8,4,4,6,0,19,8,11,10,5,2,,,2,2,0,,,
"Sep 24, 2023 4:00 PM",41,12,29,23,12,11,18,3,15,14,5,9,14,5,9,14,6,6,0,17,8,9,5,0,25,17,8,11,2,0,,,1,1,0,,,
"Sep 24, 2023 5:00 PM",47,16,31,18,10,8,21,12,9,14,9,5,7,0,7,7,8,5,3,10,5,5,4,0,24,13,11,12,0,0,,,4,2,2,,,
"Sep 24, 2023 6:00 PM",37,12,25,10,3,7,7,5,2,5,2,3,4,2,2,7,10,5,5,4,2,2,6,0,6,5,1,12,1,3,,,2,1,1,,,
"Sep 24, 2023 7:00 PM",23,8,15,19,11,8,20,9,11,11,6,5,3,0,3,4,9,6,3,10,5,5,5,0,13,9,4,15,0,0,,,0,0,0,,,
"Sep 24, 2023 8:00 PM",14,4,10,5,3,2,2,2,0,5,3,2,1,0,1,4,7,6,1,10,5,5,6,0,2,1,1,9,1,1,,,1,1,0,,,
"Sep 24, 2023 9:00 PM",11,6,5,2,2,0,2,1,1,1,1,0,0,0,0,0,8,8,0,2,1,1,4,0,0,0,0,2,0,0,,,2,2,0,,,
"Sep 24, 2023 10:00 PM",11,5,6,1,0,1,5,3,2,1,0,1,0,0,0,1,7,7,0,5,2,2,6,0,2,2,0,2,1,0,,,1,0,1,,,
"Sep 24, 2023 11:00 PM",5,3,2,1,1,0,7,5,2,1,1,0,0,0,0,1,4,4,0,8,4,4,4,0,2,2,0,2,0,0,,,0,0,0,,,
"Sep 25, 2023 12:00 AM",2,0,2,0,0,0,2,2,0,3,3,0,0,0,0,0,0,0,0,3,1,1,0,0,2,2,0,0,0,0,,,1,1,0,,,
"Sep 25, 2023 1:00 AM",3,2,1,0,0,0,3,0,3,0,0,0,0,0,0,0,1,1,0,0,0,0,1,0,0,0,0,2,0,0,,,0,0,0,,,
"Sep 25, 2023 2:00 AM",2,1,1,1,0,1,0,0,0,0,0,0,0,0,0,0,0,0,0,0,0,0,0,0,0,0,0,0,0,0,,,0,0,0,,,
"Sep 25, 2023 3:00 AM",0,0,0,1,0,1,1,0,1,1,0,1,0,0,0,0,0,0,0,0,0,0,0,0,0,0,0,0,0,0,,,1,1,0,,,
"Sep 25, 2023 4:00 AM",2,0,2,0,0,0,0,0,0,0,0,0,0,0,0,0,2,2,0,1,0,0,2,0,1,0,1,0,0,0,,,0,0,0,,,
"Sep 25, 2023 5:00 AM",8,5,3,1,1,0,2,0,2,2,1,1,1,1,0,2,6,6,0,3,1,1,7,0,1,1,0,3,0,1,,,0,0,0,,,
"Sep 25, 2023 6:00 AM",51,31,20,8,0,8,13,3,10,9,1,8,2,0,2,6,19,19,0,6,3,3,16,0,4,2,2,31,1,4,,,2,2,0,,,
"Sep 25, 2023 7:00 AM",113,85,28,54,23,31,83,24,59,58,21,37,13,9,4,20,94,89,5,28,14,14,86,0,36,10,26,120,2,10,,,9,7,2,,,
"Sep 25, 2023 8:00 AM",296,221,75,87,25,62,165,69,96,111,50,61,35,16,19,48,215,210,5,52,25,25,185,0,105,35,70,209,8,8,,,21,20,1,,,
"Sep 25, 2023 9:00 AM",145,115,30,65,24,41,76,38,38,66,35,31,16,10,6,21,106,104,2,34,17,16,74,0,45,18,27,67,2,6,,,5,2,3,,,
"Sep 25, 2023 10:00 AM",71,55,16,55,24,31,76,38,38,44,28,16,18,10,8,11,48,46,2,12,6,6,29,0,35,20,15,29,1,1,,,2,2,0,,,
"Sep 25, 2023 11:00 AM",75,47,28,39,22,17,63,35,28,27,18,9,16,7,9,10,34,30,4,22,11,11,22,0,33,17,16,26,3,2,,,5,5,0,,,
"Sep 25, 2023 12:00 PM",80,45,35,49,16,33,59,20,39,40,18,22,13,8,5,12,39,34,5,26,13,13,19,0,34,16,18,19,5,4,,,8,5,3,,,
"Sep 25, 2023 1:00 PM",91,35,56,47,31,16,63,37,26,45,21,24,15,6,9,9,21,18,3,36,17,19,13,0,18,11,7,31,3,2,,,5,4,1,,,
"Sep 25, 2023 2:00 PM",75,26,49,54,29,25,60,35,25,39,19,20,19,9,10,14,26,24,2,49,24,24,21,0,24,17,7,21,6,3,,,14,6,8,,,
"Sep 25, 2023 3:00 PM",103,27,76,59,38,21,53,29,24,39,25,14,8,6,2,30,25,21,4,71,36,35,11,0,37,20,17,26,2,3,,,8,5,3,,,
"Sep 25, 2023 4:00 PM",133,23,110,64,36,28,78,54,24,56,29,27,16,8,8,26,44,32,12,94,47,47,28,0,39,26,13,36,4,1,,,13,8,5,,,
"Sep 25, 2023 5:00 PM",271,63,208,94,58,36,156,87,69,100,56,44,14,5,9,22,51,31,20,240,120,119,29,0,82,71,11,65,9,6,,,7,6,1,,,
"Sep 25, 2023 6:00 PM",221,54,167,103,69,34,184,129,55,113,74,39,23,2,21,34,42,37,5,215,107,108,34,0,121,100,21,47,5,7,,,8,5,3,,,
"Sep 25, 2023 7:00 PM",117,33,84,75,40,35,122,64,58,75,46,29,6,3,3,20,27,16,11,110,55,55,15,0,60,36,24,34,5,7,,,6,6,0,,,
"Sep 25, 2023 8:00 PM",78,22,56,25,12,13,50,23,27,23,10,13,7,5,2,8,22,13,9,49,24,25,11,0,24,14,10,24,4,1,,,7,2,5,,,
"Sep 25, 2023 9:00 PM",54,11,43,15,11,4,17,8,9,10,5,5,3,0,3,3,11,9,2,30,15,15,7,0,19,8,11,13,2,0,,,2,0,2,,,
"Sep 25, 2023 10:00 PM",43,5,38,4,3,1,3,2,1,1,0,1,2,1,1,3,8,6,2,19,10,9,6,0,4,2,2,5,0,0,,,3,0,3,,,
"Sep 25, 2023 11:00 PM",14,5,9,3,3,0,4,3,1,1,1,0,1,1,0,2,1,1,0,11,5,5,2,0,2,2,0,3,0,0,,,1,1,0,,,
"Sep 26, 2023 12:00 AM",6,1,5,0,0,0,0,0,0,0,0,0,0,0,0,0,2,2,0,5,1,3,1,0,1,0,1,1,0,0,,,1,1,0,,,
"Sep 26, 2023 1:00 AM",5,1,4,0,0,0,0,0,0,0,0,0,0,0,0,0,0,0,0,0,0,0,0,0,0,0,0,2,0,0,,,1,1,0,,,
"Sep 26, 2023 2:00 AM",8,6,2,0,0,0,0,0,0,0,0,0,0,0,0,0,0,0,0,0,0,0,0,0,0,0,0,0,0,0,,,2,1,1,,,
"Sep 26, 2023 3:00 AM",1,0,1,1,0,1,1,0,1,1,0,1,0,0,0,0,0,0,0,2,1,1,0,0,0,0,0,0,0,1,,,0,0,0,,,
"Sep 26, 2023 4:00 AM",4,0,4,0,0,0,0,0,0,0,0,0,0,0,0,0,1,1,0,0,0,0,1,0,1,0,1,0,0,0,,,0,0,0,,,
"Sep 26, 2023 5:00 AM",9,7,2,0,0,0,1,0,1,0,0,0,3,0,3,1,5,5,0,4,2,2,6,0,1,1,0,7,0,0,,,0,0,0,,,
"Sep 26, 2023 6:00 AM",53,33,20,10,2,8,14,2,12,11,2,9,3,2,1,8,18,18,0,16,8,8,17,0,6,2,4,34,1,5,,,4,4,0,,,
"Sep 26, 2023 7:00 AM",134,101,33,44,11,33,62,13,49,41,10,31,8,7,1,13,89,88,1,38,19,19,79,0,29,5,24,109,4,4,,,6,6,0,,,
"Sep 26, 2023 8:00 AM",316,245,71,44,11,33,101,32,69,76,35,41,8,5,3,26,168,162,6,32,16,16,151,0,65,20,45,189,3,5,,,9,9,0,,,
"Sep 26, 2023 9:00 AM",137,117,20,33,10,23,44,18,26,34,23,11,6,4,2,14,80,79,1,16,8,8,57,0,43,7,36,53,2,5,,,4,4,0,,,
"Sep 26, 2023 10:00 AM",78,58,20,22,10,12,29,16,13,17,7,10,11,3,8,5,56,55,1,12,6,6,37,0,17,9,8,22,1,0,,,5,4,1,,,
"Sep 26, 2023 11:00 AM",54,33,21,35,18,17,40,22,18,27,15,12,7,3,4,5,25,24,1,6,3,3,15,0,27,15,12,27,5,1,,,6,4,2,,,
"Sep 26, 2023 12:00 PM",60,30,30,43,19,24,69,26,43,43,18,25,12,4,8,8,30,27,3,26,13,13,22,0,25,11,14,28,7,3,,,7,4,3,,,
"Sep 26, 2023 1:00 PM",72,32,40,37,15,22,60,36,24,42,24,18,14,9,5,12,14,14,0,26,12,12,12,0,22,15,7,27,1,2,,,5,4,1,,,
"Sep 26, 2023 2:00 PM",81,42,39,33,22,11,47,30,17,34,25,9,5,4,1,10,25,18,7,40,20,20,15,0,43,24,19,22,3,3,,,6,3,3,,,
"Sep 26, 2023 3:00 PM",88,25,63,50,27,23,45,30,15,44,27,17,10,5,5,16,34,23,11,39,19,20,19,0,19,12,7,22,7,1,,,4,2,2,,,
"Sep 26, 2023 4:00 PM",158,40,118,35,19,16,44,24,20,29,10,19,10,4,6,18,30,18,12,97,47,49,18,0,18,12,6,38,5,3,,,4,3,1,,,
"Sep 26, 2023 5:00 PM",228,46,182,46,37,9,84,58,26,54,33,21,10,3,7,26,30,23,7,158,77,81,25,0,61,51,10,54,7,6,,,2,2,0,,,
"Sep 26, 2023 6:00 PM",205,47,158,51,40,11,81,67,14,57,43,14,8,2,6,26,43,29,14,164,81,81,28,0,69,59,10,28,2,4,,,8,6,2,,,
"Sep 26, 2023 7:00 PM",117,31,86,21,13,8,46,32,14,23,15,8,4,1,3,15,22,10,12,88,44,43,12,0,30,22,8,14,5,3,,,10,6,4,,,
"Sep 26, 2023 8:00 PM",90,22,68,15,10,5,33,21,12,29,20,9,5,2,3,16,17,14,3,56,28,28,12,0,11,8,3,22,3,3,,,6,5,1,,,
"Sep 26, 2023 9:00 PM",48,9,39,5,4,1,9,6,3,3,1,2,2,1,1,2,14,12,2,39,20,19,13,0,7,4,3,9,4,2,,,3,1,2,,,
"Sep 26, 2023 10:00 PM",41,8,33,7,4,3,10,5,5,7,5,2,2,1,1,1,11,6,5,10,4,6,7,0,4,4,0,7,2,0,,,4,1,3,,,
"Sep 26, 2023 11:00 PM",15,5,10,2,2,0,2,1,1,0,0,0,1,0,1,1,1,0,1,13,6,6,0,0,3,3,0,2,0,0,,,0,0,0,,,
"Sep 27, 2023 12:00 AM",9,2,7,0,0,0,2,1,1,0,0,0,0,0,0,2,2,2,0,2,1,1,1,0,3,2,1,2,0,0,,,0,0,0,,,
"Sep 27, 2023 1:00 AM",6,2,4,0,0,0,0,0,0,0,0,0,0,0,0,0,1,0,1,0,0,0,0,0,0,0,0,1,0,0,,,0,0,0,,,
"Sep 27, 2023 2:00 AM",2,2,0,0,0,0,0,0,0,0,0,0,0,0,0,0,0,0,0,2,1,1,0,0,0,0,0,1,0,0,,,0,0,0,,,
"Sep 27, 2023 3:00 AM",0,0,0,1,0,1,0,0,0,1,0,1,0,0,0,1,0,0,0,2,1,1,0,0,0,0,0,0,0,0,,,1,1,0,,,
"Sep 27, 2023 4:00 AM",4,1,3,0,0,0,1,0,1,0,0,0,0,0,0,0,3,3,0,0,0,0,3,0,1,0,1,0,0,0,,,0,0,0,,,
"Sep 27, 2023 5:00 AM",12,7,5,2,0,2,1,1,0,2,1,1,0,0,0,1,4,4,0,4,2,2,5,0,1,1,0,3,0,0,,,0,0,0,,,
"Sep 27, 2023 6:00 AM",39,25,14,17,9,8,19,8,11,15,9,6,3,3,0,6,13,13,0,9,4,5,11,0,9,3,6,32,0,1,,,1,1,0,,,
"Sep 27, 2023 7:00 AM",106,77,29,47,15,32,56,16,40,48,17,31,1,1,0,7,58,56,2,21,10,11,54,0,20,6,14,76,2,6,,,5,4,1,,,
"Sep 27, 2023 8:00 AM",210,167,43,55,14,41,83,31,52,50,16,34,19,8,11,23,138,136,2,27,13,14,121,0,52,12,40,144,2,4,,,12,9,3,,,
"Sep 27, 2023 9:00 AM",68,57,11,18,4,14,26,9,17,20,11,9,9,8,1,10,44,42,2,12,6,6,27,0,25,10,15,32,2,3,,,5,4,1,,,
"Sep 27, 2023 10:00 AM",40,30,10,5,2,3,8,3,5,5,3,2,2,1,1,3,21,21,0,6,3,3,13,0,6,1,5,2,0,0,,,1,0,1,,,
"Sep 27, 2023 11:00 AM",18,10,8,6,2,4,7,1,6,5,2,3,4,0,4,7,12,11,1,2,1,1,6,0,3,1,2,8,1,0,,,1,1,0,,,
"Sep 27, 2023 12:00 PM",26,10,16,3,2,1,3,3,0,2,1,1,2,0,2,3,8,6,2,5,2,2,4,0,2,1,1,7,1,0,,,1,1,0,,,
"Sep 27, 2023 1:00 PM",48,16,32,6,4,2,7,5,2,6,3,3,4,1,3,7,11,7,4,18,9,9,11,0,4,4,0,8,1,2,,,0,0,0,,,
"Sep 27, 2023 2:00 PM",38,13,25,4,1,3,9,7,2,6,5,1,1,0,1,2,5,3,2,22,11,11,3,0,6,3,3,6,1,1,,,3,1,2,,,
"Sep 27, 2023 3:00 PM",57,19,38,8,4,4,10,6,4,10,7,3,2,1,1,5,10,7,3,26,13,13,4,0,12,9,3,12,1,0,,,5,3,2,,,
"Sep 27, 2023 4:00 PM",75,21,54,9,9,0,19,13,6,16,10,6,6,1,5,7,14,13,1,51,25,26,12,0,11,10,1,21,1,1,,,0,0,0,,,
"Sep 27, 2023 5:00 PM",158,28,130,11,10,1,35,24,11,22,16,6,2,0,2,8,16,13,3,99,50,49,14,0,27,20,7,29,4,2,,,1,1,0,,,
"Sep 27, 2023 6:00 PM",119,26,93,22,20,2,44,35,9,31,22,9,9,2,7,6,14,10,4,96,50,46,10,0,33,27,6,23,3,4,,,6,3,3,,,
"Sep 27, 2023 7:00 PM",64,13,51,14,12,2,20,16,4,16,13,3,2,0,2,1,9,7,2,52,26,26,5,0,18,16,2,7,1,1,,,3,1,2,,,
"Sep 27, 2023 8:00 PM",39,6,33,6,5,1,9,7,2,5,5,0,3,1,2,8,11,9,2,26,12,13,8,0,4,4,0,14,6,0,,,6,5,1,,,
"Sep 27, 2023 9:00 PM",32,12,20,4,4,0,8,8,0,5,5,0,1,1,0,0,9,6,3,24,12,12,5,0,5,4,1,4,2,0,,,6,6,0,,,
"Sep 27, 2023 10:00 PM",29,6,23,5,5,0,3,2,1,3,1,2,0,0,0,0,4,1,3,8,4,4,1,0,1,1,0,3,0,0,,,0,0,0,,,
"Sep 27, 2023 11:00 PM",10,3,7,0,0,0,1,0,1,1,1,0,0,0,0,1,5,3,2,7,3,4,2,0,1,1,0,3,0,0,,,2,0,2,,,
"Sep 28, 2023 12:00 AM",4,0,4,0,0,0,1,0,1,1,0,1,0,0,0,0,2,2,0,3,1,1,2,0,1,1,0,2,0,0,,,2,2,0,,,
"Sep 28, 2023 1:00 AM",2,2,0,0,0,0,1,0,1,0,0,0,0,0,0,0,0,0,0,2,1,1,0,0,0,0,0,1,1,0,,,1,0,1,,,
"Sep 28, 2023 2:00 AM",3,2,1,0,0,0,0,0,0,0,0,0,0,0,0,0,0,0,0,0,0,0,0,0,0,0,0,0,0,0,,,0,0,0,,,
"Sep 28, 2023 3:00 AM",1,0,1,0,0,0,0,0,0,0,0,0,0,0,0,0,0,0,0,0,0,0,0,0,0,0,0,0,0,0,,,0,0,0,,,
"Sep 28, 2023 4:00 AM",2,1,1,0,0,0,0,0,0,0,0,0,0,0,0,0,1,1,0,0,0,0,1,0,0,0,0,0,0,0,,,0,0,0,,,
"Sep 28, 2023 5:00 AM",8,4,4,2,0,2,3,0,3,1,0,1,0,0,0,1,4,4,0,4,2,2,4,0,2,1,1,5,0,0,,,0,0,0,,,
"Sep 28, 2023 6:00 AM",48,32,16,12,3,9,16,5,11,12,4,8,3,1,2,4,18,18,0,8,4,4,13,0,4,0,4,33,0,3,,,1,1,0,,,
"Sep 28, 2023 7:00 AM",131,99,32,32,11,21,50,14,36,36,12,24,2,1,1,18,60,59,1,37,18,18,63,0,28,11,17,102,8,3,,,7,7,0,,,
"Sep 28, 2023 8:00 AM",286,233,53,78,21,57,124,42,82,84,34,50,19,8,11,29,188,178,10,48,24,24,159,0,83,22,61,234,1,13,,,8,6,2,,,
"Sep 28, 2023 9:00 AM",163,135,28,48,21,27,62,21,41,44,20,24,15,13,2,19,100,99,1,21,10,10,73,0,51,14,37,68,1,6,,,4,2,2,,,
"Sep 28, 2023 10:00 AM",72,45,27,40,11,29,41,22,19,31,17,14,13,6,7,10,45,44,1,29,15,14,28,0,30,16,14,16,5,0,,,1,1,0,,,
"Sep 28, 2023 11:00 AM",48,27,21,33,20,13,37,18,19,27,15,12,7,4,3,4,24,23,1,11,5,5,18,0,23,10,13,22,3,1,,,4,3,1,,,
"Sep 28, 2023 12:00 PM",58,31,27,42,23,19,34,17,17,34,18,16,12,6,6,8,22,19,3,15,7,8,14,0,17,9,8,22,3,1,,,2,1,1,,,
"Sep 28, 2023 1:00 PM",94,49,45,53,30,23,61,27,34,49,24,25,12,2,10,22,22,21,1,30,15,15,16,0,28,19,9,12,5,1,,,7,5,2,,,
"Sep 28, 2023 2:00 PM",55,23,32,25,14,11,35,15,20,22,8,14,9,6,3,21,21,16,5,53,26,27,12,0,24,13,11,25,3,1,,,8,4,4,,,
"Sep 28, 2023 3:00 PM",122,40,82,35,21,14,39,25,14,38,26,12,11,4,7,26,33,27,6,64,32,32,18,0,27,16,11,26,4,1,,,4,2,2,,,
"Sep 28, 2023 4:00 PM",141,41,100,51,30,21,54,33,21,46,22,24,31,9,22,29,26,22,4,119,58,58,19,0,53,36,17,39,9,2,,,9,5,4,,,
"Sep 28, 2023 5:00 PM",227,54,173,68,51,17,96,65,31,73,50,23,18,2,16,32,46,34,12,216,108,108,35,0,78,60,18,49,10,5,,,5,4,1,,,
"Sep 28, 2023 6:00 PM",217,49,168,51,41,10,77,65,12,55,39,16,11,3,8,21,38,34,4,173,86,86,34,0,68,52,16,40,6,7,,,6,5,1,,,
"Sep 28, 2023 7:00 PM",120,29,91,33,20,13,38,25,13,37,22,15,7,1,6,22,28,17,11,63,31,32,15,0,22,17,5,20,3,3,,,5,3,2,,,
"Sep 28, 2023 8:00 PM",83,33,50,17,11,6,21,14,7,14,6,8,4,3,1,6,11,7,4,38,18,20,6,0,12,10,2,18,6,3,,,4,2,2,,,
"Sep 28, 2023 9:00 PM",57,16,41,13,11,2,9,5,4,12,7,5,2,0,2,8,10,7,3,28,15,13,6,0,3,2,1,13,2,1,,,1,0,1,,,
"Sep 28, 2023 10:00 PM",38,7,31,7,6,1,7,4,3,7,5,2,1,0,1,5,10,8,2,28,14,14,6,0,7,6,1,4,1,0,,,0,0,0,,,
"Sep 28, 2023 11:00 PM",21,2,19,2,1,1,7,4,3,4,1,3,2,2,0,3,2,2,0,13,6,6,3,0,5,5,0,5,0,0,,,0,0,0,,,
"Sep 29, 2023 12:00 AM",7,0,7,0,0,0,0,0,0,0,0,0,0,0,0,0,3,2,1,4,2,2,2,0,1,0,1,2,0,0,,,0,0,0,,,
"Sep 29, 2023 1:00 AM",7,1,6,0,0,0,1,0,1,0,0,0,0,0,0,1,1,1,0,2,1,1,0,0,0,0,0,4,0,2,,,0,0,0,,,
"Sep 29, 2023 2:00 AM",6,4,2,0,0,0,1,1,0,1,1,0,0,0,0,0,2,2,0,2,1,1,2,0,1,1,0,0,0,0,,,0,0,0,,,
"Sep 29, 2023 3:00 AM",2,0,2,0,0,0,1,0,1,0,0,0,0,0,0,0,0,0,0,0,0,0,0,0,0,0,0,2,0,0,,,0,0,0,,,
"Sep 29, 2023 4:00 AM",4,1,3,0,0,0,0,0,0,0,0,0,0,0,0,0,1,1,0,1,0,0,1,0,0,0,0,1,0,0,,,0,0,0,,,
"Sep 29, 2023 5:00 AM",10,4,6,2,1,1,5,2,3,5,2,3,0,0,0,0,5,5,0,7,3,3,6,0,1,0,1,9,1,0,,,0,0,0,,,
"Sep 29, 2023 6:00 AM",37,21,16,5,3,2,15,7,8,11,5,6,1,1,0,3,19,19,0,16,8,8,16,0,4,3,1,20,0,3,,,2,2,0,,,
"Sep 29, 2023 7:00 AM",89,65,24,47,25,22,49,21,28,52,26,26,8,8,0,14,61,57,4,20,10,10,54,0,31,15,16,88,2,1,,,8,8,0,,,
"Sep 29, 2023 8:00 AM",222,173,49,58,33,25,130,58,72,98,52,46,22,10,12,23,136,127,9,30,15,15,120,0,70,24,46,122,5,6,,,12,8,4,,,
"Sep 29, 2023 9:00 AM",111,87,24,57,28,29,69,27,42,53,18,35,24,15,9,15,74,72,2,26,13,13,53,0,48,18,30,58,1,4,,,2,2,0,,,
"Sep 29, 2023 10:00 AM",76,54,22,45,27,18,65,39,26,47,30,17,13,9,4,10,44,42,2,25,11,12,29,0,38,20,18,34,1,4,,,5,4,1,,,
"Sep 29, 2023 11:00 AM",57,30,27,50,24,26,58,26,32,37,17,20,10,6,4,13,34,31,3,20,10,10,23,0,30,15,15,25,4,1,,,2,1,1,,,
"Sep 29, 2023 12:00 PM",80,33,47,64,30,34,78,43,35,58,37,21,14,8,6,9,29,27,2,40,20,19,20,0,36,23,13,34,2,3,,,5,3,2,,,
"Sep 29, 2023 1:00 PM",107,43,64,70,37,33,91,59,32,58,35,23,21,6,15,16,28,26,2,42,21,21,21,0,49,23,26,35,3,5,,,2,1,1,,,
"Sep 29, 2023 2:00 PM",86,38,48,60,31,29,69,31,38,54,29,25,20,9,11,19,21,15,6,57,28,29,11,0,53,35,18,33,2,1,,,8,2,6,,,
"Sep 29, 2023 3:00 PM",108,44,64,68,39,29,81,53,28,59,35,24,21,13,8,16,27,24,3,78,41,37,18,0,39,24,15,26,2,3,,,7,5,2,,,
"Sep 29, 2023 4:00 PM",138,48,90,79,48,31,97,52,45,79,47,32,20,6,14,27,33,22,11,90,45,45,19,0,61,44,17,48,6,2,,,7,5,2,,,
"Sep 29, 2023 5:00 PM",185,59,126,76,36,40,107,54,53,88,44,44,24,5,19,24,28,24,4,148,74,74,22,0,73,45,28,51,7,11,,,9,6,3,,,
"Sep 29, 2023 6:00 PM",133,37,96,86,51,35,120,81,39,99,60,39,11,5,6,23,27,23,4,120,59,61,27,0,73,48,25,42,7,4,,,8,3,5,,,
"Sep 29, 2023 7:00 PM",105,27,78,36,18,18,66,38,28,55,31,24,4,0,4,14,17,12,5,25,12,13,9,0,24,15,9,29,6,3,,,6,3,3,,,
"Sep 29, 2023 8:00 PM",59,20,39,17,12,5,25,15,10,20,11,9,6,2,4,13,15,13,2,30,15,15,12,0,7,7,0,19,7,0,,,6,4,2,,,
"Sep 29, 2023 9:00 PM",30,10,20,20,13,7,18,5,13,16,8,8,2,0,2,2,7,6,1,38,19,19,8,0,6,6,0,10,2,1,,,0,0,0,,,
"Sep 29, 2023 10:00 PM",39,10,29,11,7,4,8,4,4,11,5,6,3,1,2,1,10,6,4,11,5,5,7,0,3,1,2,7,3,0,,,3,2,1,,,
"Sep 29, 2023 11:00 PM",16,5,11,11,8,3,14,4,10,7,1,6,2,2,0,4,5,5,0,14,7,7,5,0,2,2,0,4,1,0,,,0,0,0,,,
"Sep 30, 2023 12:00 AM",16,1,15,0,0,0,2,2,0,4,2,2,2,0,2,2,4,4,0,5,3,2,4,0,3,3,0,2,0,1,,,0,0,0,,,
"Sep 30, 2023 1:00 AM",8,0,8,1,1,0,2,1,1,1,1,0,0,0,0,3,3,3,0,6,3,3,2,0,0,0,0,3,0,0,,,0,0,0,,,
"Sep 30, 2023 2:00 AM",6,4,2,1,1,0,2,1,1,1,0,1,1,0,1,0,0,0,0,6,3,3,0,0,1,1,0,2,1,0,,,0,0,0,,,
"Sep 30, 2023 3:00 AM",3,0,3,2,2,0,2,2,0,1,1,0,1,1,0,0,0,0,0,2,1,1,0,0,1,1,0,3,0,1,,,0,0,0,,,
"Sep 30, 2023 4:00 AM",1,0,1,1,0,1,1,0,1,1,0,1,0,0,0,1,1,1,0,0,0,0,0,0,0,0,0,0,0,0,,,0,0,0,,,
"Sep 30, 2023 5:00 AM",2,0,2,3,2,1,4,1,3,4,2,2,2,2,0,3,1,1,0,4,2,2,1,0,0,0,0,4,0,0,,,0,0,0,,,
"Sep 30, 2023 6:00 AM",8,5,3,7,3,4,4,3,1,2,1,1,1,0,1,3,0,0,0,6,3,3,1,0,1,1,0,7,0,0,,,1,1,0,,,
"Sep 30, 2023 7:00 AM",25,14,11,24,17,7,14,11,3,18,15,3,2,2,0,4,6,6,0,11,5,5,6,0,7,4,3,17,0,3,,,2,0,2,,,
"Sep 30, 2023 8:00 AM",23,14,9,39,24,15,33,23,10,26,18,8,11,5,6,3,6,6,0,4,2,2,6,0,14,10,4,16,3,1,,,4,2,2,,,
"Sep 30, 2023 9:00 AM",29,16,13,45,19,26,42,22,20,34,19,15,8,1,7,5,8,8,0,6,3,3,8,0,19,10,9,17,3,2,,,2,2,0,,,
"Sep 30, 2023 10:00 AM",44,23,21,32,12,20,36,16,20,30,19,11,9,7,2,8,15,14,1,6,3,3,12,0,20,11,9,13,3,1,,,5,4,1,,,
"Sep 30, 2023 11:00 AM",31,16,15,14,6,8,20,13,7,12,6,6,14,8,6,9,6,6,0,16,8,8,6,0,13,8,5,12,5,1,,,6,5,1,,,
"Sep 30, 2023 12:00 PM",29,20,9,16,9,7,21,8,13,10,8,2,10,8,2,8,7,5,2,4,2,2,6,0,8,5,3,8,0,0,,,1,1,0,,,
"Sep 30, 2023 1:00 PM",28,16,12,14,7,7,12,7,5,6,5,1,3,0,3,7,6,5,1,8,4,4,4,0,5,3,2,7,2,0,,,0,0,0,,,
"Sep 30, 2023 2:00 PM",21,11,10,3,3,0,8,4,4,12,4,8,7,4,3,7,6,4,2,4,2,2,4,0,6,4,2,13,0,2,,,0,0,0,,,
"Sep 30, 2023 3:00 PM",21,4,17,3,2,1,11,5,6,8,4,4,2,1,1,9,11,11,0,8,4,4,9,0,6,4,2,8,1,1,,,2,1,1,,,
"Sep 30, 2023 4:00 PM",25,11,14,15,9,6,18,10,8,18,11,7,7,2,5,11,9,8,1,10,5,5,5,0,10,6,4,9,0,0,,,0,0,0,,,
"Sep 30, 2023 5:00 PM",33,17,16,18,11,7,15,11,4,16,10,6,3,2,1,12,5,4,1,21,10,11,3,0,11,8,3,17,1,3,,,5,3,2,,,
"Sep 30, 2023 6:00 PM",27,15,12,19,11,8,28,13,15,20,10,10,5,2,3,8,9,6,3,18,9,9,3,0,13,8,5,5,0,0,,,3,2,1,,,
"Sep 30, 2023 7:00 PM",33,20,13,11,7,4,11,5,6,6,2,4,4,3,1,7,7,6,1,6,3,3,6,0,7,4,3,13,0,0,,,1,1,0,,,
"Sep 30, 2023 8:00 PM",23,8,15,9,5,4,11,7,4,11,6,5,1,1,0,3,5,5,0,6,3,3,6,0,5,3,2,9,1,1,,,3,2,1,,,
"Sep 30, 2023 9:00 PM",20,13,7,4,3,1,6,3,3,5,3,2,2,1,1,3,4,4,0,6,3,3,3,0,4,3,1,4,0,0,,,1,0,1,,,
"Sep 30, 2023 10:00 PM",10,5,5,2,0,2,2,1,1,2,0,2,0,0,0,0,2,2,0,7,3,3,3,0,2,1,1,6,0,0,,,2,2,0,,,
"Sep 30, 2023 11:00 PM",12,5,7,0,0,0,7,4,3,2,0,2,2,1,1,4,2,2,0,3,1,1,2,0,1,1,0,7,0,0,,,1,1,0,,,
