Time,Clonskeagh Totem,Clonskeagh Totem IN,Clonskeagh Totem OUT,Dun Laogaire @ Seapoint Beach Cyclist,Dun Laogaire @ Seapoint Beach Cyclists IN,Dun Laogaire @ Seapoint Beach Cyclists OUT,Dun Laoghaire @ Peoples Park Cyclist,Dun Laoghaire @ Peoples Park Cyclists IN,Dun Laoghaire @ Peoples Park Cyclists OUT,Dun Laoghaire @ York Road Cyclist,Dun Laoghaire @ York Road Cyclists IN,Dun Laoghaire @ York Road Cyclists OUT,Glenageary Cyclist,Glenageary Bikes IN,Glenageary Bikes OUT,Grange Road Totem,N11 Before UCD,N11 Before UCD Cyclist IN,N11 Before UCD Cyclist OUT,N11 Outbound (Montrose),N11 Outbound (Montrose) OUT-Away From City Centre,N11 Outbound (Montrose) IN- Towards City Centre,N11 Totem Inbound,Rock Road Bus Lane,Rock Road Park,Rock Road Park IN,Rock Road Park OUT,Rock Road Totem Inbound,Wyattville Rd - Bicycles From N11,Wyattville Rd - Bicycles Towards N11,Wyattville Rd At Park Gates Cyclist,Wyattville Rd At Park Gates Bikes IN,Wyattville Rd At Park Gates Bikes OUT,Wyattville Road At Steps Cyclist,Wyattville Road At Steps Bikes IN,Wyattville Road At Steps Bikes OUT
"Jan 1, 2019 12:00 AM",1,1,0,,,,,,,,,,2,0,2,4,,,,1,1,0,1,1,1,0,1,13,0,0,2,0,2,0,0,0
"Jan 1, 2019 1:00 AM",4,2,2,,,,,,,,,,2,1,1,3,,,,2,2,0,0,4,3,2,1,2,0,0,0,0,0,0,0,0
"Jan 1, 2019 2:00 AM",4,1,3,,,,,,,,,,0,0,0,3,,,,5,3,2,4,4,3,1,2,2,0,1,1,1,0,0,0,0
"Jan 1, 2019 3:00 AM",6,0,6,,,,,,,,,,1,0,1,2,,,,1,1,0,3,2,0,0,0,2,0,1,0,0,0,0,0,0
"Jan 1, 2019 4:00 AM",6,2,4,,,,,,,,,,0,0,0,0,,,,1,1,0,0,5,2,2,0,1,1,2,0,0,0,0,0,0
"Jan 1, 2019 5:00 AM",4,2,2,,,,,,,,,,0,0,0,3,,,,0,0,0,1,1,1,0,1,2,0,0,0,0,0,0,0,0
"Jan 1, 2019 6:00 AM",4,3,1,,,,,,,,,,0,0,0,0,,,,1,1,0,4,3,1,0,1,5,0,0,0,0,0,0,0,0
"Jan 1, 2019 7:00 AM",7,2,5,,,,,,,,,,0,0,0,0,,,,1,1,0,1,6,1,1,0,6,1,0,0,0,0,0,0,0
"Jan 1, 2019 8:00 AM",10,5,5,,,,,,,,,,0,0,0,2,,,,4,3,1,2,3,0,0,0,12,0,0,0,0,0,0,0,0
"Jan 1, 2019 9:00 AM",7,4,3,,,,,,,,,,5,2,3,1,,,,5,5,0,4,6,6,0,6,3,1,5,0,0,0,0,0,0
"Jan 1, 2019 10:00 AM",14,5,9,,,,,,,,,,3,0,3,5,,,,10,8,2,4,17,10,2,8,19,3,2,2,0,2,1,1,0
"Jan 1, 2019 11:00 AM",13,7,6,,,,,,,,,,12,4,8,6,,,,4,4,0,6,3,19,6,13,19,3,9,0,0,0,0,0,0
"Jan 1, 2019 12:00 PM",27,15,12,,,,,,,,,,10,6,4,11,,,,9,9,0,5,14,14,4,10,16,4,3,4,2,2,2,0,2
"Jan 1, 2019 1:00 PM",25,11,14,,,,,,,,,,19,13,6,4,,,,10,10,0,9,15,16,5,11,16,4,0,2,0,2,0,0,0
"Jan 1, 2019 2:00 PM",18,11,7,,,,,,,,,,16,7,9,3,,,,8,7,1,13,10,14,11,3,12,6,0,2,1,1,1,0,1
"Jan 1, 2019 3:00 PM",14,7,7,,,,,,,,,,9,3,6,6,,,,4,3,1,5,7,17,6,11,7,1,1,0,0,0,0,0,0
"Jan 1, 2019 4:00 PM",24,12,12,,,,,,,,,,7,4,3,8,,,,5,5,0,2,9,12,7,5,7,0,2,2,0,2,0,0,0
"Jan 1, 2019 5:00 PM",15,6,9,,,,,,,,,,8,5,3,4,,,,3,2,1,3,7,3,3,0,4,0,1,1,0,1,0,0,0
"Jan 1, 2019 6:00 PM",10,3,7,,,,,,,,,,0,0,0,13,,,,4,3,1,3,5,0,0,0,5,0,0,3,1,2,5,3,2
"Jan 1, 2019 7:00 PM",17,8,9,,,,,,,,,,0,0,0,3,,,,7,5,2,5,6,5,2,3,6,0,0,0,0,0,0,0,0
"Jan 1, 2019 8:00 PM",15,6,9,,,,,,,,,,3,2,1,1,,,,5,5,0,3,4,5,0,5,4,1,0,0,0,0,0,0,0
"Jan 1, 2019 9:00 PM",8,4,4,,,,,,,,,,2,2,0,3,,,,0,0,0,2,2,1,0,1,5,0,0,0,0,0,0,0,0
"Jan 1, 2019 10:00 PM",3,1,2,,,,,,,,,,0,0,0,1,,,,6,5,1,2,3,2,1,1,1,0,1,0,0,0,0,0,0
"Jan 1, 2019 11:00 PM",4,3,1,,,,,,,,,,4,2,2,1,,,,1,1,0,1,1,0,0,0,1,0,0,0,0,0,0,0,0
"Jan 2, 2019 12:00 AM",0,0,0,,,,,,,,,,0,0,0,0,,,,0,0,0,1,2,0,0,0,1,1,0,1,1,0,1,0,1
"Jan 2, 2019 1:00 AM",1,1,0,,,,,,,,,,0,0,0,0,,,,1,1,0,0,0,0,0,0,1,0,2,0,0,0,0,0,0
"Jan 2, 2019 2:00 AM",1,1,0,,,,,,,,,,0,0,0,0,,,,0,0,0,0,1,0,0,0,0,0,0,0,0,0,0,0,0
"Jan 2, 2019 3:00 AM",0,0,0,,,,,,,,,,0,0,0,0,,,,0,0,0,0,1,0,0,0,0,0,0,0,0,0,0,0,0
"Jan 2, 2019 4:00 AM",3,1,2,,,,,,,,,,0,0,0,0,,,,1,1,0,0,0,0,0,0,2,0,0,0,0,0,0,0,0
"Jan 2, 2019 5:00 AM",3,2,1,,,,,,,,,,1,0,1,2,,,,1,1,0,3,1,0,0,0,2,3,0,0,0,0,0,0,0
"Jan 2, 2019 6:00 AM",36,28,8,,,,,,,,,,0,0,0,5,,,,4,3,1,17,4,4,3,1,31,0,0,1,0,1,0,0,0
"Jan 2, 2019 7:00 AM",94,72,22,,,,,,,,,,7,1,6,6,,,,15,12,3,58,25,12,8,4,73,0,4,3,3,0,0,0,0
"Jan 2, 2019 8:00 AM",198,161,37,,,,,,,,,,11,0,11,13,,,,29,18,11,132,37,56,44,12,166,1,6,0,0,0,0,0,0
"Jan 2, 2019 9:00 AM",65,55,10,,,,,,,,,,16,7,9,2,,,,15,7,8,38,20,30,23,7,62,2,0,6,3,3,1,0,1
"Jan 2, 2019 10:00 AM",35,23,12,,,,,,,,,,3,2,1,4,,,,10,9,1,16,11,7,6,1,22,4,1,3,0,3,0,0,0
"Jan 2, 2019 11:00 AM",24,14,10,,,,,,,,,,9,1,8,5,,,,4,2,2,13,13,9,3,6,19,2,4,1,1,0,1,1,0
"Jan 2, 2019 12:00 PM",25,9,16,,,,,,,,,,13,9,4,17,,,,11,6,5,11,13,10,3,7,18,4,2,1,1,0,2,0,2
"Jan 2, 2019 1:00 PM",45,21,24,,,,,,,,,,12,7,5,16,,,,17,11,6,14,7,18,6,12,16,7,1,2,1,1,0,0,0
"Jan 2, 2019 2:00 PM",41,20,21,,,,,,,,,,16,6,10,7,,,,8,8,0,15,14,22,12,10,14,1,4,1,1,0,1,0,1
"Jan 2, 2019 3:00 PM",50,18,32,,,,,,,,,,16,7,9,16,,,,13,12,1,12,21,20,5,15,14,4,3,4,4,0,1,1,0
"Jan 2, 2019 4:00 PM",87,19,68,,,,,,,,,,12,9,3,23,,,,43,42,1,12,40,34,8,26,33,4,1,3,2,1,0,0,0
"Jan 2, 2019 5:00 PM",196,38,158,,,,,,,,,,11,8,3,25,,,,88,87,1,14,101,58,14,44,43,9,0,2,1,1,0,0,0
"Jan 2, 2019 6:00 PM",154,29,125,,,,,,,,,,15,11,4,13,,,,86,84,2,18,99,43,2,41,29,2,0,1,0,1,0,0,0
"Jan 2, 2019 7:00 PM",56,10,46,,,,,,,,,,4,3,1,11,,,,25,24,1,12,38,14,0,14,13,1,3,3,2,1,0,0,0
"Jan 2, 2019 8:00 PM",25,5,20,,,,,,,,,,1,1,0,12,,,,13,13,0,7,15,8,3,5,9,1,1,0,0,0,0,0,0
"Jan 2, 2019 9:00 PM",22,7,15,,,,,,,,,,4,3,1,3,,,,8,8,0,5,9,9,6,3,8,0,0,0,0,0,2,2,0
"Jan 2, 2019 10:00 PM",12,5,7,,,,,,,,,,2,0,2,4,,,,10,8,2,3,6,2,2,0,7,0,0,2,0,2,0,0,0
"Jan 2, 2019 11:00 PM",7,2,5,,,,,,,,,,2,2,0,3,,,,5,5,0,2,5,2,2,0,3,1,2,1,1,0,0,0,0
"Jan 3, 2019 12:00 AM",2,1,1,,,,,,,,,,1,1,0,1,,,,1,1,0,1,1,1,0,1,4,0,0,0,0,0,0,0,0
"Jan 3, 2019 1:00 AM",1,0,1,,,,,,,,,,0,0,0,1,,,,2,2,0,0,1,0,0,0,0,1,0,0,0,0,0,0,0
"Jan 3, 2019 2:00 AM",1,0,1,,,,,,,,,,0,0,0,0,,,,0,0,0,1,0,0,0,0,0,1,0,0,0,0,0,0,0
"Jan 3, 2019 3:00 AM",2,1,1,,,,,,,,,,0,0,0,0,,,,0,0,0,0,0,1,1,0,2,0,0,0,0,0,0,0,0
"Jan 3, 2019 4:00 AM",0,0,0,,,,,,,,,,0,0,0,0,,,,2,2,0,0,1,0,0,0,2,0,0,0,0,0,0,0,0
"Jan 3, 2019 5:00 AM",7,5,2,,,,,,,,,,1,0,1,2,,,,1,1,0,5,2,0,0,0,5,0,0,0,0,0,0,0,0
"Jan 3, 2019 6:00 AM",37,30,7,,,,,,,,,,2,0,2,4,,,,4,2,2,11,7,4,3,1,36,2,1,1,0,1,0,0,0
"Jan 3, 2019 7:00 AM",124,88,36,,,,,,,,,,11,1,10,11,,,,15,13,2,60,24,17,12,5,95,0,3,1,1,0,0,0,0
"Jan 3, 2019 8:00 AM",235,195,40,,,,,,,,,,7,2,5,19,,,,27,18,9,154,43,60,48,12,206,2,2,2,1,1,0,0,0
"Jan 3, 2019 9:00 AM",90,73,17,,,,,,,,,,16,5,11,3,,,,18,14,4,53,19,41,26,15,74,0,4,4,2,2,2,1,1
"Jan 3, 2019 10:00 AM",31,24,7,,,,,,,,,,15,6,9,8,,,,12,8,4,26,7,17,10,7,20,1,1,3,2,1,1,0,1
"Jan 3, 2019 11:00 AM",29,16,13,,,,,,,,,,10,3,7,4,,,,6,5,1,15,5,7,3,4,24,2,7,6,3,3,0,0,0
"Jan 3, 2019 12:00 PM",25,12,13,,,,,,,,,,16,8,8,11,,,,6,4,2,15,9,19,7,12,18,6,3,1,1,0,2,0,2
"Jan 3, 2019 1:00 PM",52,25,27,,,,,,,,,,15,4,11,16,,,,18,15,3,12,26,14,6,8,21,3,0,0,0,0,1,1,0
"Jan 3, 2019 2:00 PM",36,19,17,,,,,,,,,,5,2,3,7,,,,16,12,4,8,12,18,3,15,12,1,3,0,0,0,0,0,0
"Jan 3, 2019 3:00 PM",55,24,31,,,,,,,,,,23,13,10,29,,,,22,22,0,10,15,27,9,18,18,2,5,4,4,0,1,1,0
"Jan 3, 2019 4:00 PM",100,23,77,,,,,,,,,,22,17,5,18,,,,42,41,1,18,50,34,5,29,26,2,0,7,5,2,0,0,0
"Jan 3, 2019 5:00 PM",218,45,173,,,,,,,,,,14,11,3,17,,,,123,119,4,24,129,38,5,33,42,5,2,1,1,0,1,0,1
"Jan 3, 2019 6:00 PM",168,32,136,,,,,,,,,,10,9,1,20,,,,94,92,2,21,122,66,5,61,41,3,0,4,1,3,0,0,0
"Jan 3, 2019 7:00 PM",70,15,55,,,,,,,,,,1,0,1,8,,,,31,30,1,8,35,16,1,15,15,3,2,2,0,2,1,1,0
"Jan 3, 2019 8:00 PM",35,13,22,,,,,,,,,,2,2,0,7,,,,15,15,0,6,23,2,0,2,11,1,2,0,0,0,1,1,0
"Jan 3, 2019 9:00 PM",30,8,22,,,,,,,,,,0,0,0,2,,,,12,12,0,7,10,1,0,1,10,1,3,0,0,0,2,0,2
"Jan 3, 2019 10:00 PM",19,4,15,,,,,,,,,,2,1,1,4,,,,11,9,2,3,7,2,1,1,11,0,0,1,0,1,0,0,0
"Jan 3, 2019 11:00 PM",8,2,6,,,,,,,,,,1,0,1,1,,,,8,7,1,2,5,1,0,1,2,0,0,0,0,0,0,0,0
"Jan 4, 2019 12:00 AM",8,2,6,,,,,,,,,,0,0,0,3,,,,0,0,0,2,2,1,0,1,1,0,0,0,0,0,0,0,0
"Jan 4, 2019 1:00 AM",1,0,1,,,,,,,,,,0,0,0,0,,,,5,5,0,1,3,0,0,0,0,0,0,0,0,0,0,0,0
"Jan 4, 2019 2:00 AM",0,0,0,,,,,,,,,,0,0,0,0,,,,2,2,0,0,2,0,0,0,0,0,0,0,0,0,0,0,0
"Jan 4, 2019 3:00 AM",1,1,0,,,,,,,,,,0,0,0,0,,,,0,0,0,0,1,0,0,0,0,0,0,0,0,0,0,0,0
"Jan 4, 2019 4:00 AM",1,1,0,,,,,,,,,,0,0,0,0,,,,0,0,0,0,0,0,0,0,3,0,0,0,0,0,0,0,0
"Jan 4, 2019 5:00 AM",5,5,0,,,,,,,,,,0,0,0,1,,,,2,1,1,3,1,0,0,0,7,2,1,0,0,0,0,0,0
"Jan 4, 2019 6:00 AM",32,26,6,,,,,,,,,,1,0,1,8,,,,8,7,1,13,6,1,0,1,34,3,0,1,0,1,0,0,0
"Jan 4, 2019 7:00 AM",93,76,17,,,,,,,,,,5,1,4,13,,,,11,9,2,64,25,14,11,3,99,0,4,0,0,0,2,0,2
"Jan 4, 2019 8:00 AM",193,159,34,,,,,,,,,,9,1,8,10,,,,20,14,6,118,41,46,40,6,181,3,1,2,1,1,0,0,0
"Jan 4, 2019 9:00 AM",92,73,19,,,,,,,,,,12,4,8,3,,,,22,18,4,57,24,35,23,12,80,2,2,6,5,1,0,0,0
"Jan 4, 2019 10:00 AM",34,29,5,,,,,,,,,,5,0,5,8,,,,7,4,3,27,12,5,3,2,21,3,3,2,1,1,0,0,0
"Jan 4, 2019 11:00 AM",30,23,7,,,,,,,,,,7,4,3,3,,,,12,11,1,22,14,10,5,5,22,2,1,0,0,0,0,0,0
"Jan 4, 2019 12:00 PM",27,10,17,,,,,,,,,,4,2,2,3,,,,13,11,2,15,12,8,4,4,10,3,5,5,5,0,2,0,2
"Jan 4, 2019 1:00 PM",55,28,27,,,,,,,,,,11,8,3,16,,,,14,12,2,17,20,23,3,20,16,4,3,1,1,0,1,1,0
"Jan 4, 2019 2:00 PM",38,16,22,,,,,,,,,,15,9,6,11,,,,15,14,1,12,16,25,10,15,15,2,3,1,1,0,0,0,0
"Jan 4, 2019 3:00 PM",63,15,48,,,,,,,,,,8,2,6,14,,,,10,10,0,13,28,19,6,13,14,5,4,12,7,5,3,3,0
"Jan 4, 2019 4:00 PM",99,22,77,,,,,,,,,,17,10,7,8,,,,49,48,1,13,55,20,4,16,32,8,3,11,9,2,8,4,4
"Jan 4, 2019 5:00 PM",182,32,150,,,,,,,,,,7,4,3,14,,,,109,108,1,28,118,49,6,43,44,8,2,3,1,2,1,0,1
"Jan 4, 2019 6:00 PM",149,28,121,,,,,,,,,,19,14,5,7,,,,68,68,0,11,100,40,1,39,27,2,2,3,1,2,1,0,1
"Jan 4, 2019 7:00 PM",53,16,37,,,,,,,,,,2,2,0,9,,,,22,22,0,11,38,15,3,12,15,2,2,1,0,1,1,0,1
"Jan 4, 2019 8:00 PM",29,10,19,,,,,,,,,,2,0,2,2,,,,8,8,0,3,16,4,2,2,11,1,1,0,0,0,0,0,0
"Jan 4, 2019 9:00 PM",28,6,22,,,,,,,,,,2,1,1,5,,,,6,6,0,4,10,4,0,4,9,1,0,1,1,0,1,1,0
"Jan 4, 2019 10:00 PM",14,4,10,,,,,,,,,,0,0,0,3,,,,5,4,1,4,7,1,0,1,9,0,1,2,1,1,0,0,0
"Jan 4, 2019 11:00 PM",10,3,7,,,,,,,,,,2,2,0,3,,,,2,2,0,2,4,5,2,3,3,0,0,0,0,0,0,0,0
"Jan 5, 2019 12:00 AM",8,2,6,,,,,,,,,,3,1,2,2,,,,4,4,0,2,2,1,0,1,1,1,0,0,0,0,0,0,0
"Jan 5, 2019 1:00 AM",4,0,4,,,,,,,,,,2,1,1,1,,,,1,1,0,1,3,0,0,0,0,0,0,0,0,0,0,0,0
"Jan 5, 2019 2:00 AM",3,1,2,,,,,,,,,,0,0,0,0,,,,2,2,0,1,4,0,0,0,2,0,2,0,0,0,0,0,0
"Jan 5, 2019 3:00 AM",3,2,1,,,,,,,,,,0,0,0,0,,,,4,4,0,0,2,0,0,0,3,0,0,0,0,0,0,0,0
"Jan 5, 2019 4:00 AM",2,0,2,,,,,,,,,,0,0,0,0,,,,0,0,0,0,1,0,0,0,0,0,0,0,0,0,0,0,0
"Jan 5, 2019 5:00 AM",2,2,0,,,,,,,,,,0,0,0,0,,,,1,1,0,1,1,0,0,0,2,0,0,0,0,0,0,0,0
"Jan 5, 2019 6:00 AM",13,8,5,,,,,,,,,,0,0,0,2,,,,2,2,0,2,1,1,0,1,6,1,0,1,1,0,1,0,1
"Jan 5, 2019 7:00 AM",12,6,6,,,,,,,,,,3,2,1,1,,,,5,5,0,4,7,2,1,1,8,1,1,1,0,1,0,0,0
"Jan 5, 2019 8:00 AM",19,9,10,,,,,,,,,,5,0,5,2,,,,4,4,0,10,7,1,0,1,17,0,0,1,1,0,0,0,0
"Jan 5, 2019 9:00 AM",33,19,14,,,,,,,,,,3,2,1,5,,,,9,8,1,6,10,7,3,4,20,2,2,0,0,0,1,0,1
"Jan 5, 2019 10:00 AM",27,16,11,,,,,,,,,,14,9,5,4,,,,9,7,2,17,24,21,11,10,21,4,8,3,0,3,0,0,0
"Jan 5, 2019 11:00 AM",39,26,13,,,,,,,,,,15,6,9,12,,,,11,10,1,17,15,16,2,14,20,0,3,0,0,0,1,1,0
"Jan 5, 2019 12:00 PM",30,20,10,,,,,,,,,,28,13,15,9,,,,12,7,5,14,22,26,8,18,23,4,6,7,6,1,0,0,0
"Jan 5, 2019 1:00 PM",40,17,23,,,,,,,,,,22,9,13,10,,,,15,13,2,16,21,25,14,11,19,2,1,3,1,2,1,0,1
"Jan 5, 2019 2:00 PM",43,21,22,,,,,,,,,,24,11,13,12,,,,11,9,2,16,17,11,2,9,29,2,3,3,3,0,1,0,1
"Jan 5, 2019 3:00 PM",39,18,21,,,,,,,,,,32,15,17,16,,,,4,4,0,21,13,27,11,16,24,2,1,2,2,0,0,0,0
"Jan 5, 2019 4:00 PM",41,23,18,,,,,,,,,,17,11,6,14,,,,13,11,2,7,12,21,10,11,21,0,3,3,2,1,0,0,0
"Jan 5, 2019 5:00 PM",28,11,17,,,,,,,,,,8,4,4,4,,,,18,18,0,10,10,20,10,10,10,0,2,4,2,2,6,3,3
"Jan 5, 2019 6:00 PM",29,17,12,,,,,,,,,,8,7,1,11,,,,12,10,2,5,15,6,2,4,15,0,0,1,0,1,0,0,0
"Jan 5, 2019 7:00 PM",20,4,16,,,,,,,,,,7,7,0,5,,,,4,4,0,7,7,10,1,9,13,1,0,3,2,1,1,0,1
"Jan 5, 2019 8:00 PM",21,6,15,,,,,,,,,,5,2,3,2,,,,3,3,0,10,4,0,0,0,3,2,0,3,2,1,1,1,0
"Jan 5, 2019 9:00 PM",21,9,12,,,,,,,,,,2,1,1,0,,,,2,2,0,2,3,4,1,3,8,0,0,1,0,1,0,0,0
"Jan 5, 2019 10:00 PM",10,4,6,,,,,,,,,,0,0,0,5,,,,7,7,0,1,5,6,2,4,2,0,0,0,0,0,0,0,0
"Jan 5, 2019 11:00 PM",12,4,8,,,,,,,,,,0,0,0,0,,,,0,0,0,4,2,1,1,0,4,0,0,0,0,0,0,0,0
"Jan 6, 2019 12:00 AM",3,1,2,,,,,,,,,,3,1,2,2,,,,3,2,1,1,3,2,2,0,0,0,0,0,0,0,0,0,0
"Jan 6, 2019 1:00 AM",4,3,1,,,,,,,,,,0,0,0,2,,,,5,5,0,1,2,6,6,0,1,0,1,0,0,0,0,0,0
"Jan 6, 2019 2:00 AM",6,0,6,,,,,,,,,,0,0,0,0,,,,2,1,1,2,0,1,0,1,0,0,1,0,0,0,0,0,0
"Jan 6, 2019 3:00 AM",2,0,2,,,,,,,,,,0,0,0,0,,,,1,1,0,0,2,0,0,0,0,0,0,0,0,0,0,0,0
"Jan 6, 2019 4:00 AM",1,0,1,,,,,,,,,,0,0,0,0,,,,1,1,0,0,2,0,0,0,0,0,0,0,0,0,0,0,0
"Jan 6, 2019 5:00 AM",0,0,0,,,,,,,,,,0,0,0,0,,,,0,0,0,0,1,0,0,0,3,0,0,0,0,0,0,0,0
"Jan 6, 2019 6:00 AM",4,2,2,,,,,,,,,,0,0,0,0,,,,6,6,0,2,4,1,1,0,5,1,0,0,0,0,0,0,0
"Jan 6, 2019 7:00 AM",9,6,3,,,,,,,,,,1,1,0,0,,,,2,2,0,4,8,0,0,0,10,0,1,1,1,0,0,0,0
"Jan 6, 2019 8:00 AM",14,4,10,,,,,,,,,,4,1,3,7,,,,6,5,1,7,7,5,0,5,14,0,1,0,0,0,0,0,0
"Jan 6, 2019 9:00 AM",25,14,11,,,,,,,,,,10,3,7,5,,,,9,9,0,18,11,13,5,8,28,4,13,1,1,0,0,0,0
"Jan 6, 2019 10:00 AM",31,16,15,,,,,,,,,,14,8,6,9,,,,10,7,3,15,14,19,8,11,28,1,3,3,1,2,2,1,1
"Jan 6, 2019 11:00 AM",31,17,14,,,,,,,,,,18,4,14,11,,,,19,15,4,9,32,40,13,27,25,5,8,2,2,0,2,1,1
"Jan 6, 2019 12:00 PM",37,20,17,,,,,,,,,,36,14,22,14,,,,19,16,3,18,31,40,24,16,22,9,7,3,1,2,3,2,1
"Jan 6, 2019 1:00 PM",42,22,20,,,,,,,,,,31,19,12,20,,,,11,10,1,13,35,35,7,28,15,3,1,3,0,3,0,0,0
"Jan 6, 2019 2:00 PM",34,20,14,,,,,,,,,,43,23,20,20,,,,23,15,8,10,15,18,8,10,19,5,3,5,4,1,1,1,0
"Jan 6, 2019 3:00 PM",42,22,20,,,,,,,,,,43,27,16,29,,,,8,6,2,18,12,27,9,18,27,1,5,5,3,2,3,1,2
"Jan 6, 2019 4:00 PM",39,20,19,,,,,,,,,,20,10,10,11,,,,10,8,2,14,17,25,21,4,24,5,1,2,2,0,1,0,1
"Jan 6, 2019 5:00 PM",32,11,21,,,,,,,,,,4,2,2,12,,,,9,8,1,14,12,14,9,5,17,2,0,1,1,0,0,0,0
"Jan 6, 2019 6:00 PM",25,10,15,,,,,,,,,,10,7,3,4,,,,12,12,0,3,16,11,6,5,14,2,0,4,3,1,1,0,1
"Jan 6, 2019 7:00 PM",20,7,13,,,,,,,,,,4,0,4,1,,,,3,3,0,5,10,3,0,3,13,0,0,4,2,2,0,0,0
"Jan 6, 2019 8:00 PM",13,5,8,,,,,,,,,,5,4,1,5,,,,2,1,1,6,5,2,0,2,6,0,0,2,1,1,1,1,0
"Jan 6, 2019 9:00 PM",10,4,6,,,,,,,,,,3,2,1,3,,,,6,4,2,3,3,5,3,2,8,0,1,1,0,1,0,0,0
"Jan 6, 2019 10:00 PM",2,1,1,,,,,,,,,,2,0,2,3,,,,5,4,1,3,1,4,3,1,4,0,2,0,0,0,0,0,0
"Jan 6, 2019 11:00 PM",2,2,0,,,,,,,,,,1,1,0,3,,,,2,2,0,1,3,2,2,0,1,0,0,0,0,0,0,0,0
"Jan 7, 2019 12:00 AM",4,0,4,,,,,,,,,,1,1,0,0,,,,1,1,0,1,3,1,1,0,3,0,1,1,0,1,0,0,0
"Jan 7, 2019 1:00 AM",1,1,0,,,,,,,,,,0,0,0,1,,,,1,1,0,1,1,1,0,1,1,0,0,0,0,0,0,0,0
"Jan 7, 2019 2:00 AM",1,0,1,,,,,,,,,,0,0,0,0,,,,3,3,0,1,1,0,0,0,0,0,0,0,0,0,0,0,0
"Jan 7, 2019 3:00 AM",2,1,1,,,,,,,,,,0,0,0,0,,,,0,0,0,0,1,0,0,0,0,0,0,0,0,0,0,0,0
"Jan 7, 2019 4:00 AM",0,0,0,,,,,,,,,,0,0,0,0,,,,0,0,0,0,0,0,0,0,2,0,0,0,0,0,0,0,0
"Jan 7, 2019 5:00 AM",2,2,0,,,,,,,,,,1,0,1,1,,,,1,1,0,4,2,0,0,0,7,2,1,0,0,0,0,0,0
"Jan 7, 2019 6:00 AM",53,40,13,,,,,,,,,,3,0,3,5,,,,3,2,1,21,11,3,3,0,47,1,1,1,0,1,0,0,0
"Jan 7, 2019 7:00 AM",175,138,37,,,,,,,,,,13,1,12,14,,,,24,19,5,126,32,33,23,10,148,3,2,3,3,0,1,0,1
"Jan 7, 2019 8:00 AM",371,296,75,,,,,,,,,,25,4,21,27,,,,43,31,12,248,61,90,73,17,343,8,6,19,15,4,1,0,1
"Jan 7, 2019 9:00 AM",165,138,27,,,,,,,,,,14,5,9,8,,,,20,11,9,93,35,61,43,18,102,2,2,2,1,1,1,0,1
"Jan 7, 2019 10:00 AM",43,32,11,,,,,,,,,,5,0,5,8,,,,7,5,2,18,13,12,5,7,23,2,0,3,0,3,1,1,0
"Jan 7, 2019 11:00 AM",29,19,10,,,,,,,,,,5,4,1,6,,,,11,10,1,17,11,12,3,9,19,1,0,1,1,0,0,0,0
"Jan 7, 2019 12:00 PM",31,18,13,,,,,,,,,,11,5,6,2,,,,8,8,0,17,13,7,4,3,17,1,0,2,2,0,1,0,1
"Jan 7, 2019 1:00 PM",57,26,31,,,,,,,,,,9,5,4,8,,,,20,19,1,15,15,8,4,4,21,1,0,1,1,0,0,0,0
"Jan 7, 2019 2:00 PM",50,23,27,,,,,,,,,,7,4,3,7,,,,15,12,3,13,16,8,2,6,11,1,4,3,2,1,0,0,0
"Jan 7, 2019 3:00 PM",53,13,40,,,,,,,,,,9,6,3,11,,,,22,18,4,14,20,6,1,5,18,2,3,6,2,4,4,4,0
"Jan 7, 2019 4:00 PM",112,33,79,,,,,,,,,,5,4,1,12,,,,56,54,2,21,61,31,6,25,34,2,3,5,0,5,0,0,0
"Jan 7, 2019 5:00 PM",310,54,256,,,,,,,,,,14,8,6,22,,,,169,164,5,27,135,62,8,54,77,6,1,2,2,0,0,0,0
"Jan 7, 2019 6:00 PM",304,49,255,,,,,,,,,,22,16,6,23,,,,170,164,6,31,202,85,6,79,53,3,3,3,2,1,3,1,2
"Jan 7, 2019 7:00 PM",130,34,96,,,,,,,,,,6,5,1,12,,,,69,67,2,12,70,29,1,28,22,3,2,3,3,0,4,4,0
"Jan 7, 2019 8:00 PM",66,18,48,,,,,,,,,,6,5,1,5,,,,41,39,2,12,26,9,1,8,11,2,0,1,0,1,0,0,0
"Jan 7, 2019 9:00 PM",39,7,32,,,,,,,,,,3,1,2,8,,,,21,20,1,8,12,7,1,6,10,2,0,1,0,1,0,0,0
"Jan 7, 2019 10:00 PM",20,6,14,,,,,,,,,,3,1,2,2,,,,13,10,3,4,9,3,2,1,7,2,0,0,0,0,0,0,0
"Jan 7, 2019 11:00 PM",6,0,6,,,,,,,,,,0,0,0,0,,,,2,2,0,1,1,0,0,0,1,0,0,0,0,0,0,0,0
"Jan 8, 2019 12:00 AM",5,5,0,,,,,,,,,,2,2,0,1,,,,2,2,0,1,1,0,0,0,1,0,1,0,0,0,0,0,0
"Jan 8, 2019 1:00 AM",3,0,3,,,,,,,,,,0,0,0,0,,,,0,0,0,0,1,0,0,0,1,0,0,0,0,0,0,0,0
"Jan 8, 2019 2:00 AM",2,0,2,,,,,,,,,,0,0,0,0,,,,0,0,0,0,0,0,0,0,1,0,0,0,0,0,0,0,0
"Jan 8, 2019 3:00 AM",2,1,1,,,,,,,,,,0,0,0,0,,,,0,0,0,0,1,0,0,0,0,0,0,0,0,0,1,1,0
"Jan 8, 2019 4:00 AM",0,0,0,,,,,,,,,,0,0,0,0,,,,0,0,0,0,0,0,0,0,2,1,0,0,0,0,0,0,0
"Jan 8, 2019 5:00 AM",8,6,2,,,,,,,,,,1,0,1,4,,,,0,0,0,6,1,0,0,0,10,0,0,0,0,0,0,0,0
"Jan 8, 2019 6:00 AM",49,36,13,,,,,,,,,,0,0,0,4,,,,7,5,2,29,9,6,5,1,54,1,1,1,0,1,0,0,0
"Jan 8, 2019 7:00 AM",198,151,47,,,,,,,,,,14,0,14,16,,,,23,19,4,132,34,32,25,7,172,1,3,4,3,1,3,0,3
"Jan 8, 2019 8:00 AM",353,280,73,,,,,,,,,,20,6,14,32,,,,49,32,17,270,59,99,80,19,333,7,5,15,12,3,3,0,3
"Jan 8, 2019 9:00 AM",155,131,24,,,,,,,,,,19,6,13,4,,,,22,14,8,87,28,55,40,15,111,4,2,1,1,0,2,0,2
"Jan 8, 2019 10:00 AM",50,34,16,,,,,,,,,,4,2,2,6,,,,10,5,5,22,19,12,8,4,33,2,2,6,4,2,1,1,0
"Jan 8, 2019 11:00 AM",41,26,15,,,,,,,,,,11,5,6,3,,,,11,11,0,17,12,10,4,6,21,3,1,2,2,0,1,0,1
"Jan 8, 2019 12:00 PM",33,17,16,,,,,,,,,,7,1,6,5,,,,7,5,2,19,16,15,3,12,21,5,3,2,2,0,0,0,0
"Jan 8, 2019 1:00 PM",56,29,27,,,,,,,,,,10,8,2,13,,,,22,19,3,14,18,19,7,12,24,2,2,0,0,0,0,0,0
"Jan 8, 2019 2:00 PM",53,20,33,,,,,,,,,,15,9,6,8,,,,22,18,4,8,23,30,9,21,21,1,1,6,3,3,4,0,4
"Jan 8, 2019 3:00 PM",58,16,42,,,,,,,,,,10,4,6,11,,,,20,19,1,11,24,10,1,9,16,1,0,7,0,7,2,2,0
"Jan 8, 2019 4:00 PM",127,31,96,,,,,,,,,,16,10,6,29,,,,57,54,3,21,46,26,4,22,34,4,1,9,7,2,2,2,0
"Jan 8, 2019 5:00 PM",300,52,248,,,,,,,,,,9,5,4,11,,,,174,164,10,41,146,74,2,72,74,4,1,3,0,3,2,1,1
"Jan 8, 2019 6:00 PM",309,49,260,,,,,,,,,,20,17,3,29,,,,161,158,3,33,192,100,11,89,54,2,1,6,3,3,2,0,2
"Jan 8, 2019 7:00 PM",131,26,105,,,,,,,,,,3,3,0,9,,,,88,83,5,12,79,42,3,39,27,3,0,0,0,0,5,1,4
"Jan 8, 2019 8:00 PM",68,14,54,,,,,,,,,,8,6,2,3,,,,38,38,0,10,44,12,2,10,17,4,2,2,2,0,1,1,0
"Jan 8, 2019 9:00 PM",55,18,37,,,,,,,,,,3,3,0,2,,,,16,16,0,4,25,9,4,5,17,0,0,0,0,0,0,0,0
"Jan 8, 2019 10:00 PM",35,12,23,,,,,,,,,,3,3,0,3,,,,11,9,2,1,8,6,2,4,9,1,1,0,0,0,0,0,0
"Jan 8, 2019 11:00 PM",10,1,9,,,,,,,,,,1,0,1,1,,,,6,6,0,2,1,1,0,1,4,0,1,0,0,0,0,0,0
"Jan 9, 2019 12:00 AM",6,3,3,,,,,,,,,,1,1,0,1,,,,0,0,0,0,1,4,0,4,1,1,1,0,0,0,0,0,0
"Jan 9, 2019 1:00 AM",2,2,0,,,,,,,,,,0,0,0,0,,,,2,2,0,0,1,0,0,0,1,0,0,0,0,0,0,0,0
"Jan 9, 2019 2:00 AM",1,0,1,,,,,,,,,,0,0,0,0,,,,0,0,0,0,0,0,0,0,0,0,0,0,0,0,0,0,0
"Jan 9, 2019 3:00 AM",2,1,1,,,,,,,,,,0,0,0,0,,,,0,0,0,0,1,0,0,0,0,0,0,0,0,0,1,1,0
"Jan 9, 2019 4:00 AM",1,1,0,,,,,,,,,,0,0,0,0,,,,2,2,0,0,0,0,0,0,2,1,0,0,0,0,0,0,0
"Jan 9, 2019 5:00 AM",4,3,1,,,,,,,,,,1,0,1,1,,,,0,0,0,6,2,0,0,0,10,1,1,0,0,0,0,0,0
"Jan 9, 2019 6:00 AM",60,51,9,,,,,,,,,,3,0,3,8,,,,3,2,1,24,11,7,5,2,40,2,0,1,0,1,0,0,0
"Jan 9, 2019 7:00 AM",189,139,50,,,,,,,,,,9,2,7,19,,,,22,18,4,128,31,27,20,7,171,6,3,3,3,0,0,0,0
"Jan 9, 2019 8:00 AM",371,293,78,,,,,,,,,,28,6,22,36,,,,37,27,10,271,63,100,78,22,323,7,4,10,6,4,0,0,0
"Jan 9, 2019 9:00 AM",165,147,18,,,,,,,,,,12,2,10,10,,,,19,13,6,101,31,45,31,14,106,5,2,5,2,3,2,1,1
"Jan 9, 2019 10:00 AM",34,21,13,,,,,,,,,,11,2,9,3,,,,9,7,2,24,18,18,9,9,34,2,0,4,3,1,1,0,1
"Jan 9, 2019 11:00 AM",33,25,8,,,,,,,,,,8,2,6,5,,,,10,6,4,20,14,12,2,10,20,1,3,5,5,0,0,0,0
"Jan 9, 2019 12:00 PM",38,22,16,,,,,,,,,,14,10,4,7,,,,18,17,1,11,25,14,3,11,33,2,1,2,2,0,1,1,0
"Jan 9, 2019 1:00 PM",55,31,24,,,,,,,,,,6,5,1,7,,,,25,23,2,15,17,19,7,12,30,7,2,3,0,3,3,2,1
"Jan 9, 2019 2:00 PM",54,31,23,,,,,,,,,,11,8,3,10,,,,28,23,5,6,24,17,8,9,27,3,2,5,3,2,0,0,0
"Jan 9, 2019 3:00 PM",53,17,36,,,,,,,,,,14,2,12,19,,,,23,21,2,15,27,19,6,13,19,1,1,4,2,2,3,0,3
"Jan 9, 2019 4:00 PM",134,45,89,,,,,,,,,,18,14,4,26,,,,52,48,4,19,54,28,7,21,34,3,2,2,1,1,0,0,0
"Jan 9, 2019 5:00 PM",291,52,239,,,,,,,,,,13,7,6,18,,,,175,171,4,37,136,61,11,50,61,4,2,3,2,1,1,1,0
"Jan 9, 2019 6:00 PM",304,44,260,,,,,,,,,,21,21,0,21,,,,179,176,3,26,193,93,7,86,58,7,3,2,1,1,1,1,0
"Jan 9, 2019 7:00 PM",116,19,97,,,,,,,,,,2,2,0,5,,,,65,62,3,18,82,24,0,24,17,2,2,4,2,2,0,0,0
"Jan 9, 2019 8:00 PM",69,16,53,,,,,,,,,,3,3,0,7,,,,29,27,2,6,37,11,1,10,15,2,2,3,0,3,0,0,0
"Jan 9, 2019 9:00 PM",56,13,43,,,,,,,,,,1,1,0,5,,,,20,19,1,8,16,10,0,10,16,1,0,1,1,0,0,0,0
"Jan 9, 2019 10:00 PM",25,4,21,,,,,,,,,,1,0,1,1,,,,14,12,2,4,10,3,2,1,6,2,0,1,1,0,1,1,0
"Jan 9, 2019 11:00 PM",8,3,5,,,,,,,,,,0,0,0,1,,,,4,4,0,0,3,6,2,4,2,0,1,0,0,0,0,0,0
"Jan 10, 2019 12:00 AM",2,1,1,,,,,,,,,,0,0,0,0,,,,1,1,0,1,2,3,1,2,4,0,0,0,0,0,0,0,0
"Jan 10, 2019 1:00 AM",3,0,3,,,,,,,,,,1,1,0,0,,,,4,4,0,0,1,0,0,0,0,0,0,0,0,0,0,0,0
"Jan 10, 2019 2:00 AM",3,1,2,,,,,,,,,,0,0,0,0,,,,0,0,0,0,0,0,0,0,0,1,0,0,0,0,0,0,0
"Jan 10, 2019 3:00 AM",2,1,1,,,,,,,,,,0,0,0,0,,,,1,1,0,1,1,0,0,0,0,0,0,0,0,0,1,1,0
"Jan 10, 2019 4:00 AM",0,0,0,,,,,,,,,,0,0,0,0,,,,1,1,0,0,0,0,0,0,2,0,0,0,0,0,0,0,0
"Jan 10, 2019 5:00 AM",4,3,1,,,,,,,,,,0,0,0,7,,,,0,0,0,6,1,0,0,0,7,2,0,0,0,0,0,0,0
"Jan 10, 2019 6:00 AM",57,52,5,,,,,,,,,,1,0,1,6,,,,8,6,2,21,6,3,3,0,36,2,0,2,1,1,1,0,1
"Jan 10, 2019 7:00 AM",155,116,39,,,,,,,,,,11,3,8,13,,,,19,14,5,108,26,28,23,5,151,1,5,3,3,0,0,0,0
"Jan 10, 2019 8:00 AM",353,288,65,,,,,,,,,,19,5,14,35,,,,49,40,9,234,49,84,71,13,310,7,4,10,6,4,2,0,2
"Jan 10, 2019 9:00 AM",165,143,22,,,,,,,,,,16,3,13,1,,,,18,11,7,86,34,52,39,13,108,3,0,2,1,1,4,3,1
"Jan 10, 2019 10:00 AM",46,34,12,,,,,,,,,,8,4,4,6,,,,6,4,2,17,11,8,2,6,22,0,0,0,0,0,0,0,0
"Jan 10, 2019 11:00 AM",34,20,14,,,,,,,,,,11,1,10,3,,,,8,5,3,13,9,6,3,3,16,6,0,0,0,0,0,0,0
"Jan 10, 2019 12:00 PM",38,25,13,,,,,,,,,,9,6,3,8,,,,11,11,0,13,9,9,3,6,15,1,0,2,1,1,0,0,0
"Jan 10, 2019 1:00 PM",41,19,22,,,,,,,,,,7,6,1,6,,,,16,16,0,15,25,11,5,6,20,0,0,1,1,0,1,0,1
"Jan 10, 2019 2:00 PM",54,28,26,,,,,,,,,,7,1,6,9,,,,20,16,4,5,16,14,6,8,17,0,2,1,0,1,2,2,0
"Jan 10, 2019 3:00 PM",59,19,40,,,,,,,,,,8,3,5,9,,,,30,27,3,12,26,9,3,6,22,3,0,4,3,1,1,1,0
"Jan 10, 2019 4:00 PM",117,33,84,,,,,,,,,,12,7,5,18,,,,46,43,3,21,56,24,7,17,37,6,4,3,3,0,1,1,0
"Jan 10, 2019 5:00 PM",274,49,225,,,,,,,,,,12,9,3,19,,,,124,121,3,27,131,66,7,59,61,3,0,4,2,2,2,1,1
"Jan 10, 2019 6:00 PM",278,45,233,,,,,,,,,,11,11,0,16,,,,152,148,4,33,145,87,10,77,52,6,3,4,3,1,0,0,0
"Jan 10, 2019 7:00 PM",110,20,90,,,,,,,,,,10,7,3,15,,,,69,68,1,18,69,43,3,40,22,6,2,3,3,0,3,0,3
"Jan 10, 2019 8:00 PM",67,18,49,,,,,,,,,,8,7,1,6,,,,42,41,1,7,28,19,3,16,13,2,4,2,1,1,1,0,1
"Jan 10, 2019 9:00 PM",39,10,29,,,,,,,,,,2,2,0,4,,,,14,13,1,13,15,6,0,6,15,3,1,2,1,1,0,0,0
"Jan 10, 2019 10:00 PM",26,8,18,,,,,,,,,,8,7,1,1,,,,13,12,1,3,6,2,1,1,9,1,0,0,0,0,0,0,0
"Jan 10, 2019 11:00 PM",13,6,7,,,,,,,,,,2,0,2,1,,,,5,5,0,2,8,3,2,1,4,0,0,0,0,0,0,0,0
"Jan 11, 2019 12:00 AM",3,1,2,,,,,,,,,,0,0,0,1,,,,6,6,0,5,6,0,0,0,2,0,0,0,0,0,0,0,0
"Jan 11, 2019 1:00 AM",2,0,2,,,,,,,,,,0,0,0,0,,,,5,5,0,0,5,0,0,0,0,0,0,0,0,0,0,0,0
"Jan 11, 2019 2:00 AM",1,1,0,,,,,,,,,,0,0,0,0,,,,4,4,0,0,0,1,0,1,1,0,0,0,0,0,0,0,0
"Jan 11, 2019 3:00 AM",1,1,0,,,,,,,,,,0,0,0,0,,,,3,3,0,0,1,0,0,0,0,0,0,0,0,0,0,0,0
"Jan 11, 2019 4:00 AM",1,1,0,,,,,,,,,,0,0,0,0,,,,1,1,0,0,0,0,0,0,2,0,0,0,0,0,0,0,0
"Jan 11, 2019 5:00 AM",7,5,2,,,,,,,,,,2,2,0,1,,,,0,0,0,7,2,0,0,0,10,2,0,0,0,0,0,0,0
"Jan 11, 2019 6:00 AM",45,34,11,,,,,,,,,,2,0,2,5,,,,9,7,2,25,11,5,3,2,42,1,1,0,0,0,2,0,2
"Jan 11, 2019 7:00 AM",152,110,42,,,,,,,,,,8,1,7,15,,,,16,12,4,103,28,22,17,5,136,5,4,2,2,0,1,0,1
"Jan 11, 2019 8:00 AM",311,252,59,,,,,,,,,,28,5,23,30,,,,25,17,8,201,49,75,63,12,258,8,2,11,10,1,1,0,1
"Jan 11, 2019 9:00 AM",147,126,21,,,,,,,,,,8,1,7,8,,,,20,13,7,82,26,45,27,18,92,2,3,8,5,3,0,0,0
"Jan 11, 2019 10:00 AM",45,36,9,,,,,,,,,,8,2,6,8,,,,11,9,2,31,11,14,6,8,32,2,5,3,2,1,1,0,1
"Jan 11, 2019 11:00 AM",40,22,18,,,,,,,,,,11,5,6,5,,,,5,5,0,15,13,6,3,3,23,2,2,0,0,0,0,0,0
"Jan 11, 2019 12:00 PM",58,32,26,,,,,,,,,,9,7,2,10,,,,15,15,0,13,10,13,5,8,20,0,3,1,0,1,0,0,0
"Jan 11, 2019 1:00 PM",67,21,46,,,,,,,,,,14,9,5,12,,,,17,16,1,21,26,16,7,9,30,3,3,2,1,1,1,0,1
"Jan 11, 2019 2:00 PM",49,26,23,,,,,,,,,,22,14,8,8,,,,20,18,2,9,19,18,2,16,14,4,0,0,0,0,0,0,0
"Jan 11, 2019 3:00 PM",82,27,55,,,,,,,,,,9,4,5,11,,,,36,35,1,12,30,19,6,13,21,4,2,2,1,1,2,2,0
"Jan 11, 2019 4:00 PM",109,26,83,,,,,,,,,,12,11,1,18,,,,62,61,1,19,59,27,8,19,32,6,0,5,1,4,3,3,0
"Jan 11, 2019 5:00 PM",236,42,194,,,,,,,,,,16,14,2,12,,,,125,122,3,25,128,54,9,45,48,3,4,3,2,1,1,1,0
"Jan 11, 2019 6:00 PM",213,29,184,,,,,,,,,,17,16,1,17,,,,110,108,2,20,132,74,5,69,39,6,0,1,1,0,1,0,1
"Jan 11, 2019 7:00 PM",91,25,66,,,,,,,,,,4,3,1,7,,,,50,46,4,14,45,28,5,23,18,2,0,6,3,3,0,0,0
"Jan 11, 2019 8:00 PM",33,9,24,,,,,,,,,,3,2,1,5,,,,23,23,0,6,36,10,3,7,11,2,0,4,2,2,0,0,0
"Jan 11, 2019 9:00 PM",34,8,26,,,,,,,,,,0,0,0,2,,,,10,9,1,6,10,5,0,5,9,0,0,0,0,0,0,0,0
"Jan 11, 2019 10:00 PM",17,2,15,,,,,,,,,,1,1,0,5,,,,10,10,0,0,5,5,4,1,10,0,0,0,0,0,0,0,0
"Jan 11, 2019 11:00 PM",16,9,7,,,,,,,,,,3,1,2,1,,,,7,6,1,4,3,2,2,0,5,0,0,1,1,0,0,0,0
"Jan 12, 2019 12:00 AM",7,3,4,,,,,,,,,,2,1,1,4,,,,5,5,0,2,4,3,0,3,6,0,2,0,0,0,0,0,0
"Jan 12, 2019 1:00 AM",4,0,4,,,,,,,,,,0,0,0,0,,,,6,6,0,3,4,0,0,0,1,0,0,0,0,0,0,0,0
"Jan 12, 2019 2:00 AM",6,0,6,,,,,,,,,,0,0,0,0,,,,1,1,0,0,4,0,0,0,0,1,1,0,0,0,0,0,0
"Jan 12, 2019 3:00 AM",4,3,1,,,,,,,,,,0,0,0,0,,,,1,1,0,1,3,2,0,2,1,0,1,0,0,0,0,0,0
"Jan 12, 2019 4:00 AM",3,0,3,,,,,,,,,,0,0,0,0,,,,1,1,0,0,0,0,0,0,1,0,0,0,0,0,0,0,0
"Jan 12, 2019 5:00 AM",2,0,2,,,,,,,,,,0,0,0,1,,,,2,2,0,0,1,0,0,0,3,0,0,0,0,0,0,0,0
"Jan 12, 2019 6:00 AM",4,3,1,,,,,,,,,,0,0,0,0,,,,5,4,1,1,1,2,0,2,4,0,0,0,0,0,0,0,0
"Jan 12, 2019 7:00 AM",8,3,5,,,,,,,,,,5,0,5,1,,,,2,2,0,2,7,4,1,3,14,0,0,0,0,0,0,0,0
"Jan 12, 2019 8:00 AM",33,18,15,,,,,,,,,,1,0,1,4,,,,2,1,1,12,12,11,5,6,19,0,2,0,0,0,0,0,0
"Jan 12, 2019 9:00 AM",44,24,20,,,,,,,,,,9,4,5,4,,,,8,8,0,14,18,16,6,10,21,1,5,0,0,0,0,0,0
"Jan 12, 2019 10:00 AM",41,31,10,,,,,,,,,,16,9,7,5,,,,7,7,0,14,14,22,13,9,23,6,2,1,1,0,0,0,0
"Jan 12, 2019 11:00 AM",46,23,23,,,,,,,,,,9,6,3,12,,,,12,11,1,16,19,19,1,18,31,5,2,1,0,1,2,0,2
"Jan 12, 2019 12:00 PM",51,33,18,,,,,,,,,,26,19,7,11,,,,14,12,2,24,18,12,6,6,38,13,5,4,3,1,4,0,4
"Jan 12, 2019 1:00 PM",38,15,23,,,,,,,,,,10,3,7,4,,,,19,16,3,8,17,10,3,7,19,4,2,3,2,1,5,3,2
"Jan 12, 2019 2:00 PM",56,29,27,,,,,,,,,,11,2,9,13,,,,13,11,2,8,14,13,6,7,25,0,1,2,0,2,0,0,0
"Jan 12, 2019 3:00 PM",40,17,23,,,,,,,,,,25,9,16,16,,,,23,21,2,11,20,25,10,15,18,2,3,1,1,0,0,0,0
"Jan 12, 2019 4:00 PM",34,13,21,,,,,,,,,,31,17,14,9,,,,11,10,1,10,9,18,8,10,14,3,0,3,0,3,2,2,0
"Jan 12, 2019 5:00 PM",31,11,20,,,,,,,,,,14,10,4,8,,,,15,14,1,12,17,17,10,7,15,0,0,4,2,2,3,2,1
"Jan 12, 2019 6:00 PM",26,8,18,,,,,,,,,,5,4,1,1,,,,14,14,0,5,10,4,2,2,9,1,0,1,1,0,0,0,0
"Jan 12, 2019 7:00 PM",19,10,9,,,,,,,,,,0,0,0,2,,,,7,7,0,7,10,3,2,1,8,2,0,1,0,1,0,0,0
"Jan 12, 2019 8:00 PM",19,9,10,,,,,,,,,,4,2,2,1,,,,7,7,0,7,7,3,1,2,5,0,0,3,0,3,0,0,0
"Jan 12, 2019 9:00 PM",7,4,3,,,,,,,,,,3,2,1,5,,,,3,2,1,4,3,3,1,2,7,0,0,0,0,0,0,0,0
"Jan 12, 2019 10:00 PM",12,6,6,,,,,,,,,,0,0,0,2,,,,5,4,1,0,4,5,4,1,3,0,0,2,1,1,0,0,0
"Jan 12, 2019 11:00 PM",7,2,5,,,,,,,,,,0,0,0,1,,,,3,3,0,3,4,4,2,2,8,0,5,0,0,0,0,0,0
"Jan 13, 2019 12:00 AM",3,1,2,,,,,,,,,,0,0,0,2,,,,5,4,1,0,3,2,2,0,7,0,0,0,0,0,0,0,0
"Jan 13, 2019 1:00 AM",3,1,2,,,,,,,,,,2,0,2,2,,,,3,3,0,0,1,0,0,0,5,0,1,0,0,0,0,0,0
"Jan 13, 2019 2:00 AM",1,0,1,,,,,,,,,,2,2,0,0,,,,1,1,0,1,1,0,0,0,1,0,1,0,0,0,0,0,0
"Jan 13, 2019 3:00 AM",0,0,0,,,,,,,,,,0,0,0,2,,,,2,2,0,0,2,1,0,1,0,0,0,0,0,0,0,0,0
"Jan 13, 2019 4:00 AM",3,1,2,,,,,,,,,,0,0,0,0,,,,2,2,0,0,3,0,0,0,0,0,0,0,0,0,0,0,0
"Jan 13, 2019 5:00 AM",3,0,3,,,,,,,,,,0,0,0,0,,,,1,1,0,0,0,0,0,0,0,0,0,0,0,0,0,0,0
"Jan 13, 2019 6:00 AM",3,2,1,,,,,,,,,,0,0,0,0,,,,4,4,0,0,3,0,0,0,9,0,0,0,0,0,0,0,0
"Jan 13, 2019 7:00 AM",7,3,4,,,,,,,,,,0,0,0,0,,,,1,1,0,3,7,2,1,1,5,0,1,1,0,1,0,0,0
"Jan 13, 2019 8:00 AM",19,9,10,,,,,,,,,,4,1,3,6,,,,1,0,1,2,6,4,2,2,13,2,1,1,1,0,0,0,0
"Jan 13, 2019 9:00 AM",22,12,10,,,,,,,,,,6,2,4,3,,,,5,3,2,9,11,5,0,5,25,1,10,2,2,0,0,0,0
"Jan 13, 2019 10:00 AM",21,11,10,,,,,,,,,,8,4,4,4,,,,8,8,0,10,13,30,6,24,41,7,16,16,1,15,0,0,0
"Jan 13, 2019 11:00 AM",32,12,20,,,,,,,,,,22,8,14,10,,,,7,7,0,7,28,19,9,10,20,5,2,5,3,2,1,0,1
"Jan 13, 2019 12:00 PM",27,11,16,,,,,,,,,,17,11,6,6,,,,5,4,1,18,16,9,2,7,20,3,1,2,0,2,0,0,0
"Jan 13, 2019 1:00 PM",36,19,17,,,,,,,,,,21,12,9,20,,,,23,21,2,11,27,27,11,16,31,5,6,0,0,0,0,0,0
"Jan 13, 2019 2:00 PM",33,15,18,,,,,,,,,,28,14,14,7,,,,11,10,1,16,14,18,7,11,20,2,1,2,1,1,0,0,0
"Jan 13, 2019 3:00 PM",29,14,15,,,,,,,,,,12,5,7,33,,,,7,6,1,9,15,8,4,4,18,5,3,5,1,4,2,1,1
"Jan 13, 2019 4:00 PM",47,26,21,,,,,,,,,,18,11,7,4,,,,13,12,1,12,15,14,6,8,17,1,2,2,2,0,0,0,0
"Jan 13, 2019 5:00 PM",25,11,14,,,,,,,,,,8,3,5,8,,,,8,7,1,8,4,8,4,4,9,1,0,2,1,1,0,0,0
"Jan 13, 2019 6:00 PM",33,16,17,,,,,,,,,,6,1,5,3,,,,9,7,2,3,8,4,2,2,10,1,1,1,1,0,0,0,0
"Jan 13, 2019 7:00 PM",19,10,9,,,,,,,,,,0,0,0,6,,,,7,6,1,5,7,2,0,2,7,1,0,5,4,1,4,2,2
"Jan 13, 2019 8:00 PM",18,7,11,,,,,,,,,,1,1,0,1,,,,4,4,0,5,8,1,0,1,5,0,0,1,0,1,0,0,0
"Jan 13, 2019 9:00 PM",12,5,7,,,,,,,,,,1,0,1,2,,,,4,4,0,2,4,4,2,2,9,0,0,0,0,0,0,0,0
"Jan 13, 2019 10:00 PM",7,0,7,,,,,,,,,,3,2,1,1,,,,4,3,1,3,1,1,0,1,5,0,1,0,0,0,0,0,0
"Jan 13, 2019 11:00 PM",6,2,4,,,,,,,,,,0,0,0,0,,,,3,3,0,2,1,0,0,0,1,0,1,0,0,0,0,0,0
"Jan 14, 2019 12:00 AM",2,0,2,,,,,,,,,,0,0,0,0,,,,2,2,0,0,0,1,1,0,0,0,0,0,0,0,0,0,0
"Jan 14, 2019 1:00 AM",0,0,0,,,,,,,,,,0,0,0,0,,,,1,1,0,0,2,0,0,0,1,0,1,0,0,0,0,0,0
"Jan 14, 2019 2:00 AM",0,0,0,,,,,,,,,,1,0,1,0,,,,1,0,1,0,1,0,0,0,0,0,0,0,0,0,0,0,0
"Jan 14, 2019 3:00 AM",2,0,2,,,,,,,,,,0,0,0,0,,,,0,0,0,0,1,0,0,0,0,0,0,0,0,0,0,0,0
"Jan 14, 2019 4:00 AM",0,0,0,,,,,,,,,,0,0,0,0,,,,0,0,0,0,1,0,0,0,1,0,0,0,0,0,0,0,0
"Jan 14, 2019 5:00 AM",2,0,2,,,,,,,,,,1,0,1,0,,,,1,1,0,8,1,0,0,0,6,2,0,0,0,0,0,0,0
"Jan 14, 2019 6:00 AM",56,43,13,,,,,,,,,,2,0,2,4,,,,8,6,2,17,8,5,3,2,61,1,1,1,0,1,0,0,0
"Jan 14, 2019 7:00 AM",208,159,49,,,,,,,,,,8,0,8,16,,,,30,25,5,121,32,25,19,6,168,3,3,0,0,0,1,0,1
"Jan 14, 2019 8:00 AM",374,294,80,,,,,,,,,,30,9,21,32,,,,44,31,13,268,59,108,92,16,347,7,6,5,4,1,0,0,0
"Jan 14, 2019 9:00 AM",158,135,23,,,,,,,,,,22,6,16,7,,,,26,18,8,92,37,58,38,20,110,2,1,4,3,1,1,0,1
"Jan 14, 2019 10:00 AM",41,32,9,,,,,,,,,,7,2,5,5,,,,8,6,2,25,20,17,10,7,28,3,3,2,1,1,0,0,0
"Jan 14, 2019 11:00 AM",34,26,8,,,,,,,,,,10,5,5,8,,,,7,5,2,20,9,9,3,6,27,1,1,2,2,0,0,0,0
"Jan 14, 2019 12:00 PM",54,24,30,,,,,,,,,,7,3,4,4,,,,13,11,2,16,11,20,7,13,18,2,2,2,2,0,0,0,0
"Jan 14, 2019 1:00 PM",65,35,30,,,,,,,,,,10,8,2,6,,,,21,18,3,20,17,17,8,9,25,2,2,1,0,1,3,2,1
"Jan 14, 2019 2:00 PM",52,28,24,,,,,,,,,,13,4,9,4,,,,27,24,3,11,17,18,5,13,18,4,0,1,0,1,0,0,0
"Jan 14, 2019 3:00 PM",54,17,37,,,,,,,,,,5,4,1,11,,,,28,26,2,16,25,10,4,6,21,1,0,3,2,1,0,0,0
"Jan 14, 2019 4:00 PM",129,34,95,,,,,,,,,,12,6,6,15,,,,57,51,6,22,55,29,8,21,30,3,4,4,2,2,0,0,0
"Jan 14, 2019 5:00 PM",332,66,266,,,,,,,,,,16,8,8,32,,,,152,148,4,26,154,68,7,61,74,3,3,3,2,1,1,1,0
"Jan 14, 2019 6:00 PM",318,52,266,,,,,,,,,,20,19,1,25,,,,165,160,5,36,206,92,16,76,55,10,1,2,1,1,0,0,0
"Jan 14, 2019 7:00 PM",133,20,113,,,,,,,,,,6,5,1,6,,,,72,72,0,21,97,41,5,36,26,2,1,1,1,0,0,0,0
"Jan 14, 2019 8:00 PM",74,22,52,,,,,,,,,,6,5,1,8,,,,36,36,0,8,30,19,5,14,16,1,3,2,0,2,0,0,0
"Jan 14, 2019 9:00 PM",45,8,37,,,,,,,,,,2,2,0,7,,,,16,16,0,9,17,10,2,8,14,4,0,3,1,2,0,0,0
"Jan 14, 2019 10:00 PM",18,4,14,,,,,,,,,,1,1,0,2,,,,6,6,0,1,9,3,1,2,5,0,0,3,1,2,2,0,2
"Jan 14, 2019 11:00 PM",9,2,7,,,,,,,,,,1,0,1,0,,,,5,5,0,1,3,2,1,1,3,0,0,0,0,0,0,0,0
"Jan 15, 2019 12:00 AM",2,1,1,,,,,,,,,,0,0,0,0,,,,2,2,0,1,2,3,0,3,0,0,0,1,1,0,0,0,0
"Jan 15, 2019 1:00 AM",1,0,1,,,,,,,,,,2,0,2,0,,,,0,0,0,0,0,1,0,1,0,0,1,0,0,0,0,0,0
"Jan 15, 2019 2:00 AM",1,0,1,,,,,,,,,,0,0,0,0,,,,0,0,0,0,0,0,0,0,0,0,0,0,0,0,0,0,0
"Jan 15, 2019 3:00 AM",3,1,2,,,,,,,,,,0,0,0,0,,,,0,0,0,0,1,0,0,0,0,0,0,0,0,0,1,1,0
"Jan 15, 2019 4:00 AM",1,1,0,,,,,,,,,,0,0,0,0,,,,0,0,0,0,0,0,0,0,1,1,0,0,0,0,0,0,0
"Jan 15, 2019 5:00 AM",7,4,3,,,,,,,,,,0,0,0,1,,,,1,1,0,4,0,0,0,0,8,1,0,0,0,0,0,0,0
"Jan 15, 2019 6:00 AM",66,53,13,,,,,,,,,,2,0,2,6,,,,5,3,2,30,11,3,2,1,56,1,1,1,0,1,0,0,0
"Jan 15, 2019 7:00 AM",214,167,47,,,,,,,,,,11,0,11,17,,,,22,20,2,123,45,27,21,6,188,3,1,3,3,0,0,0,0
"Jan 15, 2019 8:00 AM",381,286,95,,,,,,,,,,24,7,17,35,,,,53,33,20,265,47,116,91,25,338,5,9,9,9,0,3,0,3
"Jan 15, 2019 9:00 AM",160,137,23,,,,,,,,,,20,3,17,7,,,,32,23,9,99,28,50,38,12,119,4,1,3,2,1,1,1,0
"Jan 15, 2019 10:00 AM",61,52,9,,,,,,,,,,4,1,3,3,,,,5,2,3,29,11,14,6,8,31,3,4,2,2,0,0,0,0
"Jan 15, 2019 11:00 AM",40,26,14,,,,,,,,,,12,7,5,11,,,,5,4,1,27,10,8,3,5,22,1,5,1,1,0,0,0,0
"Jan 15, 2019 12:00 PM",31,18,13,,,,,,,,,,6,4,2,7,,,,12,11,1,12,10,11,1,10,17,3,6,3,3,0,0,0,0
"Jan 15, 2019 1:00 PM",55,27,28,,,,,,,,,,19,11,8,14,,,,19,12,7,15,21,18,9,9,25,3,1,1,0,1,1,1,0
"Jan 15, 2019 2:00 PM",54,24,30,,,,,,,,,,15,9,6,9,,,,23,16,7,13,21,14,5,9,18,3,5,5,3,2,0,0,0
"Jan 15, 2019 3:00 PM",65,23,42,,,,,,,,,,8,3,5,7,,,,27,24,3,12,24,10,3,7,27,2,0,3,2,1,0,0,0
"Jan 15, 2019 4:00 PM",134,34,100,,,,,,,,,,7,5,2,19,,,,67,63,4,23,57,27,7,20,39,2,0,3,0,3,0,0,0
"Jan 15, 2019 5:00 PM",299,61,238,,,,,,,,,,21,20,1,18,,,,175,168,7,34,158,56,6,50,71,4,3,0,0,0,1,1,0
"Jan 15, 2019 6:00 PM",319,45,274,,,,,,,,,,18,14,4,25,,,,173,170,3,34,181,94,10,84,47,5,5,1,1,0,0,0,0
"Jan 15, 2019 7:00 PM",141,28,113,,,,,,,,,,7,4,3,17,,,,71,69,2,18,93,49,8,41,26,2,4,2,2,0,0,0,0
"Jan 15, 2019 8:00 PM",102,26,76,,,,,,,,,,9,6,3,3,,,,43,43,0,21,45,19,3,16,17,3,1,3,2,1,1,1,0
"Jan 15, 2019 9:00 PM",44,9,35,,,,,,,,,,8,7,1,4,,,,21,20,1,4,20,6,0,6,16,2,1,4,2,2,0,0,0
"Jan 15, 2019 10:00 PM",27,5,22,,,,,,,,,,4,2,2,5,,,,12,10,2,6,12,5,3,2,7,0,1,2,1,1,0,0,0
"Jan 15, 2019 11:00 PM",6,1,5,,,,,,,,,,0,0,0,0,,,,7,7,0,0,0,5,1,4,2,0,1,0,0,0,0,0,0
"Jan 16, 2019 12:00 AM",5,1,4,,,,,,,,,,1,1,0,0,,,,1,1,0,2,2,0,0,0,1,1,1,0,0,0,0,0,0
"Jan 16, 2019 1:00 AM",2,0,2,,,,,,,,,,1,1,0,0,,,,3,3,0,0,0,1,1,0,0,0,0,0,0,0,0,0,0
"Jan 16, 2019 2:00 AM",0,0,0,,,,,,,,,,0,0,0,0,,,,1,1,0,0,1,1,0,1,0,0,0,0,0,0,0,0,0
"Jan 16, 2019 3:00 AM",1,1,0,,,,,,,,,,0,0,0,0,,,,0,0,0,0,0,0,0,0,0,0,0,0,0,0,0,0,0
"Jan 16, 2019 4:00 AM",1,1,0,,,,,,,,,,0,0,0,1,,,,1,1,0,0,0,0,0,0,1,0,1,0,0,0,0,0,0
"Jan 16, 2019 5:00 AM",6,4,2,,,,,,,,,,0,0,0,1,,,,1,1,0,6,1,0,0,0,6,1,0,0,0,0,0,0,0
"Jan 16, 2019 6:00 AM",49,42,7,,,,,,,,,,3,0,3,4,,,,4,3,1,27,10,1,1,0,41,1,1,2,1,1,0,0,0
"Jan 16, 2019 7:00 AM",187,141,46,,,,,,,,,,12,2,10,9,,,,29,26,3,119,30,22,17,5,162,1,2,2,2,0,2,0,2
"Jan 16, 2019 8:00 AM",365,292,73,,,,,,,,,,21,6,15,36,,,,36,25,11,246,54,98,76,22,338,7,6,13,11,2,1,0,1
"Jan 16, 2019 9:00 AM",155,140,15,,,,,,,,,,16,4,12,6,,,,26,13,13,79,28,35,22,13,116,5,2,4,0,4,0,0,0
"Jan 16, 2019 10:00 AM",50,38,12,,,,,,,,,,8,2,6,4,,,,15,9,6,28,17,16,8,8,30,3,2,2,2,0,2,1,1
"Jan 16, 2019 11:00 AM",53,30,23,,,,,,,,,,6,3,3,4,,,,10,9,1,16,15,4,3,1,16,0,1,4,3,1,0,0,0
"Jan 16, 2019 12:00 PM",47,25,22,,,,,,,,,,10,8,2,9,,,,16,15,1,14,7,14,4,10,19,1,1,1,1,0,0,0,0
"Jan 16, 2019 1:00 PM",70,43,27,,,,,,,,,,9,8,1,9,,,,20,13,7,27,21,11,1,10,36,2,1,8,0,8,3,2,1
"Jan 16, 2019 2:00 PM",49,31,18,,,,,,,,,,9,5,4,6,,,,24,22,2,12,25,21,11,10,19,3,3,6,1,5,4,2,2
"Jan 16, 2019 3:00 PM",58,23,35,,,,,,,,,,11,8,3,14,,,,17,15,2,15,29,13,1,12,15,2,0,4,3,1,1,1,0
"Jan 16, 2019 4:00 PM",111,28,83,,,,,,,,,,9,5,4,11,,,,52,52,0,10,56,25,5,20,22,5,3,3,0,3,0,0,0
"Jan 16, 2019 5:00 PM",249,48,201,,,,,,,,,,14,8,6,19,,,,137,134,3,34,143,43,4,39,80,6,2,1,1,0,1,1,0
"Jan 16, 2019 6:00 PM",306,43,263,,,,,,,,,,20,17,3,25,,,,183,174,9,28,166,80,8,72,43,10,1,3,1,2,0,0,0
"Jan 16, 2019 7:00 PM",145,30,115,,,,,,,,,,8,6,2,9,,,,58,58,0,11,73,24,3,21,15,2,3,2,1,1,0,0,0
"Jan 16, 2019 8:00 PM",63,3,60,,,,,,,,,,4,4,0,7,,,,39,35,4,18,36,11,1,10,16,2,1,2,0,2,0,0,0
"Jan 16, 2019 9:00 PM",54,13,41,,,,,,,,,,3,1,2,5,,,,17,17,0,7,23,8,1,7,13,6,1,1,1,0,0,0,0
"Jan 16, 2019 10:00 PM",33,7,26,,,,,,,,,,2,2,0,5,,,,15,15,0,3,12,10,1,9,8,0,0,0,0,0,0,0,0
"Jan 16, 2019 11:00 PM",6,2,4,,,,,,,,,,1,1,0,1,,,,1,1,0,2,7,2,1,1,5,0,0,0,0,0,0,0,0
"Jan 17, 2019 12:00 AM",4,2,2,,,,,,,,,,1,1,0,1,,,,6,6,0,0,2,2,1,1,1,1,0,0,0,0,0,0,0
"Jan 17, 2019 1:00 AM",1,0,1,,,,,,,,,,0,0,0,0,,,,2,1,1,1,2,0,0,0,0,0,0,0,0,0,0,0,0
"Jan 17, 2019 2:00 AM",0,0,0,,,,,,,,,,0,0,0,0,,,,1,1,0,0,1,0,0,0,0,0,0,0,0,0,0,0,0
"Jan 17, 2019 3:00 AM",1,1,0,,,,,,,,,,0,0,0,0,,,,0,0,0,0,1,0,0,0,0,0,0,0,0,0,0,0,0
"Jan 17, 2019 4:00 AM",2,2,0,,,,,,,,,,0,0,0,2,,,,0,0,0,0,0,0,0,0,2,0,0,0,0,0,0,0,0
"Jan 17, 2019 5:00 AM",4,2,2,,,,,,,,,,0,0,0,2,,,,4,4,0,4,1,0,0,0,5,3,0,0,0,0,0,0,0
"Jan 17, 2019 6:00 AM",47,36,11,,,,,,,,,,2,0,2,5,,,,2,1,1,21,10,0,0,0,37,1,2,2,1,1,0,0,0
"Jan 17, 2019 7:00 AM",185,144,41,,,,,,,,,,11,1,10,12,,,,18,11,7,104,35,23,19,4,158,3,2,3,3,0,1,0,1
"Jan 17, 2019 8:00 AM",370,303,67,,,,,,,,,,22,7,15,34,,,,43,30,13,227,55,92,71,21,325,5,11,11,10,1,1,0,1
"Jan 17, 2019 9:00 AM",165,139,26,,,,,,,,,,13,5,8,6,,,,27,20,7,85,21,37,25,12,104,6,1,3,2,1,0,0,0
"Jan 17, 2019 10:00 AM",52,42,10,,,,,,,,,,8,2,6,4,,,,9,7,2,20,17,14,8,6,30,0,1,1,0,1,1,0,1
"Jan 17, 2019 11:00 AM",42,30,12,,,,,,,,,,5,2,3,7,,,,13,7,6,11,14,7,5,2,18,1,2,2,1,1,0,0,0
"Jan 17, 2019 12:00 PM",40,23,17,,,,,,,,,,10,7,3,4,,,,9,8,1,15,13,6,2,4,21,0,1,1,0,1,1,1,0
"Jan 17, 2019 1:00 PM",62,28,34,,,,,,,,,,4,3,1,11,,,,14,13,1,13,19,11,4,7,22,1,2,2,2,0,3,0,3
"Jan 17, 2019 2:00 PM",40,17,23,,,,,,,,,,10,3,7,10,,,,17,14,3,12,18,11,1,10,18,1,1,2,1,1,0,0,0
"Jan 17, 2019 3:00 PM",69,18,51,,,,,,,,,,9,4,5,13,,,,17,13,4,17,24,20,4,16,21,0,2,5,3,2,3,1,2
"Jan 17, 2019 4:00 PM",145,38,107,,,,,,,,,,12,5,7,13,,,,58,55,3,26,50,23,1,22,28,6,3,6,1,5,3,3,0
"Jan 17, 2019 5:00 PM",261,51,210,,,,,,,,,,20,12,8,16,,,,138,135,3,29,121,48,8,40,63,4,2,3,0,3,3,3,0
"Jan 17, 2019 6:00 PM",303,43,260,,,,,,,,,,14,13,1,33,,,,163,157,6,26,185,77,9,68,43,5,2,3,0,3,1,0,1
"Jan 17, 2019 7:00 PM",136,21,115,,,,,,,,,,8,5,3,11,,,,57,54,3,14,56,31,2,29,25,4,1,1,0,1,0,0,0
"Jan 17, 2019 8:00 PM",63,15,48,,,,,,,,,,6,5,1,4,,,,35,34,1,12,34,13,4,9,8,1,2,3,2,1,1,1,0
"Jan 17, 2019 9:00 PM",47,15,32,,,,,,,,,,1,1,0,5,,,,17,17,0,12,20,6,1,5,19,2,1,6,2,4,0,0,0
"Jan 17, 2019 10:00 PM",25,8,17,,,,,,,,,,3,1,2,2,,,,15,14,1,2,15,4,1,3,5,1,0,1,1,0,0,0,0
"Jan 17, 2019 11:00 PM",16,5,11,,,,,,,,,,1,0,1,1,,,,14,14,0,0,12,0,0,0,1,0,0,0,0,0,0,0,0
"Jan 18, 2019 12:00 AM",8,1,7,,,,,,,,,,0,0,0,0,,,,5,5,0,1,7,2,0,2,5,0,0,0,0,0,0,0,0
"Jan 18, 2019 1:00 AM",3,0,3,,,,,,,,,,0,0,0,0,,,,2,2,0,0,2,0,0,0,1,0,0,0,0,0,0,0,0
"Jan 18, 2019 2:00 AM",1,0,1,,,,,,,,,,0,0,0,0,,,,2,2,0,0,1,0,0,0,0,0,0,0,0,0,0,0,0
"Jan 18, 2019 3:00 AM",1,1,0,,,,,,,,,,0,0,0,0,,,,1,1,0,0,1,0,0,0,0,0,0,0,0,0,0,0,0
"Jan 18, 2019 4:00 AM",1,1,0,,,,,,,,,,0,0,0,0,,,,2,2,0,0,1,0,0,0,1,0,0,0,0,0,0,0,0
"Jan 18, 2019 5:00 AM",6,6,0,,,,,,,,,,0,0,0,1,,,,2,1,1,5,0,0,0,0,4,1,0,0,0,0,0,0,0
"Jan 18, 2019 6:00 AM",36,29,7,,,,,,,,,,0,0,0,4,,,,2,2,0,13,4,3,3,0,36,1,1,2,0,2,0,0,0
"Jan 18, 2019 7:00 AM",111,84,27,,,,,,,,,,2,0,2,12,,,,9,6,3,70,23,10,8,2,77,1,4,0,0,0,3,0,3
"Jan 18, 2019 8:00 AM",245,196,49,,,,,,,,,,10,3,7,18,,,,21,14,7,142,41,38,31,7,172,4,5,7,6,1,0,0,0
"Jan 18, 2019 9:00 AM",100,81,19,,,,,,,,,,8,3,5,3,,,,14,9,5,50,30,22,14,8,74,5,0,4,3,1,0,0,0
"Jan 18, 2019 10:00 AM",49,38,11,,,,,,,,,,6,2,4,4,,,,10,6,4,20,12,6,3,3,16,0,0,0,0,0,0,0,0
"Jan 18, 2019 11:00 AM",28,20,8,,,,,,,,,,8,4,4,5,,,,3,2,1,10,11,5,0,5,20,1,0,3,2,1,0,0,0
"Jan 18, 2019 12:00 PM",47,19,28,,,,,,,,,,3,2,1,4,,,,12,12,0,11,14,11,1,10,17,1,3,1,1,0,1,1,0
"Jan 18, 2019 1:00 PM",72,25,47,,,,,,,,,,7,3,4,5,,,,21,17,4,11,19,15,9,6,20,2,0,2,1,1,0,0,0
"Jan 18, 2019 2:00 PM",56,29,27,,,,,,,,,,9,5,4,6,,,,19,14,5,16,19,14,0,14,19,1,1,0,0,0,0,0,0
"Jan 18, 2019 3:00 PM",67,26,41,,,,,,,,,,11,5,6,8,,,,26,23,3,16,21,15,6,9,15,5,0,3,1,2,1,1,0
"Jan 18, 2019 4:00 PM",115,25,90,,,,,,,,,,10,5,5,17,,,,40,36,4,14,55,21,11,10,40,0,2,3,2,1,1,1,0
"Jan 18, 2019 5:00 PM",212,32,180,,,,,,,,,,11,7,4,18,,,,108,101,7,17,73,37,5,32,45,5,1,4,4,0,0,0,0
"Jan 18, 2019 6:00 PM",184,29,155,,,,,,,,,,11,8,3,11,,,,83,79,4,16,99,42,2,40,38,6,3,4,3,1,0,0,0
"Jan 18, 2019 7:00 PM",79,19,60,,,,,,,,,,8,6,2,7,,,,39,37,2,12,35,23,5,18,11,0,0,1,0,1,0,0,0
"Jan 18, 2019 8:00 PM",61,23,38,,,,,,,,,,3,1,2,2,,,,20,19,1,5,22,6,1,5,8,2,1,1,0,1,0,0,0
"Jan 18, 2019 9:00 PM",35,11,24,,,,,,,,,,1,1,0,5,,,,14,13,1,6,11,2,0,2,11,2,1,1,1,0,1,1,0
"Jan 18, 2019 10:00 PM",23,4,19,,,,,,,,,,0,0,0,4,,,,7,7,0,3,5,1,0,1,16,0,0,0,0,0,0,0,0
"Jan 18, 2019 11:00 PM",15,5,10,,,,,,,,,,1,1,0,3,,,,9,8,1,0,9,5,3,2,6,1,1,2,1,1,0,0,0
"Jan 19, 2019 12:00 AM",12,0,12,,,,,,,,,,2,0,2,2,,,,5,5,0,1,5,1,1,0,6,0,0,1,0,1,0,0,0
"Jan 19, 2019 1:00 AM",11,3,8,,,,,,,,,,1,1,0,2,,,,1,1,0,1,1,2,1,1,1,0,1,0,0,0,0,0,0
"Jan 19, 2019 2:00 AM",3,0,3,,,,,,,,,,3,3,0,0,,,,1,1,0,0,1,0,0,0,0,0,2,0,0,0,0,0,0
"Jan 19, 2019 3:00 AM",5,1,4,,,,,,,,,,0,0,0,0,,,,5,5,0,1,1,0,0,0,1,0,0,0,0,0,0,0,0
"Jan 19, 2019 4:00 AM",1,1,0,,,,,,,,,,0,0,0,0,,,,0,0,0,0,4,1,0,1,0,0,0,0,0,0,0,0,0
"Jan 19, 2019 5:00 AM",5,3,2,,,,,,,,,,1,0,1,1,,,,0,0,0,0,2,0,0,0,0,0,0,0,0,0,0,0,0
"Jan 19, 2019 6:00 AM",10,6,4,,,,,,,,,,1,0,1,2,,,,4,4,0,5,0,1,0,1,10,1,1,0,0,0,0,0,0
"Jan 19, 2019 7:00 AM",17,8,9,,,,,,,,,,2,0,2,0,,,,5,5,0,4,6,3,2,1,7,0,2,1,0,1,0,0,0
"Jan 19, 2019 8:00 AM",26,17,9,,,,,,,,,,7,0,7,6,,,,3,2,1,8,13,10,7,3,14,1,0,1,1,0,0,0,0
"Jan 19, 2019 9:00 AM",48,32,16,,,,,,,,,,6,3,3,6,,,,9,8,1,17,15,17,6,11,14,3,4,3,1,2,1,0,1
"Jan 19, 2019 10:00 AM",38,23,15,,,,,,,,,,12,3,9,8,,,,13,9,4,21,12,19,9,10,22,2,5,1,1,0,2,1,1
"Jan 19, 2019 11:00 AM",42,24,18,,,,,,,,,,15,7,8,6,,,,15,11,4,14,19,19,6,13,29,4,7,4,3,1,1,0,1
"Jan 19, 2019 12:00 PM",64,33,31,,,,,,,,,,14,3,11,15,,,,17,15,2,27,26,18,9,9,32,7,3,4,2,2,1,0,1
"Jan 19, 2019 1:00 PM",64,33,31,,,,,,,,,,24,16,8,13,,,,7,5,2,18,23,22,6,16,27,6,3,3,1,2,2,0,2
"Jan 19, 2019 2:00 PM",46,23,23,,,,,,,,,,17,8,9,12,,,,18,15,3,17,19,28,9,19,19,2,6,1,1,0,0,0,0
"Jan 19, 2019 3:00 PM",55,25,30,,,,,,,,,,25,10,15,25,,,,16,11,5,17,16,33,20,13,23,0,3,4,1,3,3,3,0
"Jan 19, 2019 4:00 PM",44,20,24,,,,,,,,,,26,15,11,10,,,,19,16,3,13,13,12,7,5,20,4,0,6,3,3,2,1,1
"Jan 19, 2019 5:00 PM",31,6,25,,,,,,,,,,3,1,2,15,,,,14,11,3,8,11,15,7,8,11,1,0,5,3,2,3,3,0
"Jan 19, 2019 6:00 PM",23,8,15,,,,,,,,,,2,2,0,6,,,,8,8,0,4,9,4,3,1,14,1,0,0,0,0,0,0,0
"Jan 19, 2019 7:00 PM",20,9,11,,,,,,,,,,3,1,2,1,,,,12,10,2,7,7,9,4,5,14,0,0,0,0,0,0,0,0
"Jan 19, 2019 8:00 PM",25,8,17,,,,,,,,,,6,5,1,3,,,,8,7,1,7,5,1,1,0,5,0,0,0,0,0,0,0,0
"Jan 19, 2019 9:00 PM",14,9,5,,,,,,,,,,2,2,0,1,,,,5,3,2,6,5,1,1,0,4,1,0,4,3,1,0,0,0
"Jan 19, 2019 10:00 PM",5,0,5,,,,,,,,,,3,1,2,2,,,,5,5,0,3,5,4,1,3,4,0,0,2,1,1,0,0,0
"Jan 19, 2019 11:00 PM",5,3,2,,,,,,,,,,3,2,1,1,,,,6,5,1,5,1,3,1,2,3,0,0,0,0,0,0,0,0
"Jan 20, 2019 12:00 AM",8,3,5,,,,,,,,,,0,0,0,1,,,,3,3,0,0,2,2,1,1,7,0,0,0,0,0,0,0,0
"Jan 20, 2019 1:00 AM",5,1,4,,,,,,,,,,2,0,2,1,,,,3,3,0,3,0,1,0,1,2,0,0,0,0,0,0,0,0
"Jan 20, 2019 2:00 AM",4,0,4,,,,,,,,,,0,0,0,0,,,,3,3,0,1,1,2,0,2,0,0,2,0,0,0,0,0,0
"Jan 20, 2019 3:00 AM",1,0,1,,,,,,,,,,0,0,0,0,,,,1,1,0,0,1,0,0,0,0,0,0,0,0,0,0,0,0
"Jan 20, 2019 4:00 AM",3,1,2,,,,,,,,,,0,0,0,0,,,,1,1,0,0,2,2,0,2,0,0,0,0,0,0,0,0,0
"Jan 20, 2019 5:00 AM",1,0,1,,,,,,,,,,0,0,0,0,,,,1,1,0,0,0,0,0,0,0,0,0,0,0,0,0,0,0
"Jan 20, 2019 6:00 AM",5,3,2,,,,,,,,,,0,0,0,0,,,,4,3,1,0,4,1,1,0,5,0,0,0,0,0,0,0,0
"Jan 20, 2019 7:00 AM",8,3,5,,,,,,,,,,1,1,0,0,,,,4,2,2,2,9,1,1,0,10,1,0,1,1,0,0,0,0
"Jan 20, 2019 8:00 AM",15,6,9,,,,,,,,,,2,1,1,5,,,,1,1,0,6,13,4,1,3,15,1,10,2,0,2,0,0,0
"Jan 20, 2019 9:00 AM",24,14,10,,,,,,,,,,4,2,2,8,,,,10,7,3,12,20,3,0,3,39,3,5,1,1,0,0,0,0
"Jan 20, 2019 10:00 AM",26,12,14,,,,,,,,,,15,5,10,4,,,,5,4,1,10,26,22,9,13,77,2,7,6,2,4,2,0,2
"Jan 20, 2019 11:00 AM",41,16,25,,,,,,,,,,11,6,5,6,,,,12,10,2,15,25,26,12,14,36,6,2,2,2,0,1,1,0
"Jan 20, 2019 12:00 PM",42,26,16,,,,,,,,,,23,7,16,6,,,,12,6,6,15,24,21,4,17,33,7,4,7,3,4,0,0,0
"Jan 20, 2019 1:00 PM",43,24,19,,,,,,,,,,22,14,8,13,,,,33,32,1,13,26,24,6,18,30,10,7,1,1,0,0,0,0
"Jan 20, 2019 2:00 PM",51,30,21,,,,,,,,,,24,11,13,13,,,,21,17,4,16,15,17,7,10,20,2,0,4,2,2,0,0,0
"Jan 20, 2019 3:00 PM",37,23,14,,,,,,,,,,20,13,7,26,,,,11,9,2,11,13,34,13,21,19,4,2,1,0,1,0,0,0
"Jan 20, 2019 4:00 PM",38,14,24,,,,,,,,,,31,20,11,9,,,,10,10,0,6,10,13,7,6,11,3,2,3,2,1,0,0,0
"Jan 20, 2019 5:00 PM",48,16,32,,,,,,,,,,14,6,8,8,,,,7,7,0,8,12,10,4,6,23,3,0,4,2,2,2,1,1
"Jan 20, 2019 6:00 PM",22,10,12,,,,,,,,,,9,6,3,9,,,,10,10,0,4,13,12,6,6,7,0,1,3,2,1,1,1,0
"Jan 20, 2019 7:00 PM",26,11,15,,,,,,,,,,2,2,0,2,,,,8,6,2,4,11,1,0,1,11,1,1,2,2,0,0,0,0
"Jan 20, 2019 8:00 PM",13,7,6,,,,,,,,,,5,3,2,2,,,,7,6,1,2,7,5,3,2,7,0,0,2,0,2,0,0,0
"Jan 20, 2019 9:00 PM",17,3,14,,,,,,,,,,1,0,1,3,,,,6,6,0,6,2,3,1,2,8,0,0,1,0,1,0,0,0
"Jan 20, 2019 10:00 PM",7,2,5,,,,,,,,,,0,0,0,3,,,,8,6,2,3,3,4,4,0,8,1,1,0,0,0,0,0,0
"Jan 20, 2019 11:00 PM",12,2,10,,,,,,,,,,3,2,1,0,,,,2,2,0,2,1,0,0,0,2,0,2,0,0,0,0,0,0
"Jan 21, 2019 12:00 AM",1,0,1,,,,,,,,,,0,0,0,0,,,,1,0,1,1,4,1,1,0,1,0,0,0,0,0,0,0,0
"Jan 21, 2019 1:00 AM",2,0,2,,,,,,,,,,0,0,0,0,,,,0,0,0,0,0,0,0,0,0,1,1,1,1,0,0,0,0
"Jan 21, 2019 2:00 AM",1,0,1,,,,,,,,,,0,0,0,0,,,,0,0,0,0,2,0,0,0,0,0,0,0,0,0,0,0,0
"Jan 21, 2019 3:00 AM",0,0,0,,,,,,,,,,0,0,0,0,,,,1,1,0,0,1,1,0,1,0,0,0,0,0,0,0,0,0
"Jan 21, 2019 4:00 AM",1,1,0,,,,,,,,,,0,0,0,0,,,,2,2,0,1,0,0,0,0,1,0,0,0,0,0,0,0,0
"Jan 21, 2019 5:00 AM",6,2,4,,,,,,,,,,3,1,2,1,,,,0,0,0,4,2,0,0,0,10,1,0,0,0,0,0,0,0
"Jan 21, 2019 6:00 AM",55,42,13,,,,,,,,,,2,0,2,2,,,,5,3,2,20,7,3,3,0,46,1,0,2,1,1,0,0,0
"Jan 21, 2019 7:00 AM",186,153,33,,,,,,,,,,7,2,5,14,,,,29,21,8,122,27,19,14,5,145,4,4,6,6,0,1,0,1
"Jan 21, 2019 8:00 AM",461,393,68,,,,,,,,,,22,6,16,31,,,,46,24,22,304,53,99,80,19,319,4,4,15,10,5,3,0,3
"Jan 21, 2019 9:00 AM",238,217,21,,,,,,,,,,12,5,7,14,,,,36,16,20,159,38,32,22,10,126,4,2,8,6,2,2,1,1
"Jan 21, 2019 10:00 AM",109,89,20,,,,,,,,,,8,3,5,7,,,,20,14,6,63,12,8,4,4,45,2,2,6,3,3,0,0,0
"Jan 21, 2019 11:00 AM",81,62,19,,,,,,,,,,8,2,6,5,,,,12,11,1,39,9,6,2,4,21,2,1,3,2,1,0,0,0
"Jan 21, 2019 12:00 PM",65,35,30,,,,,,,,,,8,5,3,6,,,,18,17,1,29,16,10,3,7,22,3,2,2,1,1,1,0,1
"Jan 21, 2019 1:00 PM",112,50,62,,,,,,,,,,7,5,2,5,,,,34,32,2,22,17,11,3,8,19,2,2,4,1,3,0,0,0
"Jan 21, 2019 2:00 PM",96,36,60,,,,,,,,,,11,4,7,8,,,,41,40,1,19,18,5,1,4,21,1,1,5,3,2,0,0,0
"Jan 21, 2019 3:00 PM",128,23,105,,,,,,,,,,8,5,3,12,,,,51,50,1,14,27,16,2,14,21,1,0,5,5,0,2,1,1
"Jan 21, 2019 4:00 PM",163,28,135,,,,,,,,,,6,4,2,6,,,,88,83,5,14,52,22,3,19,31,4,0,8,4,4,3,2,1
"Jan 21, 2019 5:00 PM",290,43,247,,,,,,,,,,7,6,1,17,,,,158,155,3,24,134,63,10,53,57,6,1,1,1,0,0,0,0
"Jan 21, 2019 6:00 PM",296,38,258,,,,,,,,,,11,11,0,22,,,,190,185,5,26,183,70,4,66,41,6,0,2,1,1,0,0,0
"Jan 21, 2019 7:00 PM",137,31,106,,,,,,,,,,7,7,0,4,,,,92,92,0,12,79,31,1,30,18,1,1,3,2,1,1,1,0
"Jan 21, 2019 8:00 PM",71,14,57,,,,,,,,,,3,1,2,6,,,,40,39,1,9,31,9,0,9,7,1,1,2,1,1,1,1,0
"Jan 21, 2019 9:00 PM",57,7,50,,,,,,,,,,1,1,0,4,,,,17,17,0,12,14,9,0,9,18,2,0,2,0,2,0,0,0
"Jan 21, 2019 10:00 PM",29,7,22,,,,,,,,,,0,0,0,2,,,,10,9,1,3,5,2,2,0,9,0,0,1,1,0,0,0,0
"Jan 21, 2019 11:00 PM",8,4,4,,,,,,,,,,1,0,1,0,,,,11,11,0,3,6,1,0,1,1,0,1,0,0,0,0,0,0
"Jan 22, 2019 12:00 AM",4,1,3,,,,,,,,,,1,1,0,1,,,,2,2,0,1,1,0,0,0,2,0,0,0,0,0,1,1,0
"Jan 22, 2019 1:00 AM",1,0,1,,,,,,,,,,0,0,0,0,,,,1,1,0,1,6,0,0,0,1,0,0,0,0,0,1,1,0
"Jan 22, 2019 2:00 AM",3,0,3,,,,,,,,,,0,0,0,0,,,,0,0,0,0,1,1,0,1,1,0,0,0,0,0,0,0,0
"Jan 22, 2019 3:00 AM",4,3,1,,,,,,,,,,0,0,0,0,,,,0,0,0,0,0,0,0,0,0,0,0,0,0,0,0,0,0
"Jan 22, 2019 4:00 AM",0,0,0,,,,,,,,,,0,0,0,0,,,,0,0,0,0,0,0,0,0,2,0,0,0,0,0,0,0,0
"Jan 22, 2019 5:00 AM",6,3,3,,,,,,,,,,1,0,1,1,,,,1,1,0,3,4,0,0,0,8,1,0,0,0,0,0,0,0
"Jan 22, 2019 6:00 AM",41,35,6,,,,,,,,,,1,0,1,4,,,,6,4,2,25,10,1,1,0,53,0,0,2,0,2,0,0,0
"Jan 22, 2019 7:00 AM",205,166,39,,,,,,,,,,7,1,6,14,,,,24,14,10,129,33,19,13,6,146,1,3,3,3,0,2,0,2
"Jan 22, 2019 8:00 AM",440,380,60,,,,,,,,,,17,3,14,27,,,,49,24,25,283,52,79,61,18,327,5,2,12,9,3,1,0,1
"Jan 22, 2019 9:00 AM",211,189,22,,,,,,,,,,9,4,5,11,,,,26,14,12,139,29,44,33,11,105,0,2,3,2,1,1,0,1
"Jan 22, 2019 10:00 AM",87,61,26,,,,,,,,,,5,1,4,4,,,,18,15,3,62,10,10,5,5,27,1,3,3,2,1,1,1,0
"Jan 22, 2019 11:00 AM",59,38,21,,,,,,,,,,5,4,1,7,,,,15,13,2,41,11,9,3,6,16,2,0,0,0,0,0,0,0
"Jan 22, 2019 12:00 PM",66,32,34,,,,,,,,,,8,3,5,9,,,,30,28,2,12,10,8,4,4,22,3,1,3,1,2,0,0,0
"Jan 22, 2019 1:00 PM",93,48,45,,,,,,,,,,4,3,1,5,,,,31,26,5,21,24,11,2,9,17,3,3,4,1,3,0,0,0
"Jan 22, 2019 2:00 PM",77,33,44,,,,,,,,,,7,4,3,9,,,,25,24,1,15,25,19,7,12,13,4,2,1,0,1,2,1,1
"Jan 22, 2019 3:00 PM",97,20,77,,,,,,,,,,2,1,1,5,,,,48,46,2,14,34,10,4,6,25,4,0,6,3,3,2,2,0
"Jan 22, 2019 4:00 PM",147,35,112,,,,,,,,,,6,4,2,21,,,,79,76,3,26,55,20,7,13,29,3,1,3,0,3,2,2,0
"Jan 22, 2019 5:00 PM",325,59,266,,,,,,,,,,14,10,4,19,,,,175,173,2,31,137,59,2,57,78,3,0,0,0,0,0,0,0
"Jan 22, 2019 6:00 PM",326,51,275,,,,,,,,,,16,14,2,27,,,,188,184,4,34,173,65,5,60,43,4,1,6,4,2,0,0,0
"Jan 22, 2019 7:00 PM",181,34,147,,,,,,,,,,8,5,3,11,,,,90,87,3,26,67,42,8,34,19,7,1,2,2,0,1,0,1
"Jan 22, 2019 8:00 PM",119,17,102,,,,,,,,,,4,3,1,10,,,,50,49,1,16,28,16,3,13,10,3,1,1,1,0,2,2,0
"Jan 22, 2019 9:00 PM",51,7,44,,,,,,,,,,6,2,4,7,,,,32,32,0,10,25,10,0,10,15,1,0,1,1,0,1,1,0
"Jan 22, 2019 10:00 PM",37,7,30,,,,,,,,,,2,2,0,4,,,,18,17,1,4,14,3,2,1,9,2,2,0,0,0,0,0,0
"Jan 22, 2019 11:00 PM",22,3,19,,,,,,,,,,0,0,0,0,,,,7,7,0,1,3,6,2,4,2,0,0,0,0,0,1,1,0
"Jan 23, 2019 12:00 AM",8,2,6,,,,,,,,,,2,2,0,0,,,,6,5,1,1,1,0,0,0,4,1,1,0,0,0,0,0,0
"Jan 23, 2019 1:00 AM",4,1,3,,,,,,,,,,2,0,2,1,,,,2,1,1,2,2,0,0,0,0,0,0,0,0,0,1,1,0
"Jan 23, 2019 2:00 AM",1,0,1,,,,,,,,,,0,0,0,0,,,,1,1,0,0,2,0,0,0,0,0,0,0,0,0,0,0,0
"Jan 23, 2019 3:00 AM",2,1,1,,,,,,,,,,0,0,0,0,,,,0,0,0,0,0,0,0,0,0,0,0,0,0,0,0,0,0
"Jan 23, 2019 4:00 AM",1,1,0,,,,,,,,,,0,0,0,0,,,,3,3,0,0,0,0,0,0,1,0,0,0,0,0,0,0,0
"Jan 23, 2019 5:00 AM",4,3,1,,,,,,,,,,1,0,1,2,,,,1,0,1,5,0,0,0,0,6,1,0,0,0,0,0,0,0
"Jan 23, 2019 6:00 AM",48,39,9,,,,,,,,,,0,0,0,6,,,,6,4,2,21,7,0,0,0,38,1,0,2,0,2,0,0,0
"Jan 23, 2019 7:00 AM",206,166,40,,,,,,,,,,9,1,8,14,,,,29,17,12,120,25,21,15,6,158,1,5,2,2,0,0,0,0
"Jan 23, 2019 8:00 AM",419,351,68,,,,,,,,,,13,2,11,28,,,,51,26,25,278,62,85,72,13,322,3,4,15,10,5,1,1,0
"Jan 23, 2019 9:00 AM",206,177,29,,,,,,,,,,13,3,10,11,,,,24,12,12,147,32,40,29,11,125,6,0,3,2,1,0,0,0
"Jan 23, 2019 10:00 AM",122,95,27,,,,,,,,,,9,3,6,3,,,,17,10,7,62,11,11,6,5,34,1,4,4,1,3,0,0,0
"Jan 23, 2019 11:00 AM",51,37,14,,,,,,,,,,9,5,4,3,,,,16,12,4,42,12,8,2,6,16,2,2,4,2,2,0,0,0
"Jan 23, 2019 12:00 PM",81,47,34,,,,,,,,,,8,6,2,2,,,,26,24,2,36,17,11,1,10,32,2,0,4,3,1,1,1,0
"Jan 23, 2019 1:00 PM",100,37,63,,,,,,,,,,4,1,3,14,,,,35,32,3,32,16,14,6,8,29,4,2,5,1,4,1,1,0
"Jan 23, 2019 2:00 PM",88,49,39,,,,,,,,,,7,5,2,15,,,,49,44,5,21,25,12,3,9,15,4,2,3,0,3,2,2,0
"Jan 23, 2019 3:00 PM",124,35,89,,,,,,,,,,6,1,5,6,,,,49,46,3,14,24,20,5,15,22,3,1,4,2,2,0,0,0
"Jan 23, 2019 4:00 PM",160,31,129,,,,,,,,,,12,7,5,6,,,,80,78,2,13,53,31,8,23,30,2,0,7,3,4,1,1,0
"Jan 23, 2019 5:00 PM",318,60,258,,,,,,,,,,13,11,2,20,,,,180,178,2,26,129,53,10,43,63,5,4,4,3,1,0,0,0
"Jan 23, 2019 6:00 PM",293,56,237,,,,,,,,,,12,12,0,22,,,,191,187,4,32,178,73,3,70,45,8,1,2,1,1,0,0,0
"Jan 23, 2019 7:00 PM",167,32,135,,,,,,,,,,8,6,2,14,,,,77,76,1,15,73,47,6,41,19,2,2,0,0,0,3,1,2
"Jan 23, 2019 8:00 PM",96,19,77,,,,,,,,,,2,2,0,11,,,,51,46,5,19,39,9,2,7,17,0,3,0,0,0,1,1,0
"Jan 23, 2019 9:00 PM",61,11,50,,,,,,,,,,3,3,0,2,,,,32,32,0,11,21,7,0,7,13,3,2,1,1,0,0,0,0
"Jan 23, 2019 10:00 PM",41,7,34,,,,,,,,,,2,1,1,1,,,,18,16,2,5,14,5,1,4,12,2,0,0,0,0,0,0,0
"Jan 23, 2019 11:00 PM",14,0,14,,,,,,,,,,1,0,1,0,,,,11,10,1,3,4,2,1,1,1,0,0,0,0,0,0,0,0
"Jan 24, 2019 12:00 AM",10,4,6,,,,,,,,,,0,0,0,0,,,,7,7,0,1,5,1,0,1,4,0,1,0,0,0,0,0,0
"Jan 24, 2019 1:00 AM",3,0,3,,,,,,,,,,0,0,0,0,,,,2,2,0,2,0,0,0,0,0,0,0,0,0,0,1,1,0
"Jan 24, 2019 2:00 AM",0,0,0,,,,,,,,,,0,0,0,0,,,,1,1,0,0,1,0,0,0,0,1,0,0,0,0,0,0,0
"Jan 24, 2019 3:00 AM",1,1,0,,,,,,,,,,0,0,0,0,,,,1,1,0,0,2,0,0,0,1,0,0,0,0,0,0,0,0
"Jan 24, 2019 4:00 AM",0,0,0,,,,,,,,,,0,0,0,0,,,,0,0,0,0,0,1,0,1,2,0,0,0,0,0,0,0,0
"Jan 24, 2019 5:00 AM",2,2,0,,,,,,,,,,1,0,1,1,,,,0,0,0,5,3,0,0,0,7,0,0,0,0,0,0,0,0
"Jan 24, 2019 6:00 AM",54,45,9,,,,,,,,,,1,0,1,4,,,,11,9,2,19,9,3,3,0,34,2,0,2,1,1,0,0,0
"Jan 24, 2019 7:00 AM",198,164,34,,,,,,,,,,5,0,5,10,,,,17,10,7,106,23,13,10,3,119,1,3,1,1,0,1,0,1
"Jan 24, 2019 8:00 AM",386,332,54,,,,,,,,,,18,3,15,28,,,,35,20,15,255,50,67,57,10,286,3,3,14,12,2,1,0,1
"Jan 24, 2019 9:00 AM",169,146,23,,,,,,,,,,7,2,5,10,,,,17,9,8,110,26,32,23,9,103,2,1,3,2,1,0,0,0
"Jan 24, 2019 10:00 AM",96,77,19,,,,,,,,,,4,0,4,3,,,,15,8,7,49,8,3,2,1,18,1,0,1,1,0,0,0,0
"Jan 24, 2019 11:00 AM",59,40,19,,,,,,,,,,3,2,1,4,,,,12,7,5,30,9,4,2,2,17,0,2,2,2,0,0,0,0
"Jan 24, 2019 12:00 PM",56,29,27,,,,,,,,,,7,1,6,0,,,,26,24,2,21,5,6,3,3,7,0,0,0,0,0,0,0,0
"Jan 24, 2019 1:00 PM",80,28,52,,,,,,,,,,4,3,1,5,,,,21,19,2,12,12,6,2,4,12,0,1,0,0,0,0,0,0
"Jan 24, 2019 2:00 PM",74,28,46,,,,,,,,,,8,7,1,3,,,,40,37,3,12,23,7,0,7,7,0,0,0,0,0,0,0,0
"Jan 24, 2019 3:00 PM",96,24,72,,,,,,,,,,7,4,3,6,,,,41,38,3,18,23,9,1,8,28,3,2,5,3,2,0,0,0
"Jan 24, 2019 4:00 PM",158,30,128,,,,,,,,,,10,4,6,10,,,,77,70,7,16,52,21,4,17,30,5,3,8,5,3,0,0,0
"Jan 24, 2019 5:00 PM",285,53,232,,,,,,,,,,15,9,6,22,,,,139,135,4,26,102,38,5,33,54,3,1,5,3,2,1,1,0
"Jan 24, 2019 6:00 PM",311,54,257,,,,,,,,,,11,9,2,24,,,,155,152,3,34,143,60,6,54,37,5,1,2,1,1,0,0,0
"Jan 24, 2019 7:00 PM",154,26,128,,,,,,,,,,4,4,0,8,,,,87,82,5,12,61,25,2,23,15,6,3,3,2,1,0,0,0
"Jan 24, 2019 8:00 PM",98,28,70,,,,,,,,,,8,6,2,6,,,,39,37,2,11,27,10,2,8,11,2,2,3,2,1,0,0,0
"Jan 24, 2019 9:00 PM",72,17,55,,,,,,,,,,1,1,0,5,,,,24,24,0,12,12,5,0,5,15,0,1,1,0,1,0,0,0
"Jan 24, 2019 10:00 PM",34,12,22,,,,,,,,,,1,0,1,3,,,,19,18,1,2,13,2,0,2,12,0,0,1,0,1,0,0,0
"Jan 24, 2019 11:00 PM",14,3,11,,,,,,,,,,2,2,0,3,,,,12,12,0,2,1,3,1,2,2,0,1,0,0,0,0,0,0
"Jan 25, 2019 12:00 AM",7,0,7,,,,,,,,,,2,1,1,1,,,,2,2,0,6,4,1,0,1,4,2,1,0,0,0,0,0,0
"Jan 25, 2019 1:00 AM",5,0,5,,,,,,,,,,0,0,0,1,,,,8,8,0,2,3,0,0,0,2,0,0,0,0,0,0,0,0
"Jan 25, 2019 2:00 AM",2,0,2,,,,,,,,,,0,0,0,0,,,,1,1,0,0,4,0,0,0,0,0,0,1,0,1,2,1,1
"Jan 25, 2019 3:00 AM",4,1,3,,,,,,,,,,0,0,0,0,,,,2,2,0,0,1,0,0,0,0,0,0,0,0,0,0,0,0
"Jan 25, 2019 4:00 AM",1,0,1,,,,,,,,,,0,0,0,0,,,,1,1,0,0,0,0,0,0,2,0,0,0,0,0,0,0,0
"Jan 25, 2019 5:00 AM",8,7,1,,,,,,,,,,1,1,0,1,,,,1,1,0,6,3,0,0,0,9,1,0,0,0,0,0,0,0
"Jan 25, 2019 6:00 AM",45,35,10,,,,,,,,,,3,0,3,3,,,,4,4,0,19,7,2,2,0,38,1,0,1,0,1,0,0,0
"Jan 25, 2019 7:00 AM",166,137,29,,,,,,,,,,6,1,5,14,,,,22,13,9,99,20,17,14,3,112,1,3,3,3,0,0,0,0
"Jan 25, 2019 8:00 AM",330,280,50,,,,,,,,,,21,5,16,31,,,,37,23,14,203,49,56,46,10,265,6,7,11,9,2,2,0,2
"Jan 25, 2019 9:00 AM",183,160,23,,,,,,,,,,8,4,4,2,,,,25,11,14,108,33,35,24,11,103,4,5,3,1,2,2,0,2
"Jan 25, 2019 10:00 AM",84,61,23,,,,,,,,,,10,3,7,8,,,,19,12,7,52,13,12,5,7,29,2,4,2,2,0,1,1,0
"Jan 25, 2019 11:00 AM",57,35,22,,,,,,,,,,10,5,5,4,,,,13,9,4,25,10,11,4,7,26,2,3,2,2,0,0,0,0
"Jan 25, 2019 12:00 PM",103,49,54,,,,,,,,,,8,4,4,2,,,,30,27,3,23,16,12,6,6,18,1,3,1,1,0,0,0,0
"Jan 25, 2019 1:00 PM",115,42,73,,,,,,,,,,4,2,2,9,,,,34,28,6,26,21,19,4,15,25,1,1,4,2,2,0,0,0
"Jan 25, 2019 2:00 PM",80,30,50,,,,,,,,,,13,8,5,6,,,,28,26,2,20,23,15,5,10,16,2,2,4,3,1,0,0,0
"Jan 25, 2019 3:00 PM",112,29,83,,,,,,,,,,9,6,3,12,,,,43,41,2,19,34,16,4,12,27,4,5,5,2,3,1,1,0
"Jan 25, 2019 4:00 PM",172,35,137,,,,,,,,,,9,6,3,15,,,,74,72,2,17,67,21,5,16,41,3,3,10,7,3,0,0,0
"Jan 25, 2019 5:00 PM",253,40,213,,,,,,,,,,17,11,6,17,,,,143,141,2,38,118,45,7,38,47,8,3,9,5,4,6,3,3
"Jan 25, 2019 6:00 PM",196,48,148,,,,,,,,,,15,14,1,17,,,,130,121,9,22,104,63,8,55,30,3,4,12,9,3,1,0,1
"Jan 25, 2019 7:00 PM",104,29,75,,,,,,,,,,3,2,1,4,,,,48,45,3,14,54,29,1,28,18,5,1,3,1,2,1,1,0
"Jan 25, 2019 8:00 PM",55,16,39,,,,,,,,,,2,2,0,4,,,,18,16,2,12,15,7,1,6,8,1,1,3,2,1,0,0,0
"Jan 25, 2019 9:00 PM",31,9,22,,,,,,,,,,1,1,0,6,,,,20,19,1,5,17,4,0,4,9,0,1,1,0,1,0,0,0
"Jan 25, 2019 10:00 PM",33,7,26,,,,,,,,,,1,1,0,3,,,,15,15,0,3,13,4,2,2,8,0,1,0,0,0,0,0,0
"Jan 25, 2019 11:00 PM",22,2,20,,,,,,,,,,1,0,1,1,,,,12,11,1,4,13,4,1,3,4,0,0,0,0,0,0,0,0
"Jan 26, 2019 12:00 AM",15,2,13,,,,,,,,,,5,1,4,0,,,,7,7,0,0,7,3,0,3,7,1,0,1,0,1,0,0,0
"Jan 26, 2019 1:00 AM",5,1,4,,,,,,,,,,2,0,2,0,,,,4,4,0,1,4,2,1,1,3,0,0,0,0,0,0,0,0
"Jan 26, 2019 2:00 AM",2,0,2,,,,,,,,,,1,1,0,0,,,,2,2,0,1,0,0,0,0,3,1,1,0,0,0,0,0,0
"Jan 26, 2019 3:00 AM",4,1,3,,,,,,,,,,0,0,0,0,,,,1,1,0,5,0,0,0,0,0,0,0,3,0,3,0,0,0
"Jan 26, 2019 4:00 AM",1,1,0,,,,,,,,,,0,0,0,1,,,,0,0,0,0,2,0,0,0,1,0,0,0,0,0,0,0,0
"Jan 26, 2019 5:00 AM",2,0,2,,,,,,,,,,0,0,0,1,,,,1,1,0,1,4,0,0,0,1,0,0,0,0,0,0,0,0
"Jan 26, 2019 6:00 AM",14,9,5,,,,,,,,,,1,0,1,1,,,,2,2,0,3,3,1,0,1,15,1,0,0,0,0,0,0,0
"Jan 26, 2019 7:00 AM",14,8,6,,,,,,,,,,1,0,1,1,,,,6,6,0,5,7,0,0,0,5,0,0,0,0,0,0,0,0
"Jan 26, 2019 8:00 AM",22,14,8,,,,,,,,,,2,0,2,1,,,,7,6,1,8,5,9,2,7,9,2,3,1,0,1,1,0,1
"Jan 26, 2019 9:00 AM",37,22,15,,,,,,,,,,5,1,4,7,,,,13,9,4,22,15,12,5,7,16,2,9,1,0,1,0,0,0
"Jan 26, 2019 10:00 AM",50,33,17,,,,,,,,,,10,6,4,6,,,,8,5,3,19,13,16,11,5,27,1,4,4,1,3,1,1,0
"Jan 26, 2019 11:00 AM",56,25,31,,,,,,,,,,11,6,5,11,,,,12,8,4,14,19,17,9,8,24,3,0,3,2,1,0,0,0
"Jan 26, 2019 12:00 PM",48,22,26,,,,,,,,,,9,6,3,11,,,,11,7,4,9,15,4,3,1,15,4,1,3,2,1,0,0,0
"Jan 26, 2019 1:00 PM",41,23,18,,,,,,,,,,10,8,2,2,,,,13,9,4,8,6,13,2,11,6,4,1,1,1,0,3,3,0
"Jan 26, 2019 2:00 PM",32,18,14,,,,,,,,,,20,10,10,14,,,,15,13,2,10,11,14,5,9,12,4,2,1,1,0,2,1,1
"Jan 26, 2019 3:00 PM",42,20,22,,,,,,,,,,18,8,10,15,,,,16,13,3,13,11,13,4,9,23,1,3,1,1,0,0,0,0
"Jan 26, 2019 4:00 PM",54,19,35,,,,,,,,,,15,6,9,8,,,,16,15,1,13,13,17,7,10,12,2,0,15,11,4,1,1,0
"Jan 26, 2019 5:00 PM",50,19,31,,,,,,,,,,7,5,2,4,,,,14,13,1,6,9,8,4,4,13,7,3,10,3,7,6,3,3
"Jan 26, 2019 6:00 PM",29,8,21,,,,,,,,,,7,7,0,10,,,,17,15,2,6,10,6,1,5,5,1,1,1,0,1,0,0,0
"Jan 26, 2019 7:00 PM",20,10,10,,,,,,,,,,12,8,4,0,,,,8,5,3,2,5,4,2,2,3,0,2,0,0,0,0,0,0
"Jan 26, 2019 8:00 PM",16,7,9,,,,,,,,,,6,3,3,1,,,,5,5,0,4,4,4,1,3,5,1,1,0,0,0,0,0,0
"Jan 26, 2019 9:00 PM",8,2,6,,,,,,,,,,0,0,0,0,,,,6,5,1,5,6,1,0,1,10,1,0,1,1,0,0,0,0
"Jan 26, 2019 10:00 PM",6,2,4,,,,,,,,,,0,0,0,1,,,,3,3,0,3,1,0,0,0,3,0,1,2,1,1,0,0,0
"Jan 26, 2019 11:00 PM",9,4,5,,,,,,,,,,2,1,1,1,,,,2,2,0,3,3,1,1,0,3,1,0,1,1,0,0,0,0
"Jan 27, 2019 12:00 AM",5,0,5,,,,,,,,,,1,0,1,2,,,,2,2,0,1,1,2,1,1,5,0,0,0,0,0,0,0,0
"Jan 27, 2019 1:00 AM",3,0,3,,,,,,,,,,0,0,0,0,,,,3,3,0,3,3,0,0,0,1,2,1,0,0,0,0,0,0
"Jan 27, 2019 2:00 AM",2,0,2,,,,,,,,,,3,0,3,0,,,,1,1,0,1,2,0,0,0,1,0,2,0,0,0,0,0,0
"Jan 27, 2019 3:00 AM",0,0,0,,,,,,,,,,1,1,0,1,,,,0,0,0,0,2,1,0,1,0,0,0,0,0,0,0,0,0
"Jan 27, 2019 4:00 AM",2,0,2,,,,,,,,,,0,0,0,0,,,,1,1,0,0,2,0,0,0,3,0,0,0,0,0,0,0,0
"Jan 27, 2019 5:00 AM",3,1,2,,,,,,,,,,0,0,0,0,,,,0,0,0,0,1,0,0,0,1,0,0,1,1,0,0,0,0
"Jan 27, 2019 6:00 AM",7,6,1,,,,,,,,,,1,0,1,1,,,,3,3,0,1,4,0,0,0,7,0,0,0,0,0,0,0,0
"Jan 27, 2019 7:00 AM",10,5,5,,,,,,,,,,0,0,0,2,,,,2,2,0,3,15,1,0,1,12,0,1,0,0,0,0,0,0
"Jan 27, 2019 8:00 AM",18,8,10,,,,,,,,,,1,0,1,2,,,,5,5,0,6,8,0,0,0,8,3,2,2,2,0,0,0,0
"Jan 27, 2019 9:00 AM",22,18,4,,,,,,,,,,5,2,3,7,,,,6,3,3,9,9,17,13,4,14,2,10,0,0,0,0,0,0
"Jan 27, 2019 10:00 AM",34,20,14,,,,,,,,,,14,8,6,8,,,,10,8,2,38,12,20,10,10,71,9,6,0,0,0,1,0,1
"Jan 27, 2019 11:00 AM",54,25,29,,,,,,,,,,25,15,10,25,,,,16,9,7,15,24,27,9,18,38,4,4,1,1,0,0,0,0
"Jan 27, 2019 12:00 PM",46,28,18,,,,,,,,,,39,16,23,14,,,,21,17,4,11,22,24,7,17,26,5,2,2,0,2,0,0,0
"Jan 27, 2019 1:00 PM",47,29,18,,,,,,,,,,19,11,8,34,,,,14,12,2,11,32,26,8,18,25,4,1,5,1,4,1,1,0
"Jan 27, 2019 2:00 PM",41,18,23,,,,,,,,,,22,14,8,10,,,,18,13,5,11,19,21,8,13,15,4,1,4,1,3,0,0,0
"Jan 27, 2019 3:00 PM",30,13,17,,,,,,,,,,7,5,2,6,,,,15,11,4,10,15,12,6,6,17,2,1,0,0,0,1,1,0
"Jan 27, 2019 4:00 PM",44,19,25,,,,,,,,,,9,8,1,22,,,,18,15,3,5,12,13,5,8,13,2,2,3,0,3,1,1,0
"Jan 27, 2019 5:00 PM",44,13,31,,,,,,,,,,6,2,4,9,,,,10,10,0,15,7,9,6,3,23,1,0,4,2,2,0,0,0
"Jan 27, 2019 6:00 PM",36,13,23,,,,,,,,,,2,1,1,7,,,,7,6,1,8,11,3,0,3,16,1,0,3,3,0,1,1,0
"Jan 27, 2019 7:00 PM",29,13,16,,,,,,,,,,4,4,0,1,,,,3,3,0,7,7,5,0,5,7,0,0,1,1,0,0,0,0
"Jan 27, 2019 8:00 PM",16,8,8,,,,,,,,,,0,0,0,4,,,,11,9,2,6,8,3,2,1,7,0,0,2,1,1,1,1,0
"Jan 27, 2019 9:00 PM",17,3,14,,,,,,,,,,1,0,1,4,,,,6,6,0,3,7,1,1,0,11,1,0,0,0,0,1,0,1
"Jan 27, 2019 10:00 PM",6,1,5,,,,,,,,,,0,0,0,2,,,,5,2,3,2,2,1,1,0,3,0,1,1,1,0,0,0,0
"Jan 27, 2019 11:00 PM",8,4,4,,,,,,,,,,2,0,2,0,,,,2,2,0,0,1,1,1,0,3,0,1,0,0,0,0,0,0
"Jan 28, 2019 12:00 AM",3,1,2,,,,,,,,,,0,0,0,0,,,,2,2,0,1,1,2,0,2,1,0,1,0,0,0,0,0,0
"Jan 28, 2019 1:00 AM",2,1,1,,,,,,,,,,0,0,0,0,,,,3,3,0,1,2,0,0,0,0,0,1,0,0,0,0,0,0
"Jan 28, 2019 2:00 AM",1,0,1,,,,,,,,,,0,0,0,0,,,,0,0,0,0,0,0,0,0,1,0,0,0,0,0,0,0,0
"Jan 28, 2019 3:00 AM",1,0,1,,,,,,,,,,0,0,0,0,,,,1,1,0,2,1,1,0,1,3,0,0,0,0,0,0,0,0
"Jan 28, 2019 4:00 AM",1,1,0,,,,,,,,,,0,0,0,0,,,,0,0,0,2,0,0,0,0,0,0,0,1,0,1,0,0,0
"Jan 28, 2019 5:00 AM",2,2,0,,,,,,,,,,0,0,0,0,,,,3,3,0,6,2,0,0,0,8,0,0,0,0,0,0,0,0
"Jan 28, 2019 6:00 AM",55,42,13,,,,,,,,,,3,1,2,4,,,,2,1,1,19,5,2,2,0,47,1,0,1,0,1,0,0,0
"Jan 28, 2019 7:00 AM",183,149,34,,,,,,,,,,4,0,4,12,,,,36,26,10,129,27,18,13,5,158,1,6,3,3,0,3,0,3
"Jan 28, 2019 8:00 AM",408,343,65,,,,,,,,,,26,8,18,37,,,,40,22,18,289,51,95,73,22,332,5,4,15,12,3,2,1,1
"Jan 28, 2019 9:00 AM",254,225,29,,,,,,,,,,14,3,11,17,,,,31,14,17,129,24,42,32,10,111,2,3,4,1,3,1,0,1
"Jan 28, 2019 10:00 AM",91,75,16,,,,,,,,,,8,1,7,8,,,,17,10,7,65,16,10,6,4,23,2,0,3,1,2,0,0,0
"Jan 28, 2019 11:00 AM",65,49,16,,,,,,,,,,12,5,7,16,,,,19,12,7,37,8,10,5,5,29,2,0,1,1,0,1,1,0
"Jan 28, 2019 12:00 PM",78,37,41,,,,,,,,,,10,6,4,1,,,,23,18,5,32,12,11,4,7,20,1,2,4,4,0,0,0,0
"Jan 28, 2019 1:00 PM",90,40,50,,,,,,,,,,20,8,12,6,,,,29,23,6,26,19,14,3,11,25,1,0,1,0,1,1,0,1
"Jan 28, 2019 2:00 PM",80,39,41,,,,,,,,,,10,5,5,7,,,,34,32,2,20,19,15,7,8,18,1,0,2,1,1,4,1,3
"Jan 28, 2019 3:00 PM",107,21,86,,,,,,,,,,8,5,3,13,,,,42,42,0,16,26,19,8,11,19,1,4,9,4,5,1,1,0
"Jan 28, 2019 4:00 PM",161,45,116,,,,,,,,,,8,6,2,18,,,,92,88,4,22,60,37,5,32,25,0,4,4,2,2,1,1,0
"Jan 28, 2019 5:00 PM",330,52,278,,,,,,,,,,11,8,3,19,,,,174,167,7,32,126,58,7,51,64,4,1,2,0,2,2,2,0
"Jan 28, 2019 6:00 PM",333,57,276,,,,,,,,,,17,15,2,21,,,,213,208,5,24,196,77,6,71,36,5,0,3,1,2,1,1,0
"Jan 28, 2019 7:00 PM",168,36,132,,,,,,,,,,3,3,0,8,,,,84,84,0,9,86,36,1,35,27,7,3,2,2,0,2,1,1
"Jan 28, 2019 8:00 PM",108,30,78,,,,,,,,,,4,4,0,9,,,,41,38,3,14,35,14,3,11,15,1,0,4,2,2,1,1,0
"Jan 28, 2019 9:00 PM",60,6,54,,,,,,,,,,1,1,0,3,,,,28,28,0,8,16,7,2,5,19,3,0,0,0,0,1,1,0
"Jan 28, 2019 10:00 PM",52,10,42,,,,,,,,,,1,0,1,0,,,,10,10,0,3,17,0,0,0,7,0,0,1,0,1,0,0,0
"Jan 28, 2019 11:00 PM",14,2,12,,,,,,,,,,0,0,0,0,,,,7,7,0,5,5,2,0,2,1,0,0,1,1,0,0,0,0
"Jan 29, 2019 12:00 AM",6,1,5,,,,,,,,,,0,0,0,0,,,,3,3,0,0,1,0,0,0,2,0,0,0,0,0,1,1,0
"Jan 29, 2019 1:00 AM",4,3,1,,,,,,,,,,0,0,0,0,,,,1,1,0,0,1,0,0,0,0,0,1,0,0,0,0,0,0
"Jan 29, 2019 2:00 AM",2,2,0,,,,,,,,,,0,0,0,0,,,,0,0,0,0,1,1,0,1,0,0,0,0,0,0,0,0,0
"Jan 29, 2019 3:00 AM",1,1,0,,,,,,,,,,0,0,0,0,,,,0,0,0,0,0,0,0,0,0,0,0,0,0,0,0,0,0
"Jan 29, 2019 4:00 AM",3,1,2,,,,,,,,,,0,0,0,0,,,,2,1,1,1,0,1,1,0,0,0,0,0,0,0,0,0,0
"Jan 29, 2019 5:00 AM",3,2,1,,,,,,,,,,0,0,0,1,,,,1,1,0,7,2,0,0,0,10,1,0,0,0,0,0,0,0
"Jan 29, 2019 6:00 AM",43,31,12,,,,,,,,,,2,0,2,4,,,,3,1,2,21,6,1,1,0,53,1,0,1,0,1,0,0,0
"Jan 29, 2019 7:00 AM",185,147,38,,,,,,,,,,4,0,4,14,,,,23,15,8,121,28,20,14,6,169,0,1,2,2,0,3,0,3
"Jan 29, 2019 8:00 AM",383,327,56,,,,,,,,,,9,0,9,28,,,,38,22,16,247,33,62,52,10,302,6,4,5,4,1,1,0,1
"Jan 29, 2019 9:00 AM",195,177,18,,,,,,,,,,10,1,9,9,,,,17,8,9,112,21,30,26,4,99,1,0,2,1,1,0,0,0
"Jan 29, 2019 10:00 AM",76,62,14,,,,,,,,,,6,1,5,5,,,,12,5,7,44,10,8,7,1,21,2,0,0,0,0,0,0,0
"Jan 29, 2019 11:00 AM",48,41,7,,,,,,,,,,1,0,1,10,,,,10,8,2,25,6,6,1,5,21,0,0,0,0,0,0,0,0
"Jan 29, 2019 12:00 PM",75,40,35,,,,,,,,,,4,3,1,3,,,,22,18,4,20,6,2,1,1,11,1,1,1,1,0,1,1,0
"Jan 29, 2019 1:00 PM",80,35,45,,,,,,,,,,8,5,3,5,,,,18,13,5,20,9,10,5,5,18,1,0,1,0,1,0,0,0
"Jan 29, 2019 2:00 PM",65,26,39,,,,,,,,,,7,5,2,4,,,,24,22,2,21,20,8,2,6,13,1,1,2,1,1,0,0,0
"Jan 29, 2019 3:00 PM",88,25,63,,,,,,,,,,4,2,2,13,,,,44,41,3,13,16,7,1,6,19,1,1,4,2,2,0,0,0
"Jan 29, 2019 4:00 PM",144,34,110,,,,,,,,,,9,6,3,9,,,,69,66,3,24,48,28,3,25,29,6,0,2,2,0,1,1,0
"Jan 29, 2019 5:00 PM",292,54,238,,,,,,,,,,13,11,2,22,,,,167,162,5,28,109,41,2,39,43,4,0,0,0,0,1,1,0
"Jan 29, 2019 6:00 PM",335,53,282,,,,,,,,,,15,12,3,16,,,,165,163,2,21,152,53,3,50,40,5,2,1,0,1,0,0,0
"Jan 29, 2019 7:00 PM",175,22,153,,,,,,,,,,4,4,0,12,,,,82,80,2,20,63,40,5,35,19,4,2,4,1,3,1,1,0
"Jan 29, 2019 8:00 PM",108,22,86,,,,,,,,,,4,2,2,4,,,,43,40,3,11,33,18,2,16,9,2,1,0,0,0,3,1,2
"Jan 29, 2019 9:00 PM",59,11,48,,,,,,,,,,2,1,1,4,,,,31,30,1,7,25,5,1,4,17,1,2,2,0,2,1,1,0
"Jan 29, 2019 10:00 PM",46,11,35,,,,,,,,,,5,3,2,2,,,,19,18,1,3,11,5,3,2,8,2,0,1,1,0,0,0,0
"Jan 29, 2019 11:00 PM",11,5,6,,,,,,,,,,0,0,0,1,,,,10,10,0,1,9,0,0,0,4,0,0,1,1,0,0,0,0
"Jan 30, 2019 12:00 AM",7,0,7,,,,,,,,,,1,1,0,0,,,,3,3,0,0,0,0,0,0,1,0,1,0,0,0,0,0,0
"Jan 30, 2019 1:00 AM",1,0,1,,,,,,,,,,1,0,1,0,,,,1,1,0,0,2,0,0,0,2,2,0,0,0,0,0,0,0
"Jan 30, 2019 2:00 AM",1,0,1,,,,,,,,,,0,0,0,0,,,,1,1,0,0,1,0,0,0,0,0,0,0,0,0,0,0,0
"Jan 30, 2019 3:00 AM",1,1,0,,,,,,,,,,0,0,0,0,,,,0,0,0,0,1,0,0,0,0,0,0,1,1,0,0,0,0
"Jan 30, 2019 4:00 AM",3,3,0,,,,,,,,,,0,0,0,0,,,,3,3,0,0,0,0,0,0,0,0,0,0,0,0,0,0,0
"Jan 30, 2019 5:00 AM",7,5,2,,,,,,,,,,0,0,0,1,,,,1,1,0,4,2,0,0,0,9,0,0,0,0,0,0,0,0
"Jan 30, 2019 6:00 AM",41,33,8,,,,,,,,,,3,0,3,3,,,,5,3,2,24,6,1,1,0,49,1,2,2,1,1,0,0,0
"Jan 30, 2019 7:00 AM",161,128,33,,,,,,,,,,7,1,6,9,,,,28,19,9,103,23,17,13,4,127,1,3,3,3,0,0,0,0
"Jan 30, 2019 8:00 AM",393,336,57,,,,,,,,,,16,2,14,35,,,,39,23,16,256,45,72,59,13,302,5,7,10,7,3,2,0,2
"Jan 30, 2019 9:00 AM",238,215,23,,,,,,,,,,16,4,12,15,,,,19,12,7,141,27,41,29,12,109,2,1,4,2,2,0,0,0
"Jan 30, 2019 10:00 AM",105,85,20,,,,,,,,,,5,2,3,7,,,,18,12,6,73,14,9,5,4,35,3,0,2,1,1,1,1,0
"Jan 30, 2019 11:00 AM",54,40,14,,,,,,,,,,6,2,4,5,,,,15,11,4,26,12,11,3,8,20,1,2,3,2,1,0,0,0
"Jan 30, 2019 12:00 PM",67,40,27,,,,,,,,,,8,6,2,8,,,,18,14,4,23,8,16,6,10,26,0,0,2,1,1,0,0,0
"Jan 30, 2019 1:00 PM",87,40,47,,,,,,,,,,10,6,4,15,,,,27,21,6,22,16,13,6,7,23,4,1,2,1,1,1,1,0
"Jan 30, 2019 2:00 PM",71,28,43,,,,,,,,,,11,3,8,14,,,,30,27,3,21,27,13,8,5,16,2,4,3,2,1,1,0,1
"Jan 30, 2019 3:00 PM",101,33,68,,,,,,,,,,13,7,6,15,,,,49,45,4,20,20,19,3,16,20,0,1,4,2,2,1,1,0
"Jan 30, 2019 4:00 PM",154,34,120,,,,,,,,,,15,7,8,12,,,,82,79,3,24,59,26,5,21,36,5,2,3,2,1,2,2,0
"Jan 30, 2019 5:00 PM",256,46,210,,,,,,,,,,18,12,6,17,,,,145,141,4,25,109,37,5,32,53,2,1,1,1,0,4,1,3
"Jan 30, 2019 6:00 PM",300,54,246,,,,,,,,,,14,13,1,22,,,,167,159,8,37,130,61,8,53,36,4,1,1,1,0,1,1,0
"Jan 30, 2019 7:00 PM",178,26,152,,,,,,,,,,8,6,2,4,,,,90,86,4,10,59,31,2,29,18,2,4,7,2,5,0,0,0
"Jan 30, 2019 8:00 PM",112,21,91,,,,,,,,,,7,6,1,11,,,,48,48,0,17,40,9,0,9,14,0,1,1,0,1,2,1,1
"Jan 30, 2019 9:00 PM",68,18,50,,,,,,,,,,2,2,0,4,,,,29,28,1,4,20,8,1,7,5,3,0,0,0,0,1,1,0
"Jan 30, 2019 10:00 PM",41,7,34,,,,,,,,,,1,1,0,2,,,,26,24,2,2,9,3,1,2,13,1,1,0,0,0,0,0,0
"Jan 30, 2019 11:00 PM",11,0,11,,,,,,,,,,1,0,1,0,,,,10,10,0,0,9,1,0,1,2,0,0,0,0,0,0,0,0
"Jan 31, 2019 12:00 AM",2,0,2,,,,,,,,,,1,0,1,0,,,,5,5,0,3,2,1,0,1,2,0,0,0,0,0,0,0,0
"Jan 31, 2019 1:00 AM",1,0,1,,,,,,,,,,1,1,0,0,,,,0,0,0,1,2,1,0,1,0,1,0,0,0,0,0,0,0
"Jan 31, 2019 2:00 AM",1,0,1,,,,,,,,,,0,0,0,0,,,,2,2,0,0,0,0,0,0,1,0,0,0,0,0,0,0,0
"Jan 31, 2019 3:00 AM",2,1,1,,,,,,,,,,0,0,0,0,,,,0,0,0,0,0,0,0,0,0,0,0,0,0,0,0,0,0
"Jan 31, 2019 4:00 AM",1,1,0,,,,,,,,,,0,0,0,0,,,,1,1,0,0,0,0,0,0,2,0,0,0,0,0,0,0,0
"Jan 31, 2019 5:00 AM",5,1,4,,,,,,,,,,0,0,0,1,,,,1,1,0,5,0,0,0,0,7,2,0,0,0,0,0,0,0
"Jan 31, 2019 6:00 AM",37,33,4,,,,,,,,,,1,0,1,3,,,,5,4,1,13,6,2,1,1,35,0,0,1,0,1,0,0,0
"Jan 31, 2019 7:00 AM",118,92,26,,,,,,,,,,5,0,5,9,,,,11,7,4,78,17,9,9,0,83,0,1,3,2,1,2,0,2
"Jan 31, 2019 8:00 AM",291,253,38,,,,,,,,,,10,1,9,22,,,,32,16,16,166,35,52,44,8,196,3,5,7,5,2,2,0,2
"Jan 31, 2019 9:00 AM",156,134,22,,,,,,,,,,8,1,7,9,,,,23,12,11,74,17,21,14,7,86,2,0,2,1,1,3,0,3
"Jan 31, 2019 10:00 AM",81,71,10,,,,,,,,,,2,0,2,6,,,,12,4,8,47,3,3,2,1,15,0,0,0,0,0,0,0,0
"Jan 31, 2019 11:00 AM",39,29,10,,,,,,,,,,2,0,2,1,,,,11,10,1,21,7,4,2,2,12,0,2,0,0,0,2,2,0
"Jan 31, 2019 12:00 PM",45,23,22,,,,,,,,,,3,3,0,4,,,,8,7,1,13,7,3,0,3,7,0,0,1,1,0,0,0,0
"Jan 31, 2019 1:00 PM",61,27,34,,,,,,,,,,4,3,1,6,,,,13,11,2,20,11,7,1,6,10,2,0,1,0,1,0,0,0
"Jan 31, 2019 2:00 PM",48,15,33,,,,,,,,,,8,4,4,10,,,,25,22,3,5,19,2,0,2,9,0,2,2,1,1,0,0,0
"Jan 31, 2019 3:00 PM",57,16,41,,,,,,,,,,7,4,3,4,,,,20,16,4,14,10,6,1,5,19,0,0,1,1,0,0,0,0
"Jan 31, 2019 4:00 PM",120,36,84,,,,,,,,,,7,6,1,3,,,,53,49,4,14,40,12,1,11,20,3,0,0,0,0,0,0,0
"Jan 31, 2019 5:00 PM",212,26,186,,,,,,,,,,7,5,2,10,,,,89,85,4,12,62,24,2,22,36,1,3,2,0,2,0,0,0
"Jan 31, 2019 6:00 PM",203,30,173,,,,,,,,,,10,9,1,19,,,,111,106,5,11,93,32,6,26,29,3,0,0,0,0,1,0,1
"Jan 31, 2019 7:00 PM",111,21,90,,,,,,,,,,2,2,0,4,,,,57,57,0,7,36,17,1,16,11,1,2,0,0,0,1,1,0
"Jan 31, 2019 8:00 PM",75,16,59,,,,,,,,,,1,1,0,4,,,,23,21,2,9,27,9,0,9,8,2,0,0,0,0,1,1,0
"Jan 31, 2019 9:00 PM",27,2,25,,,,,,,,,,1,1,0,1,,,,18,17,1,5,14,4,0,4,4,0,0,0,0,0,0,0,0
"Jan 31, 2019 10:00 PM",27,5,22,,,,,,,,,,3,1,2,3,,,,8,8,0,1,8,2,0,2,7,0,0,0,0,0,0,0,0
"Jan 31, 2019 11:00 PM",17,1,16,,,,,,,,,,0,0,0,0,,,,4,4,0,3,6,1,0,1,1,0,1,0,0,0,0,0,0
"Feb 1, 2019 12:00 AM",8,0,8,,,,,,,,,,0,0,0,0,,,,5,5,0,3,2,0,0,0,4,0,0,0,0,0,1,0,1
"Feb 1, 2019 1:00 AM",2,1,1,,,,,,,,,,0,0,0,0,,,,3,3,0,0,3,0,0,0,3,0,0,0,0,0,0,0,0
"Feb 1, 2019 2:00 AM",3,1,2,,,,,,,,,,0,0,0,0,,,,0,0,0,0,3,0,0,0,2,0,0,0,0,0,0,0,0
"Feb 1, 2019 3:00 AM",1,1,0,,,,,,,,,,0,0,0,0,,,,2,2,0,0,1,0,0,0,0,0,0,0,0,0,0,0,0
"Feb 1, 2019 4:00 AM",2,1,1,,,,,,,,,,0,0,0,0,,,,1,1,0,1,0,0,0,0,0,0,0,0,0,0,0,0,0
"Feb 1, 2019 5:00 AM",7,5,2,,,,,,,,,,0,0,0,2,,,,1,1,0,4,2,0,0,0,7,1,0,0,0,0,0,0,0
"Feb 1, 2019 6:00 AM",31,25,6,,,,,,,,,,1,0,1,1,,,,7,5,2,16,4,3,3,0,32,1,1,1,0,1,0,0,0
"Feb 1, 2019 7:00 AM",109,83,26,,,,,,,,,,6,1,5,9,,,,15,11,4,68,24,18,14,4,78,1,4,1,1,0,0,0,0
"Feb 1, 2019 8:00 AM",284,242,42,,,,,,,,,,13,2,11,23,,,,27,14,13,158,31,52,41,11,196,3,5,13,11,2,4,0,4
"Feb 1, 2019 9:00 AM",171,153,18,,,,,,,,,,6,2,4,4,,,,25,10,15,85,19,23,11,12,85,4,2,3,1,2,0,0,0
"Feb 1, 2019 10:00 AM",69,57,12,,,,,,,,,,9,6,3,9,,,,17,8,9,44,11,7,4,3,20,2,2,2,2,0,0,0,0
"Feb 1, 2019 11:00 AM",51,36,15,,,,,,,,,,3,1,2,3,,,,17,13,4,21,10,5,2,3,21,0,0,1,1,0,0,0,0
"Feb 1, 2019 12:00 PM",73,37,36,,,,,,,,,,2,0,2,6,,,,16,12,4,22,10,14,1,13,19,1,1,2,2,0,3,2,1
"Feb 1, 2019 1:00 PM",88,40,48,,,,,,,,,,7,4,3,7,,,,31,27,4,22,15,9,4,5,13,3,0,1,0,1,0,0,0
"Feb 1, 2019 2:00 PM",80,30,50,,,,,,,,,,7,4,3,4,,,,41,39,2,11,26,10,0,10,13,0,1,0,0,0,0,0,0
"Feb 1, 2019 3:00 PM",85,22,63,,,,,,,,,,3,1,2,16,,,,40,39,1,12,29,10,1,9,24,4,1,5,2,3,2,2,0
"Feb 1, 2019 4:00 PM",138,38,100,,,,,,,,,,17,8,9,11,,,,42,40,2,14,45,16,3,13,29,3,1,3,1,2,1,1,0
"Feb 1, 2019 5:00 PM",211,28,183,,,,,,,,,,10,8,2,13,,,,106,103,3,25,91,45,10,35,37,4,2,4,2,2,1,0,1
"Feb 1, 2019 6:00 PM",182,32,150,,,,,,,,,,12,10,2,15,,,,94,90,4,15,84,51,8,43,26,7,1,4,1,3,1,1,0
"Feb 1, 2019 7:00 PM",95,26,69,,,,,,,,,,3,2,1,5,,,,50,50,0,17,38,22,2,20,13,4,1,5,3,2,2,1,1
"Feb 1, 2019 8:00 PM",49,9,40,,,,,,,,,,0,0,0,7,,,,21,20,1,10,19,4,2,2,11,1,2,2,2,0,0,0,0
"Feb 1, 2019 9:00 PM",36,9,27,,,,,,,,,,2,1,1,1,,,,16,16,0,4,6,3,1,2,8,5,0,0,0,0,0,0,0
"Feb 1, 2019 10:00 PM",19,8,11,,,,,,,,,,1,1,0,4,,,,16,15,1,2,5,1,0,1,10,0,0,0,0,0,0,0,0
"Feb 1, 2019 11:00 PM",21,1,20,,,,,,,,,,4,3,1,4,,,,6,6,0,6,6,2,0,2,3,0,0,0,0,0,0,0,0
"Feb 2, 2019 12:00 AM",12,3,9,,,,,,,,,,2,0,2,0,,,,6,6,0,2,6,0,0,0,5,1,1,0,0,0,1,0,1
"Feb 2, 2019 1:00 AM",3,0,3,,,,,,,,,,1,1,0,0,,,,8,8,0,1,4,0,0,0,2,0,1,0,0,0,0,0,0
"Feb 2, 2019 2:00 AM",2,0,2,,,,,,,,,,1,0,1,0,,,,1,1,0,0,1,0,0,0,3,0,1,0,0,0,0,0,0
"Feb 2, 2019 3:00 AM",5,2,3,,,,,,,,,,1,1,0,0,,,,3,3,0,1,0,3,2,1,0,0,0,0,0,0,0,0,0
"Feb 2, 2019 4:00 AM",2,1,1,,,,,,,,,,0,0,0,0,,,,2,2,0,1,1,0,0,0,0,0,0,0,0,0,0,0,0
"Feb 2, 2019 5:00 AM",4,0,4,,,,,,,,,,0,0,0,0,,,,0,0,0,2,2,1,1,0,1,0,0,0,0,0,0,0,0
"Feb 2, 2019 6:00 AM",6,4,2,,,,,,,,,,1,1,0,1,,,,4,4,0,5,1,1,0,1,6,0,0,0,0,0,0,0,0
"Feb 2, 2019 7:00 AM",10,3,7,,,,,,,,,,1,0,1,1,,,,2,2,0,3,2,1,1,0,5,0,0,0,0,0,0,0,0
"Feb 2, 2019 8:00 AM",11,9,2,,,,,,,,,,2,0,2,4,,,,5,4,1,8,4,1,0,1,14,0,2,0,0,0,0,0,0
"Feb 2, 2019 9:00 AM",40,34,6,,,,,,,,,,7,2,5,4,,,,7,4,3,13,8,9,3,6,24,2,1,5,2,3,0,0,0
"Feb 2, 2019 10:00 AM",37,27,10,,,,,,,,,,14,8,6,9,,,,5,5,0,28,19,13,6,7,11,2,3,6,2,4,0,0,0
"Feb 2, 2019 11:00 AM",56,33,23,,,,,,,,,,6,4,2,12,,,,16,12,4,17,27,13,4,9,26,2,6,0,0,0,2,0,2
"Feb 2, 2019 12:00 PM",49,25,24,,,,,,,,,,14,4,10,8,,,,11,8,3,12,16,17,3,14,27,4,2,4,3,1,1,0,1
"Feb 2, 2019 1:00 PM",50,27,23,,,,,,,,,,26,13,13,9,,,,18,15,3,16,17,22,8,14,32,2,1,3,1,2,2,0,2
"Feb 2, 2019 2:00 PM",64,32,32,,,,,,,,,,21,9,12,27,,,,25,21,4,20,16,21,9,12,18,3,0,4,3,1,1,0,1
"Feb 2, 2019 3:00 PM",50,30,20,,,,,,,,,,14,8,6,10,,,,20,17,3,15,29,9,2,7,23,0,2,15,7,8,2,1,1
"Feb 2, 2019 4:00 PM",40,16,24,,,,,,,,,,14,4,10,12,,,,19,18,1,15,13,13,2,11,25,7,3,7,4,3,1,0,1
"Feb 2, 2019 5:00 PM",39,12,27,,,,,,,,,,6,5,1,13,,,,10,10,0,6,9,19,13,6,18,2,0,4,3,1,2,0,2
"Feb 2, 2019 6:00 PM",35,10,25,,,,,,,,,,7,6,1,9,,,,3,3,0,5,8,7,2,5,9,0,0,5,2,3,3,3,0
"Feb 2, 2019 7:00 PM",31,19,12,,,,,,,,,,3,3,0,3,,,,12,11,1,9,6,1,0,1,4,3,0,1,1,0,0,0,0
"Feb 2, 2019 8:00 PM",22,10,12,,,,,,,,,,1,1,0,4,,,,7,6,1,8,7,4,0,4,5,0,0,0,0,0,0,0,0
"Feb 2, 2019 9:00 PM",23,8,15,,,,,,,,,,0,0,0,3,,,,8,8,0,3,3,2,0,2,8,0,0,0,0,0,0,0,0
"Feb 2, 2019 10:00 PM",11,3,8,,,,,,,,,,0,0,0,1,,,,3,3,0,0,5,1,0,1,9,0,3,1,0,1,0,0,0
"Feb 2, 2019 11:00 PM",5,0,5,,,,,,,,,,0,0,0,1,,,,8,8,0,2,2,2,2,0,4,0,0,2,1,1,0,0,0
"Feb 3, 2019 12:00 AM",12,4,8,,,,,,,,,,1,0,1,1,,,,4,4,0,1,2,0,0,0,3,0,0,0,0,0,0,0,0
"Feb 3, 2019 1:00 AM",4,1,3,,,,,,,,,,3,0,3,2,,,,3,3,0,2,1,2,0,2,3,0,1,0,0,0,0,0,0
"Feb 3, 2019 2:00 AM",4,0,4,,,,,,,,,,0,0,0,0,,,,0,0,0,0,0,1,0,1,0,0,3,0,0,0,0,0,0
"Feb 3, 2019 3:00 AM",1,0,1,,,,,,,,,,0,0,0,0,,,,3,3,0,1,1,1,0,1,0,0,0,0,0,0,0,0,0
"Feb 3, 2019 4:00 AM",2,0,2,,,,,,,,,,0,0,0,0,,,,3,3,0,0,2,0,0,0,1,0,0,0,0,0,0,0,0
"Feb 3, 2019 5:00 AM",0,0,0,,,,,,,,,,0,0,0,0,,,,0,0,0,1,1,0,0,0,0,0,0,0,0,0,0,0,0
"Feb 3, 2019 6:00 AM",3,2,1,,,,,,,,,,0,0,0,0,,,,5,5,0,3,2,0,0,0,4,1,0,0,0,0,0,0,0
"Feb 3, 2019 7:00 AM",6,5,1,,,,,,,,,,2,2,0,0,,,,1,1,0,4,6,2,2,0,10,0,2,1,1,0,1,0,1
"Feb 3, 2019 8:00 AM",17,9,8,,,,,,,,,,6,1,5,2,,,,1,1,0,7,6,4,0,4,12,1,6,2,2,0,0,0,0
"Feb 3, 2019 9:00 AM",19,14,5,,,,,,,,,,4,1,3,3,,,,13,11,2,9,18,11,4,7,28,5,4,0,0,0,0,0,0
"Feb 3, 2019 10:00 AM",24,17,7,,,,,,,,,,12,5,7,4,,,,7,6,1,13,12,15,6,9,59,3,4,3,2,1,1,0,1
"Feb 3, 2019 11:00 AM",44,16,28,,,,,,,,,,22,14,8,12,,,,12,11,1,13,19,21,10,11,14,5,4,3,3,0,3,2,1
"Feb 3, 2019 12:00 PM",38,24,14,,,,,,,,,,29,11,18,9,,,,10,8,2,14,18,20,9,11,21,7,2,2,0,2,0,0,0
"Feb 3, 2019 1:00 PM",47,30,17,,,,,,,,,,25,13,12,6,,,,9,9,0,8,18,28,10,18,21,7,3,6,3,3,2,1,1
"Feb 3, 2019 2:00 PM",34,16,18,,,,,,,,,,12,7,5,8,,,,11,11,0,11,18,13,8,5,18,0,1,5,3,2,1,0,1
"Feb 3, 2019 3:00 PM",35,13,22,,,,,,,,,,13,6,7,5,,,,7,6,1,7,10,9,3,6,14,1,2,3,1,2,0,0,0
"Feb 3, 2019 4:00 PM",36,12,24,,,,,,,,,,20,8,12,6,,,,12,10,2,12,4,25,13,12,13,2,2,5,3,2,0,0,0
"Feb 3, 2019 5:00 PM",35,9,26,,,,,,,,,,12,8,4,5,,,,12,10,2,9,10,14,9,5,11,3,1,1,1,0,0,0,0
"Feb 3, 2019 6:00 PM",35,17,18,,,,,,,,,,5,2,3,7,,,,14,13,1,4,7,4,2,2,6,0,0,2,2,0,0,0,0
"Feb 3, 2019 7:00 PM",28,16,12,,,,,,,,,,3,2,1,1,,,,7,6,1,4,7,5,2,3,9,0,1,0,0,0,1,1,0
"Feb 3, 2019 8:00 PM",20,7,13,,,,,,,,,,2,2,0,1,,,,5,5,0,3,4,2,1,1,3,0,0,0,0,0,1,1,0
"Feb 3, 2019 9:00 PM",23,9,14,,,,,,,,,,0,0,0,2,,,,8,7,1,9,3,1,0,1,4,1,0,2,1,1,0,0,0
"Feb 3, 2019 10:00 PM",7,2,5,,,,,,,,,,1,0,1,0,,,,5,5,0,6,1,3,1,2,4,0,2,0,0,0,0,0,0
"Feb 3, 2019 11:00 PM",9,2,7,,,,,,,,,,0,0,0,4,,,,1,1,0,1,4,1,1,0,3,0,0,1,1,0,1,0,1
"Feb 4, 2019 12:00 AM",1,0,1,,,,,,,,,,1,0,1,0,,,,3,3,0,1,1,0,0,0,0,0,1,0,0,0,0,0,0
"Feb 4, 2019 1:00 AM",4,3,1,,,,,,,,,,0,0,0,0,,,,2,2,0,0,0,0,0,0,0,0,0,0,0,0,0,0,0
"Feb 4, 2019 2:00 AM",2,0,2,,,,,,,,,,0,0,0,0,,,,1,1,0,0,1,0,0,0,1,0,0,0,0,0,0,0,0
"Feb 4, 2019 3:00 AM",4,0,4,,,,,,,,,,0,0,0,0,,,,2,2,0,0,1,0,0,0,0,0,0,0,0,0,0,0,0
"Feb 4, 2019 4:00 AM",2,1,1,,,,,,,,,,0,0,0,0,,,,0,0,0,0,1,0,0,0,0,0,0,0,0,0,0,0,0
"Feb 4, 2019 5:00 AM",3,2,1,,,,,,,,,,1,0,1,1,,,,1,1,0,6,1,0,0,0,11,1,0,0,0,0,0,0,0
"Feb 4, 2019 6:00 AM",53,38,15,,,,,,,,,,3,0,3,4,,,,5,4,1,21,8,1,1,0,51,0,1,1,0,1,0,0,0
"Feb 4, 2019 7:00 AM",168,140,28,,,,,,,,,,9,0,9,9,,,,21,15,6,112,25,27,21,6,150,1,5,3,2,1,0,0,0
"Feb 4, 2019 8:00 AM",378,323,55,,,,,,,,,,32,0,32,38,,,,42,26,16,291,44,84,64,20,345,3,5,5,4,1,3,0,3
"Feb 4, 2019 9:00 AM",237,212,25,,,,,,,,,,13,2,11,8,,,,21,8,13,145,33,57,47,10,118,3,1,5,2,3,1,0,1
"Feb 4, 2019 10:00 AM",82,71,11,,,,,,,,,,12,1,11,3,,,,22,13,9,65,17,17,9,8,34,3,2,2,1,1,2,1,1
"Feb 4, 2019 11:00 AM",76,58,18,,,,,,,,,,13,8,5,7,,,,15,10,5,37,14,10,3,7,35,2,1,2,1,1,0,0,0
"Feb 4, 2019 12:00 PM",61,41,20,,,,,,,,,,15,4,11,4,,,,21,15,6,29,9,13,7,6,17,2,3,2,2,0,0,0,0
"Feb 4, 2019 1:00 PM",79,39,40,,,,,,,,,,10,3,7,5,,,,24,21,3,28,19,20,3,17,22,0,1,1,0,1,0,0,0
"Feb 4, 2019 2:00 PM",84,33,51,,,,,,,,,,15,8,7,9,,,,30,27,3,18,18,26,9,17,19,1,3,0,0,0,1,0,1
"Feb 4, 2019 3:00 PM",107,26,81,,,,,,,,,,15,4,11,12,,,,37,35,2,15,27,23,8,15,20,4,3,2,2,0,0,0,0
"Feb 4, 2019 4:00 PM",159,36,123,,,,,,,,,,15,9,6,17,,,,81,78,3,24,61,32,8,24,37,3,1,4,1,3,6,3,3
"Feb 4, 2019 5:00 PM",317,60,257,,,,,,,,,,15,11,4,19,,,,168,162,6,29,140,53,8,45,66,4,2,3,3,0,1,1,0
"Feb 4, 2019 6:00 PM",310,41,269,,,,,,,,,,24,19,5,24,,,,212,205,7,32,188,94,9,85,48,7,4,1,1,0,0,0,0
"Feb 4, 2019 7:00 PM",183,35,148,,,,,,,,,,6,6,0,9,,,,82,82,0,14,82,28,3,25,20,3,2,2,2,0,2,2,0
"Feb 4, 2019 8:00 PM",101,19,82,,,,,,,,,,9,3,6,6,,,,46,44,2,11,38,21,3,18,12,2,1,3,2,1,1,0,1
"Feb 4, 2019 9:00 PM",84,16,68,,,,,,,,,,0,0,0,4,,,,34,29,5,11,22,6,0,6,23,3,0,2,2,0,0,0,0
"Feb 4, 2019 10:00 PM",32,2,30,,,,,,,,,,1,0,1,3,,,,14,14,0,2,7,1,0,1,9,0,1,0,0,0,0,0,0
"Feb 4, 2019 11:00 PM",14,5,9,,,,,,,,,,2,2,0,0,,,,6,6,0,4,6,3,1,2,1,0,0,0,0,0,0,0,0
"Feb 5, 2019 12:00 AM",2,1,1,,,,,,,,,,0,0,0,0,,,,1,1,0,1,5,0,0,0,3,0,1,0,0,0,0,0,0
"Feb 5, 2019 1:00 AM",3,0,3,,,,,,,,,,0,0,0,0,,,,1,1,0,1,2,0,0,0,3,0,0,0,0,0,0,0,0
"Feb 5, 2019 2:00 AM",3,0,3,,,,,,,,,,0,0,0,0,,,,1,1,0,0,1,1,0,1,0,0,0,0,0,0,0,0,0
"Feb 5, 2019 3:00 AM",3,1,2,,,,,,,,,,0,0,0,0,,,,0,0,0,0,1,0,0,0,0,0,0,0,0,0,0,0,0
"Feb 5, 2019 4:00 AM",2,1,1,,,,,,,,,,0,0,0,0,,,,0,0,0,0,0,0,0,0,1,0,0,0,0,0,0,0,0
"Feb 5, 2019 5:00 AM",4,2,2,,,,,,,,,,0,0,0,1,,,,1,1,0,6,2,0,0,0,9,1,0,0,0,0,0,0,0
"Feb 5, 2019 6:00 AM",49,38,11,,,,,,,,,,1,1,0,4,,,,5,3,2,27,8,3,3,0,45,0,2,1,0,1,0,0,0
"Feb 5, 2019 7:00 AM",194,158,36,,,,,,,,,,12,7,5,13,,,,23,17,6,129,26,24,18,6,152,2,3,3,1,2,0,0,0
"Feb 5, 2019 8:00 AM",404,342,62,,,,,,,,,,19,17,2,35,,,,39,22,17,289,57,72,64,8,291,3,7,6,6,0,3,0,3
"Feb 5, 2019 9:00 AM",212,192,20,,,,,,,,,,10,9,1,7,,,,37,16,21,124,25,33,23,10,139,3,1,3,3,0,1,0,1
"Feb 5, 2019 10:00 AM",89,67,22,,,,,,,,,,5,5,0,6,,,,18,10,8,57,11,10,8,2,19,0,2,2,1,1,0,0,0
"Feb 5, 2019 11:00 AM",37,26,11,,,,,,,,,,8,6,2,4,,,,16,9,7,17,7,5,4,1,15,0,1,0,0,0,0,0,0
"Feb 5, 2019 12:00 PM",49,23,26,,,,,,,,,,7,6,1,5,,,,11,9,2,18,11,4,1,3,17,0,2,0,0,0,1,1,0
"Feb 5, 2019 1:00 PM",83,43,40,,,,,,,,,,6,6,0,8,,,,28,23,5,29,16,9,3,6,15,0,0,2,0,2,0,0,0
"Feb 5, 2019 2:00 PM",71,31,40,,,,,,,,,,12,9,3,11,,,,29,27,2,12,21,8,2,6,10,1,1,0,0,0,0,0,0
"Feb 5, 2019 3:00 PM",95,26,69,,,,,,,,,,6,3,3,8,,,,34,31,3,9,13,13,1,12,17,3,0,3,3,0,2,1,1
"Feb 5, 2019 4:00 PM",153,25,128,,,,,,,,,,18,16,2,15,,,,85,78,7,20,58,22,6,16,29,4,1,3,2,1,3,1,2
"Feb 5, 2019 5:00 PM",304,57,247,,,,,,,,,,13,4,9,19,,,,168,160,8,28,143,36,2,34,56,4,2,5,2,3,0,0,0
"Feb 5, 2019 6:00 PM",301,58,243,,,,,,,,,,19,8,11,20,,,,191,188,3,31,176,73,5,68,52,7,3,0,0,0,2,2,0
"Feb 5, 2019 7:00 PM",157,29,128,,,,,,,,,,7,4,3,8,,,,93,91,2,13,65,28,2,26,17,6,1,3,1,2,1,1,0
"Feb 5, 2019 8:00 PM",108,20,88,,,,,,,,,,1,0,1,8,,,,55,53,2,20,40,15,2,13,15,2,2,1,0,1,0,0,0
"Feb 5, 2019 9:00 PM",79,10,69,,,,,,,,,,2,1,1,1,,,,47,45,2,14,22,9,0,9,15,2,1,0,0,0,1,1,0
"Feb 5, 2019 10:00 PM",45,9,36,,,,,,,,,,2,1,1,4,,,,23,21,2,3,11,4,2,2,6,2,1,1,0,1,0,0,0
"Feb 5, 2019 11:00 PM",17,1,16,,,,,,,,,,0,0,0,1,,,,4,4,0,4,7,2,2,0,4,0,1,0,0,0,0,0,0
"Feb 6, 2019 12:00 AM",4,2,2,,,,,,,,,,0,0,0,0,,,,9,8,1,2,2,0,0,0,2,0,0,0,0,0,0,0,0
"Feb 6, 2019 1:00 AM",4,1,3,,,,,,,,,,0,0,0,0,,,,2,2,0,0,1,2,0,2,1,0,0,0,0,0,0,0,0
"Feb 6, 2019 2:00 AM",1,0,1,,,,,,,,,,0,0,0,0,,,,0,0,0,0,1,0,0,0,0,0,0,0,0,0,0,0,0
"Feb 6, 2019 3:00 AM",2,1,1,,,,,,,,,,0,0,0,0,,,,0,0,0,0,0,0,0,0,1,0,0,0,0,0,0,0,0
"Feb 6, 2019 4:00 AM",3,2,1,,,,,,,,,,0,0,0,0,,,,1,1,0,0,0,0,0,0,1,0,0,0,0,0,0,0,0
"Feb 6, 2019 5:00 AM",7,5,2,,,,,,,,,,1,1,0,1,,,,0,0,0,6,1,0,0,0,6,0,0,0,0,0,0,0,0
"Feb 6, 2019 6:00 AM",49,39,10,,,,,,,,,,1,0,1,5,,,,1,1,0,29,9,3,3,0,41,0,2,2,1,1,0,0,0
"Feb 6, 2019 7:00 AM",200,158,42,,,,,,,,,,7,1,6,11,,,,22,13,9,127,25,23,17,6,156,2,3,3,2,1,3,0,3
"Feb 6, 2019 8:00 AM",396,342,54,,,,,,,,,,26,5,21,32,,,,44,29,15,302,60,78,61,17,329,8,6,16,14,2,3,0,3
"Feb 6, 2019 9:00 AM",233,207,26,,,,,,,,,,18,4,14,16,,,,18,12,6,138,35,42,26,16,120,6,3,4,2,2,3,0,3
"Feb 6, 2019 10:00 AM",109,88,21,,,,,,,,,,3,1,2,9,,,,23,12,11,67,13,17,14,3,26,1,2,1,0,1,0,0,0
"Feb 6, 2019 11:00 AM",59,45,14,,,,,,,,,,32,14,18,8,,,,12,10,2,33,14,13,3,10,19,2,1,3,2,1,4,3,1
"Feb 6, 2019 12:00 PM",71,36,35,,,,,,,,,,17,9,8,3,,,,31,23,8,22,15,11,1,10,28,3,2,5,2,3,0,0,0
"Feb 6, 2019 1:00 PM",102,56,46,,,,,,,,,,15,4,11,8,,,,32,17,15,29,24,21,9,12,21,1,4,1,0,1,1,1,0
"Feb 6, 2019 2:00 PM",75,32,43,,,,,,,,,,10,7,3,17,,,,37,33,4,19,26,17,5,12,14,4,4,2,0,2,0,0,0
"Feb 6, 2019 3:00 PM",102,25,77,,,,,,,,,,15,10,5,9,,,,41,39,2,20,24,19,5,14,22,2,1,8,4,4,1,1,0
"Feb 6, 2019 4:00 PM",164,33,131,,,,,,,,,,12,6,6,17,,,,75,73,2,17,68,32,4,28,31,8,1,6,3,3,1,1,0
"Feb 6, 2019 5:00 PM",298,55,243,,,,,,,,,,16,11,5,15,,,,155,152,3,34,120,54,9,45,72,2,3,6,3,3,1,1,0
"Feb 6, 2019 6:00 PM",323,46,277,,,,,,,,,,14,13,1,23,,,,185,183,2,28,172,86,11,75,49,2,3,4,2,2,0,0,0
"Feb 6, 2019 7:00 PM",189,37,152,,,,,,,,,,14,9,5,5,,,,90,85,5,20,94,34,4,30,23,0,0,0,0,0,0,0,0
"Feb 6, 2019 8:00 PM",117,22,95,,,,,,,,,,6,4,2,11,,,,36,35,1,8,32,15,0,15,11,1,2,1,1,0,2,2,0
"Feb 6, 2019 9:00 PM",71,8,63,,,,,,,,,,1,1,0,2,,,,35,35,0,4,28,10,0,10,9,4,1,1,0,1,1,1,0
"Feb 6, 2019 10:00 PM",30,5,25,,,,,,,,,,3,3,0,5,,,,20,20,0,3,12,5,0,5,8,0,0,1,0,1,0,0,0
"Feb 6, 2019 11:00 PM",13,2,11,,,,,,,,,,1,0,1,1,,,,5,5,0,1,12,0,0,0,3,0,0,0,0,0,0,0,0
"Feb 7, 2019 12:00 AM",5,1,4,,,,,,,,,,0,0,0,0,,,,4,3,1,2,0,0,0,0,1,1,1,0,0,0,0,0,0
"Feb 7, 2019 1:00 AM",2,0,2,,,,,,,,,,0,0,0,2,,,,0,0,0,0,1,0,0,0,0,0,0,0,0,0,0,0,0
"Feb 7, 2019 2:00 AM",3,0,3,,,,,,,,,,0,0,0,0,,,,2,2,0,0,3,0,0,0,0,0,0,0,0,0,0,0,0
"Feb 7, 2019 3:00 AM",1,0,1,,,,,,,,,,0,0,0,0,,,,0,0,0,0,1,0,0,0,0,0,0,0,0,0,0,0,0
"Feb 7, 2019 4:00 AM",1,0,1,,,,,,,,,,0,0,0,0,,,,1,1,0,0,1,0,0,0,0,0,0,0,0,0,0,0,0
"Feb 7, 2019 5:00 AM",7,5,2,,,,,,,,,,0,0,0,1,,,,1,1,0,6,2,0,0,0,7,1,0,0,0,0,0,0,0
"Feb 7, 2019 6:00 AM",33,28,5,,,,,,,,,,1,0,1,4,,,,6,4,2,19,6,1,1,0,45,1,1,1,0,1,0,0,0
"Feb 7, 2019 7:00 AM",204,168,36,,,,,,,,,,8,0,8,11,,,,18,12,6,115,22,18,15,3,133,2,2,4,2,2,2,0,2
"Feb 7, 2019 8:00 AM",425,366,59,,,,,,,,,,26,6,20,32,,,,36,21,15,260,56,72,56,16,284,1,6,8,6,2,1,0,1
"Feb 7, 2019 9:00 AM",200,179,21,,,,,,,,,,14,5,9,10,,,,28,13,15,115,27,46,29,17,119,2,2,1,1,0,0,0,0
"Feb 7, 2019 10:00 AM",94,87,7,,,,,,,,,,8,4,4,7,,,,12,6,6,48,5,10,5,5,28,1,1,3,3,0,2,0,2
"Feb 7, 2019 11:00 AM",48,32,16,,,,,,,,,,11,7,4,5,,,,15,12,3,34,14,9,2,7,16,1,2,3,2,1,0,0,0
"Feb 7, 2019 12:00 PM",70,34,36,,,,,,,,,,5,2,3,5,,,,23,15,8,24,11,11,5,6,18,0,0,1,1,0,0,0,0
"Feb 7, 2019 1:00 PM",65,26,39,,,,,,,,,,5,0,5,11,,,,15,14,1,18,24,12,7,5,22,1,0,1,0,1,1,1,0
"Feb 7, 2019 2:00 PM",72,24,48,,,,,,,,,,7,4,3,10,,,,22,21,1,17,22,9,1,8,8,2,2,2,1,1,0,0,0
"Feb 7, 2019 3:00 PM",73,18,55,,,,,,,,,,10,4,6,9,,,,52,49,3,14,26,12,1,11,17,6,3,5,3,2,0,0,0
"Feb 7, 2019 4:00 PM",146,35,111,,,,,,,,,,13,7,6,14,,,,77,73,4,20,61,24,11,13,23,1,2,5,2,3,0,0,0
"Feb 7, 2019 5:00 PM",279,48,231,,,,,,,,,,19,12,7,15,,,,158,151,7,29,119,45,7,38,67,5,3,4,3,1,0,0,0
"Feb 7, 2019 6:00 PM",292,52,240,,,,,,,,,,13,12,1,23,,,,171,163,8,23,158,73,8,65,44,2,1,3,0,3,2,1,1
"Feb 7, 2019 7:00 PM",150,21,129,,,,,,,,,,11,9,2,8,,,,72,71,1,14,67,34,4,30,16,2,2,3,2,1,3,3,0
"Feb 7, 2019 8:00 PM",89,25,64,,,,,,,,,,7,4,3,3,,,,43,41,2,12,28,7,0,7,5,2,3,3,1,2,2,2,0
"Feb 7, 2019 9:00 PM",72,9,63,,,,,,,,,,0,0,0,6,,,,28,26,2,12,13,9,2,7,15,1,1,1,0,1,1,1,0
"Feb 7, 2019 10:00 PM",42,3,39,,,,,,,,,,4,3,1,2,,,,19,17,2,1,19,3,0,3,7,1,1,1,1,0,0,0,0
"Feb 7, 2019 11:00 PM",26,0,26,,,,,,,,,,0,0,0,0,,,,14,14,0,2,3,2,2,0,4,0,1,1,1,0,0,0,0
"Feb 8, 2019 12:00 AM",5,1,4,,,,,,,,,,1,0,1,1,,,,4,4,0,1,3,1,0,1,3,0,0,0,0,0,0,0,0
"Feb 8, 2019 1:00 AM",2,0,2,,,,,,,,,,0,0,0,0,,,,1,1,0,0,3,1,0,1,0,0,0,0,0,0,0,0,0
"Feb 8, 2019 2:00 AM",0,0,0,,,,,,,,,,0,0,0,0,,,,1,1,0,1,1,1,0,1,0,0,0,0,0,0,0,0,0
"Feb 8, 2019 3:00 AM",1,1,0,,,,,,,,,,0,0,0,0,,,,3,3,0,0,0,0,0,0,0,0,0,0,0,0,0,0,0
"Feb 8, 2019 4:00 AM",2,0,2,,,,,,,,,,0,0,0,0,,,,2,2,0,0,0,0,0,0,0,0,0,0,0,0,0,0,0
"Feb 8, 2019 5:00 AM",6,3,3,,,,,,,,,,0,0,0,1,,,,0,0,0,6,1,0,0,0,4,1,0,0,0,0,0,0,0
"Feb 8, 2019 6:00 AM",24,21,3,,,,,,,,,,1,0,1,2,,,,2,2,0,13,7,1,1,0,29,0,0,1,0,1,1,0,1
"Feb 8, 2019 7:00 AM",88,75,13,,,,,,,,,,5,1,4,8,,,,11,7,4,59,15,7,7,0,71,0,3,4,3,1,0,0,0
"Feb 8, 2019 8:00 AM",226,195,31,,,,,,,,,,8,1,7,15,,,,11,7,4,123,31,27,23,4,145,4,2,7,6,1,0,0,0
"Feb 8, 2019 9:00 AM",142,124,18,,,,,,,,,,5,2,3,4,,,,16,8,8,64,14,20,14,6,55,3,1,4,2,2,1,0,1
"Feb 8, 2019 10:00 AM",72,58,14,,,,,,,,,,3,0,3,6,,,,9,3,6,34,9,4,3,1,26,2,0,3,2,1,0,0,0
"Feb 8, 2019 11:00 AM",41,26,15,,,,,,,,,,3,2,1,1,,,,13,8,5,15,6,4,2,2,18,0,0,4,2,2,0,0,0
"Feb 8, 2019 12:00 PM",51,21,30,,,,,,,,,,4,1,3,5,,,,10,8,2,14,7,5,0,5,10,5,1,3,2,1,1,1,0
"Feb 8, 2019 1:00 PM",58,26,32,,,,,,,,,,5,3,2,2,,,,21,15,6,28,13,12,2,10,16,0,0,2,1,1,0,0,0
"Feb 8, 2019 2:00 PM",57,26,31,,,,,,,,,,6,4,2,5,,,,17,15,2,8,17,10,2,8,11,3,1,6,4,2,4,2,2
"Feb 8, 2019 3:00 PM",63,15,48,,,,,,,,,,7,4,3,6,,,,33,33,0,13,18,10,3,7,22,1,0,1,0,1,1,1,0
"Feb 8, 2019 4:00 PM",104,23,81,,,,,,,,,,12,6,6,7,,,,47,46,1,7,30,12,1,11,23,2,1,3,2,1,1,0,1
"Feb 8, 2019 5:00 PM",161,29,132,,,,,,,,,,12,8,4,9,,,,87,83,4,12,82,26,3,23,30,1,0,0,0,0,0,0,0
"Feb 8, 2019 6:00 PM",160,27,133,,,,,,,,,,11,10,1,8,,,,81,78,3,10,74,31,2,29,14,3,1,0,0,0,3,1,2
"Feb 8, 2019 7:00 PM",80,22,58,,,,,,,,,,6,5,1,5,,,,36,35,1,11,32,15,0,15,6,1,2,5,2,3,2,2,0
"Feb 8, 2019 8:00 PM",42,9,33,,,,,,,,,,4,4,0,3,,,,14,13,1,2,11,3,0,3,5,2,0,0,0,0,0,0,0
"Feb 8, 2019 9:00 PM",16,6,10,,,,,,,,,,2,0,2,1,,,,15,14,1,6,5,0,0,0,3,0,0,1,0,1,0,0,0
"Feb 8, 2019 10:00 PM",22,5,17,,,,,,,,,,1,1,0,2,,,,11,11,0,0,6,2,1,1,3,0,0,0,0,0,0,0,0
"Feb 8, 2019 11:00 PM",9,3,6,,,,,,,,,,0,0,0,1,,,,6,6,0,1,3,2,2,0,5,0,0,1,0,1,1,1,0
"Feb 9, 2019 12:00 AM",8,1,7,,,,,,,,,,2,1,1,0,,,,4,4,0,2,0,2,0,2,7,0,0,0,0,0,0,0,0
"Feb 9, 2019 1:00 AM",4,0,4,,,,,,,,,,0,0,0,0,,,,3,2,1,3,1,2,0,2,1,1,1,0,0,0,0,0,0
"Feb 9, 2019 2:00 AM",1,0,1,,,,,,,,,,0,0,0,1,,,,0,0,0,1,1,1,0,1,1,0,2,0,0,0,0,0,0
"Feb 9, 2019 3:00 AM",4,1,3,,,,,,,,,,0,0,0,0,,,,1,1,0,0,1,0,0,0,0,0,0,0,0,0,0,0,0
"Feb 9, 2019 4:00 AM",2,1,1,,,,,,,,,,0,0,0,0,,,,2,2,0,0,1,0,0,0,2,0,0,0,0,0,0,0,0
"Feb 9, 2019 5:00 AM",0,0,0,,,,,,,,,,0,0,0,1,,,,0,0,0,0,1,0,0,0,0,0,0,0,0,0,0,0,0
"Feb 9, 2019 6:00 AM",9,5,4,,,,,,,,,,0,0,0,3,,,,2,2,0,2,0,0,0,0,4,1,0,0,0,0,0,0,0
"Feb 9, 2019 7:00 AM",8,4,4,,,,,,,,,,0,0,0,0,,,,2,2,0,3,4,1,1,0,3,0,0,0,0,0,0,0,0
"Feb 9, 2019 8:00 AM",23,16,7,,,,,,,,,,4,0,4,2,,,,4,4,0,12,5,4,0,4,19,0,2,0,0,0,0,0,0
"Feb 9, 2019 9:00 AM",29,19,10,,,,,,,,,,3,1,2,4,,,,10,10,0,11,8,8,3,5,20,0,2,0,0,0,0,0,0
"Feb 9, 2019 10:00 AM",33,22,11,,,,,,,,,,8,4,4,6,,,,8,5,3,17,16,15,6,9,13,1,5,0,0,0,0,0,0
"Feb 9, 2019 11:00 AM",37,25,12,,,,,,,,,,13,8,5,12,,,,6,4,2,13,15,15,4,11,20,0,2,2,1,1,0,0,0
"Feb 9, 2019 12:00 PM",49,25,24,,,,,,,,,,14,10,4,11,,,,14,13,1,19,16,16,6,10,25,2,4,2,1,1,2,0,2
"Feb 9, 2019 1:00 PM",41,24,17,,,,,,,,,,16,10,6,6,,,,15,13,2,19,17,11,4,7,20,3,3,3,0,3,1,0,1
"Feb 9, 2019 2:00 PM",41,14,27,,,,,,,,,,16,7,9,11,,,,10,8,2,5,12,7,1,6,15,1,1,0,0,0,0,0,0
"Feb 9, 2019 3:00 PM",23,14,9,,,,,,,,,,7,5,2,8,,,,11,7,4,9,13,16,9,7,7,2,3,2,2,0,1,1,0
"Feb 9, 2019 4:00 PM",51,18,33,,,,,,,,,,26,15,11,12,,,,15,13,2,13,7,11,5,6,22,2,1,2,1,1,1,0,1
"Feb 9, 2019 5:00 PM",42,15,27,,,,,,,,,,11,8,3,9,,,,18,17,1,15,10,13,9,4,23,2,0,4,2,2,1,1,0
"Feb 9, 2019 6:00 PM",37,14,23,,,,,,,,,,7,5,2,7,,,,7,7,0,8,12,15,5,10,10,0,0,2,0,2,1,0,1
"Feb 9, 2019 7:00 PM",31,19,12,,,,,,,,,,2,0,2,2,,,,11,9,2,4,9,10,8,2,0,1,1,0,0,0,0,0,0
"Feb 9, 2019 8:00 PM",28,13,15,,,,,,,,,,5,5,0,4,,,,2,2,0,7,5,4,4,0,6,0,0,1,1,0,4,2,2
"Feb 9, 2019 9:00 PM",9,3,6,,,,,,,,,,1,1,0,0,,,,4,4,0,2,12,4,1,3,6,0,0,1,0,1,0,0,0
"Feb 9, 2019 10:00 PM",9,2,7,,,,,,,,,,1,0,1,2,,,,2,2,0,1,2,4,1,3,2,0,0,0,0,0,0,0,0
"Feb 9, 2019 11:00 PM",14,4,10,,,,,,,,,,1,1,0,3,,,,1,1,0,2,2,4,2,2,5,1,1,0,0,0,0,0,0
"Feb 10, 2019 12:00 AM",11,3,8,,,,,,,,,,0,0,0,1,,,,4,4,0,3,2,1,1,0,3,0,0,0,0,0,0,0,0
"Feb 10, 2019 1:00 AM",5,2,3,,,,,,,,,,4,0,4,0,,,,2,1,1,2,2,1,0,1,1,0,0,0,0,0,0,0,0
"Feb 10, 2019 2:00 AM",6,4,2,,,,,,,,,,1,1,0,1,,,,3,3,0,0,2,2,0,2,1,0,2,0,0,0,0,0,0
"Feb 10, 2019 3:00 AM",5,0,5,,,,,,,,,,0,0,0,0,,,,2,2,0,0,4,0,0,0,0,0,0,0,0,0,0,0,0
"Feb 10, 2019 4:00 AM",4,0,4,,,,,,,,,,0,0,0,0,,,,2,2,0,0,2,0,0,0,1,0,0,1,1,0,0,0,0
"Feb 10, 2019 5:00 AM",0,0,0,,,,,,,,,,0,0,0,0,,,,1,1,0,0,1,0,0,0,1,1,0,0,0,0,0,0,0
"Feb 10, 2019 6:00 AM",7,2,5,,,,,,,,,,0,0,0,0,,,,4,4,0,0,3,0,0,0,6,0,0,0,0,0,0,0,0
"Feb 10, 2019 7:00 AM",17,9,8,,,,,,,,,,0,0,0,1,,,,4,2,2,3,13,1,1,0,7,0,0,0,0,0,2,0,2
"Feb 10, 2019 8:00 AM",20,12,8,,,,,,,,,,3,1,2,5,,,,4,4,0,3,6,8,3,5,13,2,7,1,0,1,0,0,0
"Feb 10, 2019 9:00 AM",43,25,18,,,,,,,,,,22,7,15,10,,,,8,4,4,19,18,8,4,4,32,1,11,0,0,0,0,0,0
"Feb 10, 2019 10:00 AM",45,28,17,,,,,,,,,,8,6,2,10,,,,13,11,2,23,17,29,14,15,73,4,9,6,2,4,0,0,0
"Feb 10, 2019 11:00 AM",59,34,25,,,,,,,,,,22,11,11,14,,,,17,15,2,17,18,23,7,16,22,1,4,2,2,0,2,0,2
"Feb 10, 2019 12:00 PM",53,31,22,,,,,,,,,,20,8,12,18,,,,28,21,7,19,32,46,17,29,30,2,1,0,0,0,0,0,0
"Feb 10, 2019 1:00 PM",40,22,18,,,,,,,,,,30,18,12,14,,,,32,31,1,16,30,30,19,11,17,11,3,8,5,3,1,0,1
"Feb 10, 2019 2:00 PM",45,23,22,,,,,,,,,,15,12,3,17,,,,6,5,1,11,23,15,9,6,17,4,4,0,0,0,0,0,0
"Feb 10, 2019 3:00 PM",39,20,19,,,,,,,,,,19,14,5,7,,,,15,11,4,18,25,15,4,11,21,1,1,2,1,1,1,1,0
"Feb 10, 2019 4:00 PM",36,16,20,,,,,,,,,,20,8,12,5,,,,13,11,2,7,10,9,4,5,17,3,1,2,2,0,1,1,0
"Feb 10, 2019 5:00 PM",26,10,16,,,,,,,,,,13,6,7,2,,,,12,12,0,8,10,6,6,0,17,0,3,2,0,2,2,0,2
"Feb 10, 2019 6:00 PM",27,5,22,,,,,,,,,,1,0,1,4,,,,10,10,0,2,7,4,3,1,7,2,0,3,3,0,3,3,0
"Feb 10, 2019 7:00 PM",21,6,15,,,,,,,,,,1,1,0,2,,,,6,5,1,4,8,1,1,0,5,1,0,1,0,1,0,0,0
"Feb 10, 2019 8:00 PM",24,10,14,,,,,,,,,,0,0,0,0,,,,4,4,0,2,4,3,1,2,5,0,0,1,0,1,0,0,0
"Feb 10, 2019 9:00 PM",8,1,7,,,,,,,,,,2,2,0,2,,,,5,5,0,6,1,0,0,0,4,0,0,5,3,2,1,1,0
"Feb 10, 2019 10:00 PM",15,5,10,,,,,,,,,,0,0,0,0,,,,1,1,0,1,2,0,0,0,4,0,2,0,0,0,0,0,0
"Feb 10, 2019 11:00 PM",6,1,5,,,,,,,,,,0,0,0,1,,,,2,2,0,0,0,0,0,0,4,0,0,0,0,0,0,0,0
"Feb 11, 2019 12:00 AM",1,1,0,,,,,,,,,,0,0,0,2,,,,1,1,0,0,2,0,0,0,3,0,1,0,0,0,0,0,0
"Feb 11, 2019 1:00 AM",0,0,0,,,,,,,,,,1,0,1,0,,,,1,1,0,0,0,0,0,0,0,0,0,0,0,0,0,0,0
"Feb 11, 2019 2:00 AM",1,0,1,,,,,,,,,,0,0,0,0,,,,0,0,0,0,1,0,0,0,0,0,0,0,0,0,0,0,0
"Feb 11, 2019 3:00 AM",0,0,0,,,,,,,,,,0,0,0,0,,,,0,0,0,0,1,0,0,0,0,0,0,0,0,0,0,0,0
"Feb 11, 2019 4:00 AM",0,0,0,,,,,,,,,,0,0,0,0,,,,0,0,0,1,1,0,0,0,1,0,0,0,0,0,0,0,0
"Feb 11, 2019 5:00 AM",11,7,4,,,,,,,,,,0,0,0,0,,,,2,2,0,8,1,0,0,0,7,0,0,0,0,0,0,0,0
"Feb 11, 2019 6:00 AM",43,31,12,,,,,,,,,,2,0,2,4,,,,4,3,1,23,7,2,2,0,46,1,0,1,0,1,0,0,0
"Feb 11, 2019 7:00 AM",181,147,34,,,,,,,,,,6,1,5,8,,,,26,20,6,122,27,22,18,4,133,1,7,3,2,1,0,0,0
"Feb 11, 2019 8:00 AM",435,380,55,,,,,,,,,,20,5,15,45,,,,38,23,15,292,65,87,66,21,331,3,3,10,8,2,1,0,1
"Feb 11, 2019 9:00 AM",250,225,25,,,,,,,,,,18,7,11,6,,,,32,14,18,138,24,63,43,20,116,3,2,2,1,1,2,1,1
"Feb 11, 2019 10:00 AM",86,78,8,,,,,,,,,,11,3,8,5,,,,20,5,15,59,13,12,5,7,29,1,0,4,3,1,0,0,0
"Feb 11, 2019 11:00 AM",81,63,18,,,,,,,,,,7,3,4,10,,,,15,8,7,30,13,17,9,8,29,1,2,1,1,0,0,0,0
"Feb 11, 2019 12:00 PM",53,25,28,,,,,,,,,,13,6,7,8,,,,17,15,2,35,8,14,3,11,29,2,1,1,1,0,1,1,0
"Feb 11, 2019 1:00 PM",82,35,47,,,,,,,,,,10,9,1,12,,,,23,18,5,23,23,18,4,14,18,1,1,2,2,0,1,0,1
"Feb 11, 2019 2:00 PM",68,34,34,,,,,,,,,,8,7,1,6,,,,30,26,4,21,28,13,4,9,23,2,1,2,1,1,0,0,0
"Feb 11, 2019 3:00 PM",103,24,79,,,,,,,,,,15,5,10,15,,,,48,48,0,21,24,23,8,15,21,1,4,3,1,2,1,1,0
"Feb 11, 2019 4:00 PM",159,31,128,,,,,,,,,,13,9,4,24,,,,94,88,6,25,69,36,8,28,37,2,8,1,0,1,3,3,0
"Feb 11, 2019 5:00 PM",344,54,290,,,,,,,,,,14,10,4,18,,,,190,180,10,30,126,57,13,44,68,9,4,2,2,0,0,0,0
"Feb 11, 2019 6:00 PM",332,48,284,,,,,,,,,,18,13,5,30,,,,186,181,5,28,180,82,7,75,39,7,4,9,5,4,1,1,0
"Feb 11, 2019 7:00 PM",193,42,151,,,,,,,,,,2,2,0,7,,,,103,101,2,20,84,39,4,35,21,7,4,3,2,1,1,0,1
"Feb 11, 2019 8:00 PM",114,25,89,,,,,,,,,,2,2,0,3,,,,77,77,0,10,34,20,2,18,17,1,3,5,4,1,0,0,0
"Feb 11, 2019 9:00 PM",91,12,79,,,,,,,,,,2,1,1,6,,,,28,25,3,17,22,15,2,13,20,2,0,1,0,1,1,1,0
"Feb 11, 2019 10:00 PM",44,3,41,,,,,,,,,,2,1,1,0,,,,18,18,0,4,14,5,0,5,8,1,3,0,0,0,0,0,0
"Feb 11, 2019 11:00 PM",11,0,11,,,,,,,,,,1,0,1,2,,,,11,11,0,3,5,4,2,2,1,1,0,0,0,0,1,0,1
"Feb 12, 2019 12:00 AM",6,1,5,,,,,,,,,,0,0,0,1,,,,4,4,0,0,4,1,1,0,0,0,0,0,0,0,0,0,0
"Feb 12, 2019 1:00 AM",3,1,2,,,,,,,,,,0,0,0,0,,,,2,2,0,0,1,0,0,0,1,0,1,0,0,0,0,0,0
"Feb 12, 2019 2:00 AM",0,0,0,,,,,,,,,,0,0,0,0,,,,0,0,0,0,0,0,0,0,1,0,0,0,0,0,0,0,0
"Feb 12, 2019 3:00 AM",1,0,1,,,,,,,,,,0,0,0,0,,,,2,2,0,0,0,0,0,0,0,0,0,0,0,0,0,0,0
"Feb 12, 2019 4:00 AM",2,2,0,,,,,,,,,,0,0,0,0,,,,0,0,0,1,0,0,0,0,0,0,0,0,0,0,0,0,0
"Feb 12, 2019 5:00 AM",6,3,3,,,,,,,,,,0,0,0,1,,,,1,1,0,6,3,0,0,0,8,1,1,0,0,0,0,0,0
"Feb 12, 2019 6:00 AM",59,48,11,,,,,,,,,,1,0,1,4,,,,8,7,1,25,11,4,3,1,52,0,1,0,0,0,0,0,0
"Feb 12, 2019 7:00 AM",225,181,44,,,,,,,,,,8,1,7,13,,,,31,22,9,134,36,26,21,5,166,4,3,5,3,2,0,0,0
"Feb 12, 2019 8:00 AM",453,385,68,,,,,,,,,,20,8,12,36,,,,45,25,20,320,53,98,77,21,328,3,7,10,7,3,5,2,3
"Feb 12, 2019 9:00 AM",249,212,37,,,,,,,,,,15,2,13,9,,,,27,12,15,133,29,48,37,11,115,0,1,1,1,0,1,0,1
"Feb 12, 2019 10:00 AM",88,78,10,,,,,,,,,,9,4,5,7,,,,17,8,9,69,13,23,9,14,36,1,2,1,0,1,0,0,0
"Feb 12, 2019 11:00 AM",59,40,19,,,,,,,,,,3,1,2,3,,,,12,6,6,32,17,5,2,3,25,4,2,4,3,1,1,1,0
"Feb 12, 2019 12:00 PM",50,23,27,,,,,,,,,,9,4,5,8,,,,18,17,1,28,12,8,2,6,12,1,3,2,1,1,0,0,0
"Feb 12, 2019 1:00 PM",80,42,38,,,,,,,,,,15,8,7,7,,,,28,24,4,18,18,17,5,12,22,2,0,2,1,1,0,0,0
"Feb 12, 2019 2:00 PM",59,27,32,,,,,,,,,,13,8,5,8,,,,25,24,1,21,18,16,5,11,15,1,1,0,0,0,1,1,0
"Feb 12, 2019 3:00 PM",96,21,75,,,,,,,,,,6,3,3,12,,,,47,44,3,13,30,24,4,20,20,2,3,4,1,3,0,0,0
"Feb 12, 2019 4:00 PM",164,42,122,,,,,,,,,,13,10,3,24,,,,87,85,2,26,60,31,12,19,35,4,1,6,4,2,0,0,0
"Feb 12, 2019 5:00 PM",363,72,291,,,,,,,,,,15,11,4,24,,,,184,178,6,38,154,56,5,51,75,7,7,7,5,2,0,0,0
"Feb 12, 2019 6:00 PM",326,61,265,,,,,,,,,,25,20,5,29,,,,203,197,6,40,191,102,13,89,58,10,4,7,3,4,5,3,2
"Feb 12, 2019 7:00 PM",207,40,167,,,,,,,,,,10,2,8,9,,,,96,96,0,23,89,48,9,39,20,3,2,1,1,0,1,0,1
"Feb 12, 2019 8:00 PM",118,29,89,,,,,,,,,,9,7,2,11,,,,57,54,3,11,39,22,1,21,20,2,2,2,0,2,0,0,0
"Feb 12, 2019 9:00 PM",84,16,68,,,,,,,,,,3,2,1,21,,,,28,26,2,12,27,4,0,4,15,1,0,2,1,1,0,0,0
"Feb 12, 2019 10:00 PM",60,11,49,,,,,,,,,,1,0,1,2,,,,29,27,2,5,16,9,3,6,12,0,1,0,0,0,0,0,0
"Feb 12, 2019 11:00 PM",19,6,13,,,,,,,,,,0,0,0,0,,,,10,10,0,4,2,1,0,1,4,0,0,0,0,0,0,0,0
"Feb 13, 2019 12:00 AM",7,1,6,,,,,,,,,,0,0,0,0,,,,8,8,0,1,3,1,0,1,3,1,1,0,0,0,1,1,0
"Feb 13, 2019 1:00 AM",4,1,3,,,,,,,,,,1,1,0,0,,,,2,2,0,1,1,0,0,0,0,0,0,0,0,0,0,0,0
"Feb 13, 2019 2:00 AM",4,0,4,,,,,,,,,,0,0,0,1,,,,5,5,0,0,1,0,0,0,0,0,1,0,0,0,0,0,0
"Feb 13, 2019 3:00 AM",2,1,1,,,,,,,,,,0,0,0,0,,,,2,2,0,0,0,0,0,0,0,0,0,0,0,0,0,0,0
"Feb 13, 2019 4:00 AM",0,0,0,,,,,,,,,,0,0,0,0,,,,1,1,0,1,0,0,0,0,1,0,0,0,0,0,0,0,0
"Feb 13, 2019 5:00 AM",6,4,2,,,,,,,,,,0,0,0,1,,,,1,1,0,6,1,0,0,0,7,1,0,0,0,0,0,0,0
"Feb 13, 2019 6:00 AM",47,40,7,,,,,,,,,,2,0,2,7,,,,8,6,2,21,7,4,2,2,47,1,2,3,1,2,0,0,0
"Feb 13, 2019 7:00 AM",222,173,49,,,,,,,,,,7,0,7,9,,,,26,18,8,162,40,23,20,3,157,2,5,4,3,1,0,0,0
"Feb 13, 2019 8:00 AM",448,383,65,,,,,,,,,,23,2,21,42,,,,44,28,16,296,68,104,82,22,315,4,4,8,5,3,2,0,2
"Feb 13, 2019 9:00 AM",231,209,22,,,,,,,,,,9,6,3,11,,,,30,13,17,145,37,51,31,20,118,4,3,7,5,2,2,0,2
"Feb 13, 2019 10:00 AM",54,37,17,,,,,,,,,,4,1,3,8,,,,21,15,6,72,24,11,9,2,31,3,0,2,2,0,0,0,0
"Feb 13, 2019 11:00 AM",77,60,17,,,,,,,,,,10,3,7,5,,,,16,11,5,38,12,11,6,5,38,2,1,4,1,3,2,1,1
"Feb 13, 2019 12:00 PM",81,48,33,,,,,,,,,,16,8,8,7,,,,24,21,3,27,17,19,8,11,25,2,0,3,3,0,0,0,0
"Feb 13, 2019 1:00 PM",92,31,61,,,,,,,,,,6,4,2,12,,,,41,33,8,36,27,15,6,9,27,3,1,3,1,2,0,0,0
"Feb 13, 2019 2:00 PM",78,30,48,,,,,,,,,,14,7,7,12,,,,38,35,3,22,21,23,9,14,19,2,2,3,3,0,1,1,0
"Feb 13, 2019 3:00 PM",81,22,59,,,,,,,,,,13,9,4,14,,,,45,42,3,21,20,16,2,14,19,2,1,7,3,4,1,0,1
"Feb 13, 2019 4:00 PM",164,48,116,,,,,,,,,,9,8,1,14,,,,90,87,3,24,53,38,7,31,38,4,1,3,3,0,0,0,0
"Feb 13, 2019 5:00 PM",321,60,261,,,,,,,,,,21,15,6,22,,,,175,172,3,37,145,61,12,49,83,8,2,6,6,0,2,1,1
"Feb 13, 2019 6:00 PM",338,55,283,,,,,,,,,,13,13,0,24,,,,176,172,4,28,190,83,12,71,56,2,1,9,5,4,0,0,0
"Feb 13, 2019 7:00 PM",192,26,166,,,,,,,,,,8,7,1,5,,,,92,91,1,18,84,36,2,34,25,3,3,2,0,2,4,2,2
"Feb 13, 2019 8:00 PM",123,27,96,,,,,,,,,,9,8,1,6,,,,59,57,2,14,50,15,4,11,19,3,2,3,2,1,3,3,0
"Feb 13, 2019 9:00 PM",78,16,62,,,,,,,,,,4,2,2,4,,,,44,42,2,11,30,9,1,8,15,5,0,1,1,0,1,1,0
"Feb 13, 2019 10:00 PM",46,12,34,,,,,,,,,,2,1,1,5,,,,27,27,0,7,12,6,1,5,12,1,0,1,1,0,0,0,0
"Feb 13, 2019 11:00 PM",22,7,15,,,,,,,,,,2,2,0,0,,,,7,7,0,7,5,2,0,2,0,1,0,0,0,0,1,1,0
"Feb 14, 2019 12:00 AM",9,2,7,,,,,,,,,,0,0,0,0,,,,3,3,0,0,6,0,0,0,4,0,0,1,1,0,0,0,0
"Feb 14, 2019 1:00 AM",4,1,3,,,,,,,,,,0,0,0,0,,,,4,4,0,0,0,1,0,1,0,0,0,0,0,0,0,0,0
"Feb 14, 2019 2:00 AM",2,0,2,,,,,,,,,,0,0,0,0,,,,2,2,0,0,1,0,0,0,0,0,0,0,0,0,0,0,0
"Feb 14, 2019 3:00 AM",3,2,1,,,,,,,,,,0,0,0,0,,,,0,0,0,0,1,0,0,0,2,0,0,0,0,0,0,0,0
"Feb 14, 2019 4:00 AM",2,2,0,,,,,,,,,,0,0,0,0,,,,3,3,0,0,0,0,0,0,1,0,0,0,0,0,0,0,0
"Feb 14, 2019 5:00 AM",6,4,2,,,,,,,,,,0,0,0,3,,,,2,2,0,6,2,0,0,0,7,1,0,0,0,0,0,0,0
"Feb 14, 2019 6:00 AM",50,36,14,,,,,,,,,,4,0,4,5,,,,6,6,0,22,8,4,4,0,39,3,1,1,0,1,0,0,0
"Feb 14, 2019 7:00 AM",200,165,35,,,,,,,,,,10,1,9,14,,,,25,18,7,127,31,21,13,8,156,3,2,3,2,1,0,0,0
"Feb 14, 2019 8:00 AM",426,355,71,,,,,,,,,,19,5,14,30,,,,41,20,21,262,61,99,84,15,287,3,8,10,8,2,2,1,1
"Feb 14, 2019 9:00 AM",221,191,30,,,,,,,,,,18,6,12,15,,,,18,12,6,129,37,47,28,19,120,3,4,3,2,1,0,0,0
"Feb 14, 2019 10:00 AM",103,84,19,,,,,,,,,,10,3,7,15,,,,17,10,7,66,11,15,9,6,29,3,2,4,3,1,7,2,5
"Feb 14, 2019 11:00 AM",77,52,25,,,,,,,,,,8,6,2,3,,,,19,15,4,30,20,18,7,11,18,1,0,1,0,1,0,0,0
"Feb 14, 2019 12:00 PM",71,46,25,,,,,,,,,,14,10,4,6,,,,21,17,4,22,17,17,7,10,25,0,2,2,1,1,1,0,1
"Feb 14, 2019 1:00 PM",105,40,65,,,,,,,,,,11,10,1,11,,,,31,31,0,28,29,17,6,11,30,1,0,3,3,0,0,0,0
"Feb 14, 2019 2:00 PM",61,28,33,,,,,,,,,,23,14,9,11,,,,42,38,4,22,33,35,14,21,19,1,1,2,2,0,2,1,1
"Feb 14, 2019 3:00 PM",74,31,43,,,,,,,,,,13,6,7,10,,,,45,42,3,23,26,16,2,14,24,2,2,3,2,1,1,1,0
"Feb 14, 2019 4:00 PM",162,43,119,,,,,,,,,,25,21,4,31,,,,85,83,2,20,73,33,7,26,31,4,3,3,0,3,3,3,0
"Feb 14, 2019 5:00 PM",340,58,282,,,,,,,,,,20,13,7,30,,,,194,187,7,43,160,80,15,65,81,6,3,4,3,1,0,0,0
"Feb 14, 2019 6:00 PM",305,49,256,,,,,,,,,,22,21,1,25,,,,175,166,9,46,162,78,14,64,46,6,3,6,3,3,0,0,0
"Feb 14, 2019 7:00 PM",164,30,134,,,,,,,,,,10,9,1,8,,,,67,65,2,13,70,34,0,34,20,1,1,2,1,1,1,1,0
"Feb 14, 2019 8:00 PM",102,32,70,,,,,,,,,,8,3,5,4,,,,41,39,2,10,36,14,1,13,17,3,1,3,1,2,0,0,0
"Feb 14, 2019 9:00 PM",66,14,52,,,,,,,,,,2,2,0,1,,,,18,18,0,9,23,11,1,10,15,0,0,1,0,1,0,0,0
"Feb 14, 2019 10:00 PM",37,14,23,,,,,,,,,,4,2,2,2,,,,17,15,2,4,14,8,1,7,3,0,2,0,0,0,0,0,0
"Feb 14, 2019 11:00 PM",22,4,18,,,,,,,,,,1,0,1,2,,,,13,13,0,10,4,11,6,5,8,0,1,0,0,0,0,0,0
"Feb 15, 2019 12:00 AM",7,1,6,,,,,,,,,,0,0,0,0,,,,10,10,0,1,4,1,0,1,7,0,0,0,0,0,0,0,0
"Feb 15, 2019 1:00 AM",5,1,4,,,,,,,,,,0,0,0,2,,,,2,2,0,0,2,0,0,0,3,0,0,0,0,0,0,0,0
"Feb 15, 2019 2:00 AM",1,0,1,,,,,,,,,,0,0,0,0,,,,1,1,0,0,1,0,0,0,0,0,0,0,0,0,0,0,0
"Feb 15, 2019 3:00 AM",4,1,3,,,,,,,,,,0,0,0,0,,,,6,6,0,0,0,0,0,0,2,0,0,0,0,0,0,0,0
"Feb 15, 2019 4:00 AM",2,2,0,,,,,,,,,,0,0,0,0,,,,4,3,1,0,0,0,0,0,1,0,0,0,0,0,0,0,0
"Feb 15, 2019 5:00 AM",9,8,1,,,,,,,,,,0,0,0,2,,,,2,2,0,5,3,0,0,0,8,1,0,0,0,0,1,0,1
"Feb 15, 2019 6:00 AM",42,30,12,,,,,,,,,,1,0,1,4,,,,8,8,0,20,8,1,1,0,37,0,0,2,1,1,0,0,0
"Feb 15, 2019 7:00 AM",151,120,31,,,,,,,,,,6,0,6,12,,,,17,11,6,101,31,24,19,5,123,2,2,3,1,2,1,1,0
"Feb 15, 2019 8:00 AM",329,280,49,,,,,,,,,,16,6,10,29,,,,35,24,11,194,49,60,47,13,233,4,7,6,3,3,3,1,2
"Feb 15, 2019 9:00 AM",201,173,28,,,,,,,,,,13,3,10,8,,,,22,12,10,104,33,46,34,12,94,6,5,2,1,1,2,0,2
"Feb 15, 2019 10:00 AM",70,50,20,,,,,,,,,,8,3,5,8,,,,15,4,11,64,12,19,11,8,26,3,2,1,1,0,0,0,0
"Feb 15, 2019 11:00 AM",57,34,23,,,,,,,,,,5,2,3,9,,,,28,16,12,32,13,17,5,12,17,0,0,5,3,2,1,0,1
"Feb 15, 2019 12:00 PM",80,41,39,,,,,,,,,,10,4,6,6,,,,30,26,4,20,21,22,9,13,22,3,1,0,0,0,0,0,0
"Feb 15, 2019 1:00 PM",92,41,51,,,,,,,,,,9,5,4,7,,,,31,28,3,27,21,21,6,15,30,3,0,1,1,0,1,0,1
"Feb 15, 2019 2:00 PM",68,27,41,,,,,,,,,,11,7,4,10,,,,38,36,2,21,33,23,3,20,24,2,4,4,2,2,2,0,2
"Feb 15, 2019 3:00 PM",86,20,66,,,,,,,,,,15,8,7,14,,,,37,35,2,21,41,35,6,29,28,3,1,2,2,0,2,2,0
"Feb 15, 2019 4:00 PM",158,37,121,,,,,,,,,,14,8,6,14,,,,92,91,1,21,57,40,13,27,57,4,0,6,4,2,0,0,0
"Feb 15, 2019 5:00 PM",273,47,226,,,,,,,,,,17,14,3,30,,,,133,128,5,23,151,54,11,43,60,4,2,3,3,0,0,0,0
"Feb 15, 2019 6:00 PM",202,33,169,,,,,,,,,,19,16,3,20,,,,109,108,1,15,109,44,5,39,23,4,3,4,2,2,1,0,1
"Feb 15, 2019 7:00 PM",106,32,74,,,,,,,,,,6,4,2,5,,,,42,42,0,26,47,31,2,29,12,1,1,1,1,0,0,0,0
"Feb 15, 2019 8:00 PM",51,20,31,,,,,,,,,,2,1,1,7,,,,24,23,1,11,17,6,1,5,10,1,0,1,0,1,1,1,0
"Feb 15, 2019 9:00 PM",48,13,35,,,,,,,,,,2,2,0,1,,,,21,21,0,6,8,8,4,4,12,2,0,0,0,0,0,0,0
"Feb 15, 2019 10:00 PM",27,7,20,,,,,,,,,,4,2,2,5,,,,12,12,0,3,7,1,0,1,11,0,0,2,1,1,0,0,0
"Feb 15, 2019 11:00 PM",19,3,16,,,,,,,,,,1,1,0,2,,,,6,6,0,5,7,8,5,3,3,0,0,0,0,0,0,0,0
"Feb 16, 2019 12:00 AM",15,5,10,,,,,,,,,,2,0,2,0,,,,7,6,1,3,7,2,0,2,6,0,0,0,0,0,0,0,0
"Feb 16, 2019 1:00 AM",8,2,6,,,,,,,,,,0,0,0,1,,,,4,4,0,1,1,3,2,1,4,0,2,0,0,0,0,0,0
"Feb 16, 2019 2:00 AM",7,1,6,,,,,,,,,,0,0,0,0,,,,4,4,0,1,3,0,0,0,1,0,2,0,0,0,0,0,0
"Feb 16, 2019 3:00 AM",2,1,1,,,,,,,,,,0,0,0,0,,,,4,4,0,0,5,1,0,1,1,0,0,0,0,0,0,0,0
"Feb 16, 2019 4:00 AM",1,1,0,,,,,,,,,,0,0,0,1,,,,2,2,0,0,2,1,1,0,5,0,0,0,0,0,0,0,0
"Feb 16, 2019 5:00 AM",2,0,2,,,,,,,,,,0,0,0,0,,,,3,2,1,1,1,0,0,0,0,0,0,0,0,0,0,0,0
"Feb 16, 2019 6:00 AM",13,5,8,,,,,,,,,,0,0,0,3,,,,2,2,0,6,4,1,0,1,7,0,0,0,0,0,0,0,0
"Feb 16, 2019 7:00 AM",14,7,7,,,,,,,,,,0,0,0,0,,,,6,6,0,8,6,1,0,1,10,0,0,1,1,0,0,0,0
"Feb 16, 2019 8:00 AM",30,17,13,,,,,,,,,,9,2,7,6,,,,8,6,2,8,9,5,3,2,13,1,6,0,0,0,1,0,1
"Feb 16, 2019 9:00 AM",41,22,19,,,,,,,,,,7,2,5,14,,,,10,7,3,27,21,15,7,8,31,2,7,1,0,1,0,0,0
"Feb 16, 2019 10:00 AM",51,29,22,,,,,,,,,,17,9,8,11,,,,8,7,1,17,14,13,6,7,25,4,4,2,0,2,0,0,0
"Feb 16, 2019 11:00 AM",50,31,19,,,,,,,,,,31,24,7,17,,,,18,9,9,25,22,27,9,18,28,10,1,7,4,3,1,1,0
"Feb 16, 2019 12:00 PM",58,36,22,,,,,,,,,,11,5,6,26,,,,21,16,5,18,21,35,13,22,16,2,2,8,5,3,1,0,1
"Feb 16, 2019 1:00 PM",46,18,28,,,,,,,,,,22,6,16,21,,,,21,18,3,21,33,34,14,20,24,3,2,3,3,0,1,0,1
"Feb 16, 2019 2:00 PM",55,30,25,,,,,,,,,,24,12,12,14,,,,13,10,3,22,18,28,12,16,21,7,3,6,4,2,2,1,1
"Feb 16, 2019 3:00 PM",42,22,20,,,,,,,,,,13,8,5,14,,,,17,14,3,18,16,30,10,20,23,5,1,2,1,1,0,0,0
"Feb 16, 2019 4:00 PM",53,21,32,,,,,,,,,,13,6,7,19,,,,26,23,3,15,20,32,20,12,17,6,1,8,4,4,2,1,1
"Feb 16, 2019 5:00 PM",59,23,36,,,,,,,,,,9,5,4,12,,,,35,30,5,8,19,20,9,11,15,6,0,5,3,2,1,1,0
"Feb 16, 2019 6:00 PM",43,11,32,,,,,,,,,,4,2,2,12,,,,11,10,1,13,16,10,7,3,12,1,0,4,2,2,4,2,2
"Feb 16, 2019 7:00 PM",41,18,23,,,,,,,,,,1,0,1,3,,,,6,5,1,4,11,12,5,7,8,0,0,2,1,1,0,0,0
"Feb 16, 2019 8:00 PM",21,12,9,,,,,,,,,,7,5,2,2,,,,4,3,1,10,6,1,1,0,11,0,0,0,0,0,0,0,0
"Feb 16, 2019 9:00 PM",18,8,10,,,,,,,,,,2,2,0,1,,,,3,3,0,1,1,4,2,2,6,0,0,0,0,0,0,0,0
"Feb 16, 2019 10:00 PM",7,0,7,,,,,,,,,,0,0,0,6,,,,7,6,1,5,3,3,1,2,4,0,0,1,1,0,0,0,0
"Feb 16, 2019 11:00 PM",13,3,10,,,,,,,,,,0,0,0,3,,,,6,6,0,2,2,2,1,1,6,0,0,1,0,1,0,0,0
"Feb 17, 2019 12:00 AM",11,5,6,,,,,,,,,,3,1,2,0,,,,1,1,0,3,0,1,1,0,3,0,0,0,0,0,0,0,0
"Feb 17, 2019 1:00 AM",2,0,2,,,,,,,,,,1,1,0,0,,,,2,2,0,2,1,1,0,1,1,0,2,0,0,0,0,0,0
"Feb 17, 2019 2:00 AM",1,0,1,,,,,,,,,,1,0,1,0,,,,0,0,0,0,2,1,0,1,1,0,2,0,0,0,0,0,0
"Feb 17, 2019 3:00 AM",2,0,2,,,,,,,,,,0,0,0,1,,,,0,0,0,0,1,0,0,0,0,0,0,0,0,0,0,0,0
"Feb 17, 2019 4:00 AM",2,0,2,,,,,,,,,,0,0,0,0,,,,1,1,0,0,1,1,0,1,2,0,0,0,0,0,0,0,0
"Feb 17, 2019 5:00 AM",3,0,3,,,,,,,,,,0,0,0,0,,,,2,2,0,0,3,0,0,0,1,0,0,0,0,0,0,0,0
"Feb 17, 2019 6:00 AM",7,5,2,,,,,,,,,,0,0,0,0,,,,3,3,0,5,6,0,0,0,5,1,0,0,0,0,0,0,0
"Feb 17, 2019 7:00 AM",13,5,8,,,,,,,,,,1,1,0,1,,,,3,3,0,5,9,0,0,0,15,0,0,1,1,0,0,0,0
"Feb 17, 2019 8:00 AM",14,3,11,,,,,,,,,,2,2,0,5,,,,6,4,2,5,11,6,3,3,5,0,11,0,0,0,0,0,0
"Feb 17, 2019 9:00 AM",50,31,19,,,,,,,,,,9,4,5,13,,,,18,13,5,23,14,9,1,8,44,1,10,1,0,1,0,0,0
"Feb 17, 2019 10:00 AM",42,27,15,,,,,,,,,,7,3,4,4,,,,8,4,4,26,21,38,11,27,32,3,14,9,1,8,0,0,0
"Feb 17, 2019 11:00 AM",54,25,29,,,,,,,,,,31,13,18,16,,,,12,8,4,25,29,30,8,22,25,12,5,3,3,0,1,0,1
"Feb 17, 2019 12:00 PM",53,29,24,,,,,,,,,,56,18,38,6,,,,24,16,8,16,32,42,14,28,30,7,11,4,3,1,3,0,3
"Feb 17, 2019 1:00 PM",52,33,19,,,,,,,,,,33,20,13,8,,,,15,13,2,17,21,39,19,20,34,6,2,13,8,5,0,0,0
"Feb 17, 2019 2:00 PM",47,25,22,,,,,,,,,,36,19,17,7,,,,14,12,2,18,22,35,14,21,27,5,4,5,1,4,0,0,0
"Feb 17, 2019 3:00 PM",34,15,19,,,,,,,,,,28,14,14,15,,,,9,5,4,19,16,34,12,22,23,0,3,1,0,1,0,0,0
"Feb 17, 2019 4:00 PM",52,23,29,,,,,,,,,,20,14,6,9,,,,19,16,3,17,9,23,11,12,26,4,1,3,2,1,1,1,0
"Feb 17, 2019 5:00 PM",48,12,36,,,,,,,,,,8,7,1,4,,,,16,13,3,4,14,24,15,9,19,3,1,3,1,2,4,2,2
"Feb 17, 2019 6:00 PM",40,15,25,,,,,,,,,,4,1,3,9,,,,23,20,3,9,13,15,12,3,13,2,0,2,0,2,0,0,0
"Feb 17, 2019 7:00 PM",21,7,14,,,,,,,,,,2,1,1,7,,,,15,11,4,8,9,4,2,2,10,0,1,1,1,0,1,1,0
"Feb 17, 2019 8:00 PM",27,12,15,,,,,,,,,,4,2,2,2,,,,9,8,1,5,6,0,0,0,7,1,0,3,1,2,3,1,2
"Feb 17, 2019 9:00 PM",17,5,12,,,,,,,,,,2,2,0,3,,,,8,7,1,5,3,3,2,1,9,1,1,1,0,1,1,1,0
"Feb 17, 2019 10:00 PM",12,4,8,,,,,,,,,,2,1,1,2,,,,6,6,0,4,2,0,0,0,5,0,0,1,0,1,0,0,0
"Feb 17, 2019 11:00 PM",6,1,5,,,,,,,,,,1,1,0,4,,,,1,1,0,3,2,0,0,0,3,0,2,0,0,0,0,0,0
"Feb 18, 2019 12:00 AM",5,4,1,,,,,,,,,,0,0,0,3,,,,2,2,0,2,3,0,0,0,0,1,1,1,1,0,0,0,0
"Feb 18, 2019 1:00 AM",0,0,0,,,,,,,,,,1,0,1,0,,,,1,1,0,0,1,0,0,0,0,0,0,0,0,0,0,0,0
"Feb 18, 2019 2:00 AM",2,0,2,,,,,,,,,,0,0,0,0,,,,0,0,0,0,1,1,1,0,0,0,0,0,0,0,0,0,0
"Feb 18, 2019 3:00 AM",1,0,1,,,,,,,,,,0,0,0,0,,,,0,0,0,0,0,0,0,0,0,0,0,0,0,0,0,0,0
"Feb 18, 2019 4:00 AM",1,0,1,,,,,,,,,,0,0,0,0,,,,0,0,0,2,0,0,0,0,0,1,0,0,0,0,0,0,0
"Feb 18, 2019 5:00 AM",2,1,1,,,,,,,,,,2,0,2,1,,,,1,1,0,6,1,0,0,0,9,1,0,0,0,0,0,0,0
"Feb 18, 2019 6:00 AM",43,33,10,,,,,,,,,,2,0,2,3,,,,5,4,1,25,12,2,1,1,45,1,0,0,0,0,0,0,0
"Feb 18, 2019 7:00 AM",183,150,33,,,,,,,,,,5,0,5,11,,,,24,19,5,115,34,29,22,7,144,1,4,2,1,1,3,0,3
"Feb 18, 2019 8:00 AM",407,346,61,,,,,,,,,,17,3,14,30,,,,42,23,19,284,57,89,76,13,318,1,4,7,4,3,0,0,0
"Feb 18, 2019 9:00 AM",196,173,23,,,,,,,,,,17,6,11,10,,,,29,12,17,131,38,49,28,21,103,2,4,3,3,0,2,1,1
"Feb 18, 2019 10:00 AM",92,71,21,,,,,,,,,,9,2,7,9,,,,24,13,11,57,12,12,7,5,42,4,0,0,0,0,0,0,0
"Feb 18, 2019 11:00 AM",84,64,20,,,,,,,,,,3,1,2,7,,,,15,9,6,35,18,13,5,8,27,2,3,2,2,0,1,0,1
"Feb 18, 2019 12:00 PM",61,43,18,,,,,,,,,,12,9,3,10,,,,19,15,4,30,11,9,2,7,14,4,4,2,1,1,0,0,0
"Feb 18, 2019 1:00 PM",78,31,47,,,,,,,,,,16,9,7,11,,,,31,25,6,30,23,15,7,8,17,1,1,2,1,1,4,3,1
"Feb 18, 2019 2:00 PM",69,31,38,,,,,,,,,,19,11,8,9,,,,34,30,4,22,19,10,1,9,17,2,0,4,3,1,2,0,2
"Feb 18, 2019 3:00 PM",75,18,57,,,,,,,,,,11,4,7,22,,,,48,46,2,13,27,15,4,11,13,2,1,1,1,0,1,0,1
"Feb 18, 2019 4:00 PM",161,33,128,,,,,,,,,,18,8,10,8,,,,78,77,1,22,74,26,7,19,36,5,1,11,8,3,1,0,1
"Feb 18, 2019 5:00 PM",335,61,274,,,,,,,,,,24,16,8,15,,,,157,152,5,34,143,62,13,49,76,3,2,0,0,0,0,0,0
"Feb 18, 2019 6:00 PM",330,59,271,,,,,,,,,,19,17,2,14,,,,175,166,9,29,181,92,8,84,46,5,4,1,1,0,1,1,0
"Feb 18, 2019 7:00 PM",167,25,142,,,,,,,,,,10,7,3,9,,,,95,93,2,26,83,32,3,29,27,3,2,0,0,0,0,0,0
"Feb 18, 2019 8:00 PM",103,20,83,,,,,,,,,,14,7,7,9,,,,54,53,1,15,42,19,3,16,18,2,0,2,2,0,2,1,1
"Feb 18, 2019 9:00 PM",65,6,59,,,,,,,,,,2,2,0,5,,,,32,32,0,8,30,3,1,2,15,3,1,0,0,0,0,0,0
"Feb 18, 2019 10:00 PM",41,4,37,,,,,,,,,,3,3,0,2,,,,22,20,2,2,10,3,0,3,4,0,0,0,0,0,0,0,0
"Feb 18, 2019 11:00 PM",17,2,15,,,,,,,,,,3,1,2,0,,,,7,7,0,1,7,2,0,2,0,0,0,0,0,0,0,0,0
"Feb 19, 2019 12:00 AM",9,1,8,,,,,,,,,,2,2,0,0,,,,5,5,0,1,5,0,0,0,4,0,0,0,0,0,1,1,0
"Feb 19, 2019 1:00 AM",3,1,2,,,,,,,,,,2,0,2,0,,,,2,2,0,0,0,0,0,0,1,0,1,0,0,0,0,0,0
"Feb 19, 2019 2:00 AM",0,0,0,,,,,,,,,,0,0,0,0,,,,1,1,0,0,1,0,0,0,0,0,0,0,0,0,0,0,0
"Feb 19, 2019 3:00 AM",1,1,0,,,,,,,,,,0,0,0,0,,,,0,0,0,0,0,0,0,0,0,0,0,0,0,0,0,0,0
"Feb 19, 2019 4:00 AM",4,2,2,,,,,,,,,,0,0,0,0,,,,1,1,0,1,0,0,0,0,0,1,0,0,0,0,0,0,0
"Feb 19, 2019 5:00 AM",6,5,1,,,,,,,,,,0,0,0,1,,,,1,1,0,8,5,0,0,0,8,1,0,0,0,0,0,0,0
"Feb 19, 2019 6:00 AM",44,35,9,,,,,,,,,,1,0,1,5,,,,5,4,1,29,6,2,2,0,58,0,2,2,1,1,2,0,2
"Feb 19, 2019 7:00 AM",204,166,38,,,,,,,,,,9,1,8,14,,,,34,18,16,127,35,29,23,6,153,0,5,1,0,1,0,0,0
"Feb 19, 2019 8:00 AM",389,325,64,,,,,,,,,,17,4,13,29,,,,39,22,17,268,53,69,61,8,320,3,5,8,3,5,1,1,0
"Feb 19, 2019 9:00 AM",229,202,27,,,,,,,,,,13,2,11,6,,,,39,18,21,122,31,43,32,11,106,2,6,1,1,0,1,0,1
"Feb 19, 2019 10:00 AM",111,89,22,,,,,,,,,,5,2,3,11,,,,18,8,10,61,13,13,8,5,36,5,2,2,2,0,1,0,1
"Feb 19, 2019 11:00 AM",56,38,18,,,,,,,,,,4,1,3,19,,,,12,10,2,40,9,14,5,9,16,3,2,1,1,0,1,0,1
"Feb 19, 2019 12:00 PM",63,34,29,,,,,,,,,,17,4,13,22,,,,22,19,3,35,12,14,6,8,21,2,2,1,1,0,0,0,0
"Feb 19, 2019 1:00 PM",76,35,41,,,,,,,,,,13,11,2,17,,,,18,15,3,11,13,11,5,6,16,2,1,2,1,1,0,0,0
"Feb 19, 2019 2:00 PM",58,24,34,,,,,,,,,,10,8,2,7,,,,20,19,1,10,19,12,4,8,10,0,1,1,1,0,1,0,1
"Feb 19, 2019 3:00 PM",81,16,65,,,,,,,,,,2,2,0,3,,,,36,35,1,12,20,8,1,7,10,4,0,6,4,2,1,1,0
"Feb 19, 2019 4:00 PM",128,25,103,,,,,,,,,,7,4,3,6,,,,63,63,0,17,58,14,0,14,39,2,0,2,2,0,1,0,1
"Feb 19, 2019 5:00 PM",281,57,224,,,,,,,,,,11,8,3,15,,,,153,147,6,34,117,74,8,66,50,4,3,3,3,0,3,3,0
"Feb 19, 2019 6:00 PM",319,57,262,,,,,,,,,,15,14,1,17,,,,160,155,5,32,170,73,6,67,39,4,3,3,1,2,0,0,0
"Feb 19, 2019 7:00 PM",188,27,161,,,,,,,,,,6,6,0,10,,,,99,98,1,21,86,41,5,36,21,2,0,4,1,3,1,1,0
"Feb 19, 2019 8:00 PM",102,15,87,,,,,,,,,,3,2,1,1,,,,57,56,1,6,37,20,3,17,12,3,2,3,2,1,2,2,0
"Feb 19, 2019 9:00 PM",59,15,44,,,,,,,,,,2,1,1,2,,,,32,32,0,6,19,16,5,11,10,0,0,0,0,0,1,1,0
"Feb 19, 2019 10:00 PM",57,8,49,,,,,,,,,,2,2,0,5,,,,25,23,2,3,13,5,2,3,13,1,0,1,0,1,0,0,0
"Feb 19, 2019 11:00 PM",11,1,10,,,,,,,,,,1,1,0,0,,,,7,7,0,2,6,1,0,1,6,0,1,0,0,0,0,0,0
"Feb 20, 2019 12:00 AM",10,2,8,,,,,,,,,,1,0,1,1,,,,3,3,0,1,0,1,0,1,1,0,1,0,0,0,0,0,0
"Feb 20, 2019 1:00 AM",2,0,2,,,,,,,,,,0,0,0,0,,,,0,0,0,0,0,0,0,0,0,0,0,0,0,0,0,0,0
"Feb 20, 2019 2:00 AM",1,0,1,,,,,,,,,,0,0,0,0,,,,0,0,0,0,0,0,0,0,1,1,0,0,0,0,0,0,0
"Feb 20, 2019 3:00 AM",3,1,2,,,,,,,,,,0,0,0,0,,,,2,1,1,0,0,0,0,0,0,0,0,0,0,0,0,0,0
"Feb 20, 2019 4:00 AM",2,1,1,,,,,,,,,,0,0,0,0,,,,3,3,0,0,1,0,0,0,0,0,0,0,0,0,0,0,0
"Feb 20, 2019 5:00 AM",12,7,5,,,,,,,,,,0,0,0,2,,,,0,0,0,8,1,0,0,0,4,2,0,0,0,0,0,0,0
"Feb 20, 2019 6:00 AM",37,33,4,,,,,,,,,,2,0,2,5,,,,8,6,2,20,5,7,4,3,42,0,1,1,0,1,0,0,0
"Feb 20, 2019 7:00 AM",196,162,34,,,,,,,,,,3,0,3,11,,,,26,17,9,133,31,28,23,5,151,1,6,2,1,1,1,0,1
"Feb 20, 2019 8:00 AM",389,328,61,,,,,,,,,,21,3,18,16,,,,43,22,21,256,59,82,64,18,294,0,5,3,0,3,0,0,0
"Feb 20, 2019 9:00 AM",215,192,23,,,,,,,,,,16,4,12,5,,,,17,9,8,144,24,45,31,14,92,2,0,2,0,2,1,1,0
"Feb 20, 2019 10:00 AM",91,72,19,,,,,,,,,,8,2,6,5,,,,23,12,11,66,11,18,15,3,32,1,1,3,1,2,1,1,0
"Feb 20, 2019 11:00 AM",57,42,15,,,,,,,,,,6,2,4,5,,,,24,18,6,29,15,10,4,6,22,4,6,0,0,0,2,1,1
"Feb 20, 2019 12:00 PM",79,46,33,,,,,,,,,,21,10,11,7,,,,18,14,4,32,12,14,3,11,21,3,3,3,0,3,0,0,0
"Feb 20, 2019 1:00 PM",83,42,41,,,,,,,,,,5,1,4,17,,,,28,24,4,23,26,20,4,16,24,2,0,3,2,1,4,2,2
"Feb 20, 2019 2:00 PM",65,32,33,,,,,,,,,,6,5,1,10,,,,31,30,1,15,14,26,9,17,19,3,2,5,3,2,2,2,0
"Feb 20, 2019 3:00 PM",100,26,74,,,,,,,,,,17,12,5,10,,,,43,43,0,12,22,23,9,14,18,3,3,4,2,2,0,0,0
"Feb 20, 2019 4:00 PM",130,31,99,,,,,,,,,,17,9,8,5,,,,57,55,2,20,69,32,12,20,38,3,2,2,2,0,1,1,0
"Feb 20, 2019 5:00 PM",326,51,275,,,,,,,,,,19,12,7,29,,,,161,155,6,23,133,68,13,55,71,6,3,4,2,2,2,2,0
"Feb 20, 2019 6:00 PM",312,53,259,,,,,,,,,,15,13,2,21,,,,168,163,5,36,161,80,9,71,44,4,0,3,2,1,2,1,1
"Feb 20, 2019 7:00 PM",192,41,151,,,,,,,,,,10,7,3,1,,,,95,91,4,21,87,33,2,31,17,2,1,1,0,1,1,1,0
"Feb 20, 2019 8:00 PM",43,8,35,,,,,,,,,,5,2,3,5,,,,54,52,2,14,57,17,2,15,21,2,2,2,1,1,0,0,0
"Feb 20, 2019 9:00 PM",44,10,34,,,,,,,,,,2,2,0,3,,,,47,44,3,7,20,12,1,11,16,5,0,1,0,1,1,1,0
"Feb 20, 2019 10:00 PM",40,6,34,,,,,,,,,,8,7,1,2,,,,22,22,0,4,11,8,2,6,10,1,0,0,0,0,0,0,0
"Feb 20, 2019 11:00 PM",15,2,13,,,,,,,,,,3,2,1,1,,,,13,13,0,2,4,4,2,2,4,0,1,0,0,0,0,0,0
"Feb 21, 2019 12:00 AM",9,1,8,,,,,,,,,,2,1,1,0,,,,4,4,0,0,4,2,0,2,2,0,0,2,1,1,0,0,0
"Feb 21, 2019 1:00 AM",2,0,2,,,,,,,,,,1,1,0,0,,,,4,4,0,0,0,0,0,0,0,0,0,0,0,0,1,0,1
"Feb 21, 2019 2:00 AM",2,0,2,,,,,,,,,,0,0,0,0,,,,1,1,0,0,1,0,0,0,0,0,0,1,1,0,0,0,0
"Feb 21, 2019 3:00 AM",0,0,0,,,,,,,,,,0,0,0,0,,,,0,0,0,0,1,0,0,0,1,1,0,0,0,0,0,0,0
"Feb 21, 2019 4:00 AM",2,1,1,,,,,,,,,,0,0,0,0,,,,1,1,0,0,0,0,0,0,2,0,0,0,0,0,0,0,0
"Feb 21, 2019 5:00 AM",7,3,4,,,,,,,,,,0,0,0,2,,,,1,1,0,8,3,0,0,0,8,1,0,0,0,0,0,0,0
"Feb 21, 2019 6:00 AM",56,42,14,,,,,,,,,,3,0,3,2,,,,7,6,1,22,9,4,3,1,45,1,3,0,0,0,0,0,0
"Feb 21, 2019 7:00 AM",172,131,41,,,,,,,,,,8,2,6,16,,,,24,18,6,123,29,25,20,5,158,2,5,4,2,2,5,2,3
"Feb 21, 2019 8:00 AM",370,314,56,,,,,,,,,,11,3,8,29,,,,42,26,16,239,51,64,49,15,269,2,8,2,1,1,0,0,0
"Feb 21, 2019 9:00 AM",224,197,27,,,,,,,,,,17,8,9,7,,,,16,9,7,115,36,44,29,15,101,2,2,6,3,3,0,0,0
"Feb 21, 2019 10:00 AM",101,80,21,,,,,,,,,,8,1,7,1,,,,19,9,10,53,16,16,6,10,38,2,2,7,6,1,0,0,0
"Feb 21, 2019 11:00 AM",60,33,27,,,,,,,,,,12,5,7,5,,,,20,14,6,33,24,23,8,15,26,0,1,2,0,2,1,1,0
"Feb 21, 2019 12:00 PM",71,41,30,,,,,,,,,,22,11,11,12,,,,28,23,5,35,11,23,12,11,25,1,2,2,2,0,1,0,1
"Feb 21, 2019 1:00 PM",86,35,51,,,,,,,,,,13,9,4,13,,,,34,29,5,25,16,18,8,10,28,1,2,2,1,1,3,1,2
"Feb 21, 2019 2:00 PM",64,25,39,,,,,,,,,,22,11,11,7,,,,27,27,0,17,24,17,5,12,17,1,3,7,4,3,2,0,2
"Feb 21, 2019 3:00 PM",89,29,60,,,,,,,,,,14,8,6,4,,,,48,47,1,18,31,20,8,12,22,4,2,2,2,0,0,0,0
"Feb 21, 2019 4:00 PM",160,32,128,,,,,,,,,,8,5,3,26,,,,75,73,2,34,73,38,15,23,29,2,3,2,2,0,3,0,3
"Feb 21, 2019 5:00 PM",301,77,224,,,,,,,,,,7,5,2,23,,,,141,134,7,44,122,70,15,55,77,7,4,7,3,4,2,1,1
"Feb 21, 2019 6:00 PM",268,50,218,,,,,,,,,,0,0,0,24,,,,138,135,3,32,154,94,8,86,52,4,1,7,4,3,3,3,0
"Feb 21, 2019 7:00 PM",169,26,143,,,,,,,,,,7,4,3,7,,,,89,86,3,6,69,35,3,32,21,3,0,2,1,1,9,5,4
"Feb 21, 2019 8:00 PM",109,18,91,,,,,,,,,,13,6,7,6,,,,45,42,3,14,44,20,6,14,14,5,1,4,3,1,0,0,0
"Feb 21, 2019 9:00 PM",80,17,63,,,,,,,,,,2,1,1,8,,,,41,38,3,12,21,4,0,4,15,1,0,1,0,1,0,0,0
"Feb 21, 2019 10:00 PM",54,8,46,,,,,,,,,,0,0,0,3,,,,20,20,0,8,22,4,0,4,8,0,0,0,0,0,0,0,0
"Feb 21, 2019 11:00 PM",18,5,13,,,,,,,,,,2,0,2,3,,,,15,11,4,3,13,3,2,1,3,0,0,0,0,0,0,0,0
"Feb 22, 2019 12:00 AM",11,2,9,,,,,,,,,,3,2,1,1,,,,6,6,0,1,5,0,0,0,3,0,1,0,0,0,0,0,0
"Feb 22, 2019 1:00 AM",5,0,5,,,,,,,,,,2,0,2,0,,,,1,1,0,1,1,1,0,1,0,0,0,0,0,0,0,0,0
"Feb 22, 2019 2:00 AM",2,1,1,,,,,,,,,,0,0,0,1,,,,1,1,0,0,2,0,0,0,1,0,0,0,0,0,0,0,0
"Feb 22, 2019 3:00 AM",5,0,5,,,,,,,,,,0,0,0,0,,,,1,1,0,0,1,0,0,0,1,0,0,0,0,0,0,0,0
"Feb 22, 2019 4:00 AM",5,4,1,,,,,,,,,,0,0,0,0,,,,1,1,0,0,0,0,0,0,1,0,0,0,0,0,0,0,0
"Feb 22, 2019 5:00 AM",8,6,2,,,,,,,,,,0,0,0,1,,,,0,0,0,8,4,0,0,0,5,1,0,0,0,0,0,0,0
"Feb 22, 2019 6:00 AM",40,30,10,,,,,,,,,,2,0,2,3,,,,5,4,1,18,3,2,2,0,35,0,1,1,0,1,0,0,0
"Feb 22, 2019 7:00 AM",143,112,31,,,,,,,,,,9,2,7,15,,,,20,14,6,106,23,14,10,4,92,0,8,0,0,0,0,0,0
"Feb 22, 2019 8:00 AM",271,223,48,,,,,,,,,,10,0,10,16,,,,30,17,13,167,40,67,54,13,212,0,7,3,2,1,2,1,1
"Feb 22, 2019 9:00 AM",178,159,19,,,,,,,,,,10,3,7,11,,,,15,4,11,102,24,50,31,19,82,2,3,2,1,1,2,0,2
"Feb 22, 2019 10:00 AM",84,66,18,,,,,,,,,,9,2,7,3,,,,15,6,9,45,13,21,9,12,32,6,1,2,0,2,1,0,1
"Feb 22, 2019 11:00 AM",67,38,29,,,,,,,,,,4,2,2,9,,,,16,8,8,35,9,14,5,9,20,1,2,3,1,2,0,0,0
"Feb 22, 2019 12:00 PM",77,32,45,,,,,,,,,,20,7,13,6,,,,23,22,1,17,9,15,9,6,33,2,2,1,1,0,4,1,3
"Feb 22, 2019 1:00 PM",77,32,45,,,,,,,,,,13,9,4,8,,,,31,28,3,19,29,15,6,9,24,4,4,2,2,0,1,0,1
"Feb 22, 2019 2:00 PM",69,28,41,,,,,,,,,,13,6,7,18,,,,33,28,5,18,27,15,3,12,15,1,1,5,2,3,1,1,0
"Feb 22, 2019 3:00 PM",87,18,69,,,,,,,,,,16,14,2,14,,,,37,35,2,8,24,24,7,17,16,4,3,5,1,4,1,1,0
"Feb 22, 2019 4:00 PM",155,40,115,,,,,,,,,,13,4,9,12,,,,71,66,5,27,42,30,9,21,26,5,6,4,1,3,2,1,1
"Feb 22, 2019 5:00 PM",245,49,196,,,,,,,,,,19,10,9,22,,,,127,125,2,29,81,55,6,49,52,6,2,8,5,3,3,1,2
"Feb 22, 2019 6:00 PM",196,41,155,,,,,,,,,,20,20,0,13,,,,106,101,5,20,109,59,6,53,27,3,4,4,2,2,3,3,0
"Feb 22, 2019 7:00 PM",117,27,90,,,,,,,,,,13,10,3,7,,,,43,42,1,18,51,19,3,16,16,7,0,2,1,1,0,0,0
"Feb 22, 2019 8:00 PM",47,15,32,,,,,,,,,,4,1,3,5,,,,24,24,0,4,12,10,3,7,13,0,0,3,1,2,0,0,0
"Feb 22, 2019 9:00 PM",51,8,43,,,,,,,,,,1,0,1,1,,,,18,18,0,5,14,6,3,3,5,2,0,3,1,2,2,2,0
"Feb 22, 2019 10:00 PM",45,7,38,,,,,,,,,,7,3,4,3,,,,21,20,1,8,9,12,1,11,11,1,0,0,0,0,0,0,0
"Feb 22, 2019 11:00 PM",13,3,10,,,,,,,,,,4,2,2,1,,,,10,10,0,3,9,4,3,1,3,1,1,0,0,0,0,0,0
"Feb 23, 2019 12:00 AM",12,3,9,,,,,,,,,,1,1,0,2,,,,12,11,1,2,7,2,0,2,5,0,1,0,0,0,0,0,0
"Feb 23, 2019 1:00 AM",5,1,4,,,,,,,,,,3,1,2,0,,,,3,3,0,1,1,2,0,2,0,1,1,0,0,0,0,0,0
"Feb 23, 2019 2:00 AM",3,1,2,,,,,,,,,,1,0,1,0,,,,3,3,0,0,1,4,0,4,4,0,1,0,0,0,0,0,0
"Feb 23, 2019 3:00 AM",5,1,4,,,,,,,,,,0,0,0,3,,,,3,3,0,1,3,1,0,1,2,0,1,0,0,0,0,0,0
"Feb 23, 2019 4:00 AM",3,1,2,,,,,,,,,,0,0,0,0,,,,2,2,0,0,1,1,0,1,1,0,1,1,1,0,2,1,1
"Feb 23, 2019 5:00 AM",1,1,0,,,,,,,,,,0,0,0,1,,,,0,0,0,1,1,0,0,0,2,0,0,0,0,0,0,0,0
"Feb 23, 2019 6:00 AM",12,6,6,,,,,,,,,,0,0,0,3,,,,2,2,0,5,3,1,1,0,4,1,0,0,0,0,0,0,0
"Feb 23, 2019 7:00 AM",19,11,8,,,,,,,,,,4,2,2,1,,,,2,2,0,8,14,3,1,2,10,0,2,0,0,0,0,0,0
"Feb 23, 2019 8:00 AM",31,20,11,,,,,,,,,,7,0,7,5,,,,8,6,2,16,10,8,3,5,15,2,4,0,0,0,0,0,0
"Feb 23, 2019 9:00 AM",48,38,10,,,,,,,,,,3,0,3,7,,,,11,8,3,22,20,15,10,5,25,2,4,2,1,1,0,0,0
"Feb 23, 2019 10:00 AM",51,23,28,,,,,,,,,,11,3,8,9,,,,19,16,3,27,21,11,3,8,14,7,4,1,0,1,0,0,0
"Feb 23, 2019 11:00 AM",44,24,20,,,,,,,,,,34,20,14,17,,,,14,9,5,15,15,21,8,13,38,3,1,12,8,4,3,1,2
"Feb 23, 2019 12:00 PM",67,33,34,,,,,,,,,,26,14,12,23,,,,14,10,4,19,20,35,15,20,19,3,4,3,3,0,0,0,0
"Feb 23, 2019 1:00 PM",59,29,30,,,,,,,,,,17,7,10,13,,,,17,12,5,12,25,21,8,13,26,7,1,12,10,2,4,1,3
"Feb 23, 2019 2:00 PM",55,32,23,,,,,,,,,,8,3,5,17,,,,16,15,1,14,21,12,3,9,17,6,1,5,4,1,2,2,0
"Feb 23, 2019 3:00 PM",46,33,13,,,,,,,,,,25,19,6,21,,,,15,14,1,13,21,41,20,21,17,3,3,7,2,5,3,3,0
"Feb 23, 2019 4:00 PM",60,20,40,,,,,,,,,,26,13,13,13,,,,28,26,2,11,18,22,9,13,26,4,5,5,4,1,0,0,0
"Feb 23, 2019 5:00 PM",60,21,39,,,,,,,,,,15,8,7,17,,,,25,24,1,14,9,29,10,19,24,4,3,5,3,2,1,0,1
"Feb 23, 2019 6:00 PM",34,13,21,,,,,,,,,,6,2,4,6,,,,14,14,0,7,19,20,8,12,17,1,3,3,2,1,1,0,1
"Feb 23, 2019 7:00 PM",45,20,25,,,,,,,,,,6,4,2,6,,,,9,7,2,10,17,10,3,7,14,2,2,1,0,1,1,0,1
"Feb 23, 2019 8:00 PM",31,12,19,,,,,,,,,,2,1,1,6,,,,7,7,0,6,6,5,3,2,13,2,1,2,0,2,0,0,0
"Feb 23, 2019 9:00 PM",22,14,8,,,,,,,,,,1,0,1,4,,,,2,2,0,2,2,3,1,2,3,0,2,0,0,0,0,0,0
"Feb 23, 2019 10:00 PM",17,3,14,,,,,,,,,,4,3,1,4,,,,7,7,0,2,6,3,3,0,4,0,0,0,0,0,0,0,0
"Feb 23, 2019 11:00 PM",6,1,5,,,,,,,,,,5,5,0,1,,,,7,6,1,1,5,2,0,2,9,0,1,0,0,0,0,0,0
"Feb 24, 2019 12:00 AM",7,2,5,,,,,,,,,,1,0,1,2,,,,1,1,0,2,5,3,0,3,8,0,0,1,1,0,0,0,0
"Feb 24, 2019 1:00 AM",12,2,10,,,,,,,,,,3,0,3,0,,,,3,3,0,1,2,1,0,1,1,0,1,0,0,0,0,0,0
"Feb 24, 2019 2:00 AM",4,0,4,,,,,,,,,,0,0,0,0,,,,3,3,0,0,0,0,0,0,1,0,2,0,0,0,0,0,0
"Feb 24, 2019 3:00 AM",2,0,2,,,,,,,,,,0,0,0,1,,,,3,3,0,0,2,0,0,0,1,0,0,0,0,0,0,0,0
"Feb 24, 2019 4:00 AM",2,1,1,,,,,,,,,,0,0,0,2,,,,2,2,0,0,0,0,0,0,0,0,0,0,0,0,0,0,0
"Feb 24, 2019 5:00 AM",2,1,1,,,,,,,,,,0,0,0,0,,,,2,1,1,1,1,0,0,0,3,0,0,0,0,0,0,0,0
"Feb 24, 2019 6:00 AM",10,3,7,,,,,,,,,,0,0,0,0,,,,1,1,0,1,5,1,1,0,5,1,1,0,0,0,0,0,0
"Feb 24, 2019 7:00 AM",11,4,7,,,,,,,,,,1,1,0,1,,,,6,5,1,9,11,2,1,1,15,0,0,0,0,0,1,0,1
"Feb 24, 2019 8:00 AM",14,8,6,,,,,,,,,,3,2,1,8,,,,5,4,1,8,15,7,2,5,13,2,12,1,1,0,0,0,0
"Feb 24, 2019 9:00 AM",60,40,20,,,,,,,,,,10,7,3,21,,,,14,10,4,21,16,21,5,16,29,6,18,1,0,1,0,0,0
"Feb 24, 2019 10:00 AM",63,32,31,,,,,,,,,,20,11,9,8,,,,14,11,3,19,22,26,8,18,28,7,4,1,1,0,1,0,1
"Feb 24, 2019 11:00 AM",44,22,22,,,,,,,,,,32,21,11,14,,,,11,9,2,12,26,33,11,22,31,8,11,8,6,2,3,1,2
"Feb 24, 2019 12:00 PM",67,42,25,,,,,,,,,,26,5,21,19,,,,9,9,0,18,31,50,19,31,50,7,2,2,1,1,0,0,0
"Feb 24, 2019 1:00 PM",83,41,42,,,,,,,,,,20,10,10,22,,,,15,13,2,25,22,35,18,17,28,4,4,4,2,2,1,0,1
"Feb 24, 2019 2:00 PM",44,21,23,,,,,,,,,,19,10,9,12,,,,18,15,3,23,25,32,19,13,22,6,0,2,1,1,2,2,0
"Feb 24, 2019 3:00 PM",51,24,27,,,,,,,,,,15,10,5,14,,,,10,10,0,12,27,28,14,14,32,3,1,3,3,0,1,1,0
"Feb 24, 2019 4:00 PM",49,20,29,,,,,,,,,,26,12,14,12,,,,10,9,1,8,13,14,1,13,18,0,3,19,8,11,1,1,0
"Feb 24, 2019 5:00 PM",46,12,34,,,,,,,,,,22,14,8,11,,,,18,16,2,14,17,14,10,4,25,1,3,1,1,0,5,4,1
"Feb 24, 2019 6:00 PM",43,18,25,,,,,,,,,,4,2,2,6,,,,12,11,1,14,15,16,7,9,13,1,1,3,1,2,0,0,0
"Feb 24, 2019 7:00 PM",24,10,14,,,,,,,,,,7,2,5,1,,,,13,11,2,3,14,7,3,4,10,1,0,1,1,0,0,0,0
"Feb 24, 2019 8:00 PM",32,13,19,,,,,,,,,,5,2,3,5,,,,12,12,0,3,6,6,2,4,7,2,0,3,1,2,0,0,0
"Feb 24, 2019 9:00 PM",22,8,14,,,,,,,,,,1,0,1,8,,,,5,5,0,5,3,5,2,3,6,0,0,1,0,1,0,0,0
"Feb 24, 2019 10:00 PM",18,3,15,,,,,,,,,,0,0,0,3,,,,5,4,1,2,0,1,0,1,11,1,2,1,1,0,0,0,0
"Feb 24, 2019 11:00 PM",8,3,5,,,,,,,,,,1,1,0,3,,,,0,0,0,1,4,0,0,0,2,1,1,0,0,0,0,0,0
"Feb 25, 2019 12:00 AM",7,1,6,,,,,,,,,,0,0,0,0,,,,2,2,0,0,1,0,0,0,2,0,2,4,2,2,3,3,0
"Feb 25, 2019 1:00 AM",1,1,0,,,,,,,,,,0,0,0,0,,,,5,5,0,0,1,1,0,1,0,0,0,1,1,0,0,0,0
"Feb 25, 2019 2:00 AM",0,0,0,,,,,,,,,,0,0,0,0,,,,0,0,0,1,3,0,0,0,0,0,0,0,0,0,0,0,0
"Feb 25, 2019 3:00 AM",1,0,1,,,,,,,,,,0,0,0,0,,,,0,0,0,0,0,0,0,0,0,0,0,0,0,0,0,0,0
"Feb 25, 2019 4:00 AM",2,1,1,,,,,,,,,,0,0,0,0,,,,0,0,0,0,0,0,0,0,1,1,0,0,0,0,0,0,0
"Feb 25, 2019 5:00 AM",8,5,3,,,,,,,,,,0,0,0,3,,,,3,2,1,7,3,0,0,0,8,1,0,0,0,0,0,0,0
"Feb 25, 2019 6:00 AM",53,37,16,,,,,,,,,,1,0,1,2,,,,7,5,2,27,10,3,3,0,55,1,2,1,1,0,0,0,0
"Feb 25, 2019 7:00 AM",201,156,45,,,,,,,,,,4,0,4,19,,,,30,23,7,144,32,32,25,7,192,2,6,5,5,0,3,0,3
"Feb 25, 2019 8:00 AM",413,347,66,,,,,,,,,,31,5,26,36,,,,52,37,15,331,66,101,84,17,340,7,4,8,7,1,2,0,2
"Feb 25, 2019 9:00 AM",273,242,31,,,,,,,,,,11,3,8,17,,,,22,9,13,136,36,56,43,13,125,2,6,7,4,3,1,0,1
"Feb 25, 2019 10:00 AM",96,78,18,,,,,,,,,,7,0,7,8,,,,17,4,13,61,21,17,9,8,41,4,4,5,5,0,0,0,0
"Feb 25, 2019 11:00 AM",71,52,19,,,,,,,,,,11,9,2,8,,,,14,10,4,38,13,13,3,10,28,3,2,4,1,3,1,1,0
"Feb 25, 2019 12:00 PM",84,49,35,,,,,,,,,,20,9,11,5,,,,21,17,4,42,17,15,2,13,27,2,1,7,2,5,1,0,1
"Feb 25, 2019 1:00 PM",101,56,45,,,,,,,,,,12,6,6,8,,,,29,26,3,30,28,18,7,11,24,2,4,5,2,3,1,1,0
"Feb 25, 2019 2:00 PM",74,27,47,,,,,,,,,,11,8,3,17,,,,48,45,3,28,29,32,11,21,27,3,5,3,3,0,0,0,0
"Feb 25, 2019 3:00 PM",117,25,92,,,,,,,,,,17,13,4,13,,,,38,35,3,23,34,18,5,13,18,2,2,5,0,5,0,0,0
"Feb 25, 2019 4:00 PM",176,48,128,,,,,,,,,,11,6,5,19,,,,90,86,4,34,74,43,11,32,34,2,3,8,4,4,3,2,1
"Feb 25, 2019 5:00 PM",359,64,295,,,,,,,,,,23,16,7,26,,,,194,189,5,38,167,78,10,68,86,5,1,8,6,2,0,0,0
"Feb 25, 2019 6:00 PM",346,61,285,,,,,,,,,,26,23,3,27,,,,196,190,6,32,209,98,12,86,64,8,3,7,3,4,0,0,0
"Feb 25, 2019 7:00 PM",198,39,159,,,,,,,,,,8,3,5,14,,,,101,100,1,25,96,42,3,39,19,3,4,4,2,2,6,3,3
"Feb 25, 2019 8:00 PM",120,25,95,,,,,,,,,,3,2,1,3,,,,57,53,4,14,49,20,2,18,18,2,1,3,2,1,1,0,1
"Feb 25, 2019 9:00 PM",89,20,69,,,,,,,,,,4,3,1,5,,,,54,54,0,5,23,13,4,9,26,4,0,2,0,2,4,4,0
"Feb 25, 2019 10:00 PM",50,8,42,,,,,,,,,,1,1,0,1,,,,23,23,0,3,11,7,2,5,10,2,0,1,1,0,0,0,0
"Feb 25, 2019 11:00 PM",18,4,14,,,,,,,,,,1,1,0,1,,,,7,7,0,0,9,3,1,2,1,0,0,1,0,1,1,1,0
"Feb 26, 2019 12:00 AM",6,3,3,,,,,,,,,,1,1,0,0,,,,1,1,0,0,3,0,0,0,0,0,0,0,0,0,0,0,0
"Feb 26, 2019 1:00 AM",1,0,1,,,,,,,,,,0,0,0,0,,,,4,4,0,1,1,1,1,0,0,0,0,0,0,0,0,0,0
"Feb 26, 2019 2:00 AM",1,0,1,,,,,,,,,,0,0,0,0,,,,0,0,0,0,0,1,0,1,0,0,0,0,0,0,0,0,0
"Feb 26, 2019 3:00 AM",3,2,1,,,,,,,,,,0,0,0,0,,,,2,2,0,1,0,0,0,0,0,0,1,0,0,0,0,0,0
"Feb 26, 2019 4:00 AM",2,1,1,,,,,,,,,,0,0,0,0,,,,0,0,0,0,1,0,0,0,0,0,0,0,0,0,0,0,0
"Feb 26, 2019 5:00 AM",6,4,2,,,,,,,,,,0,0,0,1,,,,2,2,0,6,0,0,0,0,9,3,0,0,0,0,0,0,0
"Feb 26, 2019 6:00 AM",62,50,12,,,,,,,,,,3,1,2,6,,,,5,4,1,28,7,5,4,1,54,2,3,2,1,1,0,0,0
"Feb 26, 2019 7:00 AM",232,184,48,,,,,,,,,,7,3,4,22,,,,33,24,9,158,35,39,31,8,214,1,5,6,6,0,2,0,2
"Feb 26, 2019 8:00 AM",491,399,92,,,,,,,,,,18,3,15,39,,,,62,38,24,343,74,93,76,17,369,7,9,10,9,1,4,1,3
"Feb 26, 2019 9:00 AM",245,211,34,,,,,,,,,,14,0,14,8,,,,22,11,11,134,28,63,48,15,144,4,0,4,4,0,0,0,0
"Feb 26, 2019 10:00 AM",109,86,23,,,,,,,,,,14,8,6,6,,,,18,9,9,72,21,21,12,9,33,0,2,3,1,2,0,0,0
"Feb 26, 2019 11:00 AM",66,44,22,,,,,,,,,,15,7,8,5,,,,20,15,5,34,22,13,8,5,30,2,2,4,3,1,3,2,1
"Feb 26, 2019 12:00 PM",70,43,27,,,,,,,,,,8,1,7,9,,,,22,18,4,30,19,27,8,19,27,1,3,0,0,0,1,0,1
"Feb 26, 2019 1:00 PM",97,51,46,,,,,,,,,,15,11,4,7,,,,30,28,2,31,26,23,8,15,36,1,0,1,1,0,1,0,1
"Feb 26, 2019 2:00 PM",89,48,41,,,,,,,,,,17,13,4,17,,,,27,25,2,28,35,33,13,20,22,4,1,3,3,0,1,0,1
"Feb 26, 2019 3:00 PM",104,26,78,,,,,,,,,,14,9,5,16,,,,53,50,3,23,35,35,8,27,25,4,2,7,5,2,3,2,1
"Feb 26, 2019 4:00 PM",176,50,126,,,,,,,,,,17,12,5,20,,,,91,87,4,30,79,58,21,37,46,9,0,7,3,4,4,3,1
"Feb 26, 2019 5:00 PM",354,78,276,,,,,,,,,,11,8,3,32,,,,176,170,6,45,163,65,8,57,79,9,8,3,2,1,3,1,2
"Feb 26, 2019 6:00 PM",366,57,309,,,,,,,,,,29,25,4,25,,,,218,213,5,44,188,117,15,102,46,7,4,7,3,4,3,0,3
"Feb 26, 2019 7:00 PM",220,31,189,,,,,,,,,,14,8,6,16,,,,96,93,3,13,77,55,14,41,29,6,0,3,2,1,2,0,2
"Feb 26, 2019 8:00 PM",138,31,107,,,,,,,,,,4,3,1,5,,,,62,61,1,13,49,13,1,12,17,2,2,5,4,1,2,2,0
"Feb 26, 2019 9:00 PM",94,16,78,,,,,,,,,,6,4,2,4,,,,45,43,2,9,49,13,1,12,21,3,0,2,1,1,0,0,0
"Feb 26, 2019 10:00 PM",76,14,62,,,,,,,,,,0,0,0,5,,,,31,30,1,5,12,14,3,11,7,1,0,1,1,0,0,0,0
"Feb 26, 2019 11:00 PM",17,3,14,,,,,,,,,,0,0,0,3,,,,13,12,1,2,14,4,2,2,4,1,0,0,0,0,1,1,0
"Feb 27, 2019 12:00 AM",12,2,10,,,,,,,,,,0,0,0,0,,,,5,5,0,0,6,1,0,1,1,0,0,0,0,0,0,0,0
"Feb 27, 2019 1:00 AM",5,1,4,,,,,,,,,,0,0,0,0,,,,1,1,0,1,1,0,0,0,1,0,0,0,0,0,0,0,0
"Feb 27, 2019 2:00 AM",3,0,3,,,,,,,,,,1,0,1,0,,,,1,1,0,0,1,0,0,0,0,1,0,0,0,0,0,0,0
"Feb 27, 2019 3:00 AM",2,2,0,,,,,,,,,,0,0,0,0,,,,0,0,0,0,0,0,0,0,1,0,0,0,0,0,0,0,0
"Feb 27, 2019 4:00 AM",1,1,0,,,,,,,,,,0,0,0,0,,,,1,1,0,0,0,0,0,0,0,1,0,0,0,0,0,0,0
"Feb 27, 2019 5:00 AM",9,7,2,,,,,,,,,,0,0,0,2,,,,2,1,1,8,4,0,0,0,8,1,0,0,0,0,0,0,0
"Feb 27, 2019 6:00 AM",68,53,15,,,,,,,,,,2,0,2,3,,,,7,6,1,22,8,5,5,0,57,3,2,2,0,2,0,0,0
"Feb 27, 2019 7:00 AM",227,185,42,,,,,,,,,,5,1,4,18,,,,27,19,8,148,37,33,25,8,180,1,8,4,3,1,2,0,2
"Feb 27, 2019 8:00 AM",464,398,66,,,,,,,,,,34,8,26,48,,,,62,39,23,319,81,98,78,20,367,7,6,11,11,0,7,4,3
"Feb 27, 2019 9:00 AM",261,227,34,,,,,,,,,,14,4,10,10,,,,27,16,11,171,30,57,40,17,108,7,4,4,3,1,1,0,1
"Feb 27, 2019 10:00 AM",103,88,15,,,,,,,,,,9,2,7,4,,,,24,14,10,92,26,18,12,6,37,1,4,3,1,2,3,1,2
"Feb 27, 2019 11:00 AM",57,45,12,,,,,,,,,,10,5,5,9,,,,17,14,3,36,13,16,8,8,35,1,3,3,2,1,2,0,2
"Feb 27, 2019 12:00 PM",67,37,30,,,,,,,,,,14,12,2,10,,,,23,16,7,34,22,21,5,16,35,5,2,3,3,0,1,0,1
"Feb 27, 2019 1:00 PM",88,46,42,,,,,,,,,,10,3,7,17,,,,37,30,7,28,32,30,8,22,32,10,1,3,2,1,1,0,1
"Feb 27, 2019 2:00 PM",68,29,39,,,,,,,,,,14,7,7,13,,,,42,39,3,15,24,29,11,18,27,1,4,3,1,2,1,0,1
"Feb 27, 2019 3:00 PM",98,29,69,,,,,,,,,,11,4,7,17,,,,47,44,3,27,32,24,6,18,31,5,1,6,4,2,1,0,1
"Feb 27, 2019 4:00 PM",161,44,117,,,,,,,,,,16,12,4,21,,,,81,77,4,26,61,52,11,41,44,5,1,7,5,2,3,1,2
"Feb 27, 2019 5:00 PM",357,61,296,,,,,,,,,,28,14,14,25,,,,185,180,5,47,146,78,13,65,88,4,3,4,2,2,2,1,1
"Feb 27, 2019 6:00 PM",352,74,278,,,,,,,,,,26,17,9,25,,,,225,215,10,34,203,97,14,83,61,8,1,3,1,2,1,1,0
"Feb 27, 2019 7:00 PM",195,32,163,,,,,,,,,,17,12,5,9,,,,75,73,2,17,104,31,2,29,28,2,3,4,3,1,0,0,0
"Feb 27, 2019 8:00 PM",121,19,102,,,,,,,,,,3,3,0,7,,,,64,63,1,17,42,21,4,17,15,2,1,2,1,1,0,0,0
"Feb 27, 2019 9:00 PM",69,12,57,,,,,,,,,,1,1,0,3,,,,34,31,3,8,23,8,1,7,13,3,0,2,0,2,0,0,0
"Feb 27, 2019 10:00 PM",62,10,52,,,,,,,,,,3,2,1,3,,,,31,30,1,3,18,11,0,11,6,1,0,0,0,0,2,2,0
"Feb 27, 2019 11:00 PM",21,2,19,,,,,,,,,,0,0,0,0,,,,13,13,0,1,12,4,2,2,6,0,1,0,0,0,0,0,0
"Feb 28, 2019 12:00 AM",6,0,6,,,,,,,,,,0,0,0,0,,,,8,8,0,1,2,0,0,0,0,2,1,0,0,0,0,0,0
"Feb 28, 2019 1:00 AM",7,0,7,,,,,,,,,,0,0,0,0,,,,2,2,0,0,0,0,0,0,0,1,0,0,0,0,0,0,0
"Feb 28, 2019 2:00 AM",0,0,0,,,,,,,,,,0,0,0,0,,,,3,3,0,0,1,0,0,0,0,0,0,0,0,0,0,0,0
"Feb 28, 2019 3:00 AM",1,1,0,,,,,,,,,,0,0,0,0,,,,2,1,1,0,0,0,0,0,0,0,0,0,0,0,0,0,0
"Feb 28, 2019 4:00 AM",2,1,1,,,,,,,,,,0,0,0,0,,,,2,2,0,0,1,0,0,0,2,0,0,0,0,0,0,0,0
"Feb 28, 2019 5:00 AM",7,6,1,,,,,,,,,,1,0,1,4,,,,2,1,1,7,3,0,0,0,7,0,0,0,0,0,0,0,0
"Feb 28, 2019 6:00 AM",62,47,15,,,,,,,,,,2,0,2,5,,,,2,2,0,22,3,3,3,0,50,3,1,2,1,1,2,0,2
"Feb 28, 2019 7:00 AM",204,166,38,,,,,,,,,,8,3,5,13,,,,26,18,8,125,30,33,21,12,163,1,6,4,2,2,2,0,2
"Feb 28, 2019 8:00 AM",418,360,58,,,,,,,,,,32,11,21,43,,,,48,28,20,268,68,103,87,16,330,5,6,10,9,1,3,1,2
"Feb 28, 2019 9:00 AM",250,223,27,,,,,,,,,,17,7,10,10,,,,12,6,6,143,37,53,38,15,111,6,3,4,2,2,1,1,0
"Feb 28, 2019 10:00 AM",94,81,13,,,,,,,,,,11,4,7,8,,,,24,15,9,60,12,12,8,4,33,1,0,2,2,0,2,1,1
"Feb 28, 2019 11:00 AM",76,46,30,,,,,,,,,,6,3,3,9,,,,16,14,2,30,12,13,5,8,22,0,2,0,0,0,0,0,0
"Feb 28, 2019 12:00 PM",62,26,36,,,,,,,,,,8,2,6,3,,,,17,15,2,22,14,11,4,7,23,1,2,4,3,1,2,0,2
"Feb 28, 2019 1:00 PM",91,33,58,,,,,,,,,,13,5,8,7,,,,29,26,3,27,22,14,5,9,25,3,2,1,1,0,0,0,0
"Feb 28, 2019 2:00 PM",74,32,42,,,,,,,,,,16,13,3,15,,,,29,23,6,18,22,22,5,17,13,3,2,2,1,1,1,0,1
"Feb 28, 2019 3:00 PM",116,23,93,,,,,,,,,,9,6,3,8,,,,59,55,4,19,26,24,6,18,25,4,1,6,3,3,2,2,0
"Feb 28, 2019 4:00 PM",184,37,147,,,,,,,,,,12,8,4,16,,,,91,86,5,25,66,31,2,29,33,4,2,5,1,4,1,1,0
"Feb 28, 2019 5:00 PM",299,61,238,,,,,,,,,,19,17,2,20,,,,153,150,3,35,127,70,10,60,79,12,4,7,5,2,3,2,1
"Feb 28, 2019 6:00 PM",331,50,281,,,,,,,,,,15,10,5,24,,,,191,188,3,49,202,82,7,75,49,7,2,12,8,4,2,0,2
"Feb 28, 2019 7:00 PM",133,36,97,,,,,,,,,,20,15,5,15,,,,71,69,2,20,84,40,4,36,17,3,2,0,0,0,1,0,1
"Feb 28, 2019 8:00 PM",96,29,67,,,,,,,,,,5,4,1,8,,,,37,35,2,7,36,20,3,17,13,2,0,2,0,2,3,3,0
"Feb 28, 2019 9:00 PM",56,16,40,,,,,,,,,,3,3,0,0,,,,22,21,1,10,34,9,1,8,15,1,2,1,0,1,0,0,0
"Feb 28, 2019 10:00 PM",33,7,26,,,,,,,,,,2,2,0,5,,,,19,19,0,5,14,6,2,4,8,0,1,0,0,0,0,0,0
"Feb 28, 2019 11:00 PM",30,6,24,,,,,,,,,,2,1,1,2,,,,10,9,1,4,14,5,2,3,3,1,0,1,1,0,0,0,0
"Mar 1, 2019 12:00 AM",21,4,17,,,,,,,,,,1,1,0,0,,,,7,7,0,2,4,3,0,3,1,0,1,0,0,0,0,0,0
"Mar 1, 2019 1:00 AM",2,0,2,,,,,,,,,,0,0,0,1,,,,7,7,0,0,5,0,0,0,0,0,0,0,0,0,0,0,0
"Mar 1, 2019 2:00 AM",4,1,3,,,,,,,,,,0,0,0,0,,,,1,1,0,0,2,0,0,0,0,0,0,0,0,0,0,0,0
"Mar 1, 2019 3:00 AM",1,1,0,,,,,,,,,,2,2,0,0,,,,3,3,0,1,1,0,0,0,0,0,0,0,0,0,0,0,0
"Mar 1, 2019 4:00 AM",1,1,0,,,,,,,,,,0,0,0,0,,,,0,0,0,0,0,0,0,0,2,0,0,0,0,0,0,0,0
"Mar 1, 2019 5:00 AM",12,10,2,,,,,,,,,,0,0,0,3,,,,1,0,1,4,3,0,0,0,10,1,0,0,0,0,0,0,0
"Mar 1, 2019 6:00 AM",44,34,10,,,,,,,,,,1,0,1,5,,,,4,4,0,22,4,3,2,1,45,2,0,3,1,2,1,0,1
"Mar 1, 2019 7:00 AM",170,125,45,,,,,,,,,,10,2,8,12,,,,23,16,7,109,41,29,18,11,120,1,5,3,2,1,2,0,2
"Mar 1, 2019 8:00 AM",310,260,50,,,,,,,,,,16,4,12,27,,,,54,35,19,204,62,64,53,11,238,1,6,9,8,1,4,1,3
"Mar 1, 2019 9:00 AM",207,180,27,,,,,,,,,,15,4,11,6,,,,24,15,9,128,31,58,37,21,84,4,5,3,3,0,0,0,0
"Mar 1, 2019 10:00 AM",81,67,14,,,,,,,,,,12,5,7,8,,,,22,12,10,57,14,23,9,14,31,3,4,4,3,1,1,1,0
"Mar 1, 2019 11:00 AM",54,30,24,,,,,,,,,,13,8,5,5,,,,21,17,4,29,15,20,6,14,24,1,3,0,0,0,0,0,0
"Mar 1, 2019 12:00 PM",100,52,48,,,,,,,,,,19,9,10,6,,,,18,16,2,25,20,17,10,7,27,3,3,3,3,0,0,0,0
"Mar 1, 2019 1:00 PM",88,38,50,,,,,,,,,,11,5,6,11,,,,26,19,7,22,30,26,12,14,32,4,1,5,2,3,1,0,1
"Mar 1, 2019 2:00 PM",87,32,55,,,,,,,,,,9,7,2,14,,,,38,33,5,17,33,27,6,21,26,5,5,4,3,1,1,0,1
"Mar 1, 2019 3:00 PM",103,27,76,,,,,,,,,,11,7,4,7,,,,47,43,4,17,33,23,6,17,27,5,4,4,2,2,1,1,0
"Mar 1, 2019 4:00 PM",175,51,124,,,,,,,,,,25,12,13,25,,,,88,83,5,29,40,35,11,24,41,1,2,4,2,2,2,2,0
"Mar 1, 2019 5:00 PM",280,39,241,,,,,,,,,,13,9,4,17,,,,132,130,2,28,118,61,7,54,55,5,1,4,1,3,3,2,1
"Mar 1, 2019 6:00 PM",194,46,148,,,,,,,,,,14,9,5,13,,,,108,103,5,20,98,59,4,55,25,1,2,2,1,1,1,0,1
"Mar 1, 2019 7:00 PM",118,26,92,,,,,,,,,,8,6,2,6,,,,57,55,2,12,63,22,2,20,9,1,0,2,0,2,1,1,0
"Mar 1, 2019 8:00 PM",51,12,39,,,,,,,,,,5,3,2,2,,,,25,24,1,13,25,8,0,8,6,1,1,2,1,1,0,0,0
"Mar 1, 2019 9:00 PM",39,6,33,,,,,,,,,,1,0,1,2,,,,25,22,3,3,11,2,1,1,7,0,0,1,1,0,0,0,0
"Mar 1, 2019 10:00 PM",41,12,29,,,,,,,,,,1,1,0,3,,,,11,11,0,3,12,2,0,2,11,0,0,1,0,1,1,1,0
"Mar 1, 2019 11:00 PM",19,5,14,,,,,,,,,,0,0,0,0,,,,11,11,0,6,11,0,0,0,5,0,0,0,0,0,0,0,0
"Mar 2, 2019 12:00 AM",13,6,7,,,,,,,,,,0,0,0,0,,,,6,6,0,2,7,1,0,1,5,0,0,1,1,0,0,0,0
"Mar 2, 2019 1:00 AM",15,2,13,,,,,,,,,,0,0,0,0,,,,4,4,0,5,5,1,1,0,1,1,0,0,0,0,0,0,0
"Mar 2, 2019 2:00 AM",2,0,2,,,,,,,,,,1,1,0,0,,,,5,5,0,1,1,0,0,0,4,0,2,0,0,0,0,0,0
"Mar 2, 2019 3:00 AM",5,1,4,,,,,,,,,,0,0,0,0,,,,2,2,0,1,1,0,0,0,4,0,2,0,0,0,0,0,0
"Mar 2, 2019 4:00 AM",2,2,0,,,,,,,,,,0,0,0,0,,,,0,0,0,0,3,1,0,1,2,0,0,0,0,0,0,0,0
"Mar 2, 2019 5:00 AM",2,0,2,,,,,,,,,,0,0,0,0,,,,0,0,0,1,3,0,0,0,2,0,0,0,0,0,0,0,0
"Mar 2, 2019 6:00 AM",20,12,8,,,,,,,,,,1,1,0,2,,,,1,1,0,2,3,1,1,0,9,0,0,1,1,0,0,0,0
"Mar 2, 2019 7:00 AM",20,13,7,,,,,,,,,,3,0,3,1,,,,6,4,2,7,8,5,0,5,9,0,1,0,0,0,0,0,0
"Mar 2, 2019 8:00 AM",44,23,21,,,,,,,,,,3,0,3,4,,,,4,2,2,12,9,2,1,1,19,2,4,0,0,0,0,0,0
"Mar 2, 2019 9:00 AM",52,40,12,,,,,,,,,,10,3,7,6,,,,10,7,3,22,18,17,10,7,27,2,3,1,0,1,0,0,0
"Mar 2, 2019 10:00 AM",47,21,26,,,,,,,,,,10,7,3,6,,,,15,11,4,13,10,15,5,10,25,0,4,5,2,3,2,1,1
"Mar 2, 2019 11:00 AM",43,21,22,,,,,,,,,,6,3,3,12,,,,16,13,3,20,11,24,7,17,18,5,1,2,1,1,3,0,3
"Mar 2, 2019 12:00 PM",38,22,16,,,,,,,,,,12,4,8,9,,,,10,9,1,16,17,15,7,8,37,3,0,2,2,0,1,0,1
"Mar 2, 2019 1:00 PM",46,20,26,,,,,,,,,,13,7,6,3,,,,19,17,2,21,13,19,4,15,22,2,5,3,2,1,0,0,0
"Mar 2, 2019 2:00 PM",34,17,17,,,,,,,,,,9,2,7,4,,,,13,10,3,10,9,7,2,5,16,1,1,3,1,2,0,0,0
"Mar 2, 2019 3:00 PM",23,10,13,,,,,,,,,,7,4,3,3,,,,8,5,3,13,9,8,3,5,12,0,1,2,1,1,0,0,0
"Mar 2, 2019 4:00 PM",33,11,22,,,,,,,,,,5,2,3,3,,,,19,17,2,6,9,8,4,4,10,0,2,9,8,1,5,2,3
"Mar 2, 2019 5:00 PM",35,12,23,,,,,,,,,,9,4,5,9,,,,21,19,2,7,13,9,1,8,11,3,0,1,1,0,0,0,0
"Mar 2, 2019 6:00 PM",41,12,29,,,,,,,,,,8,7,1,7,,,,8,8,0,4,11,12,3,9,12,2,3,3,1,2,0,0,0
"Mar 2, 2019 7:00 PM",23,6,17,,,,,,,,,,2,0,2,5,,,,7,5,2,6,14,1,0,1,10,0,0,0,0,0,0,0,0
"Mar 2, 2019 8:00 PM",36,17,19,,,,,,,,,,3,2,1,1,,,,6,6,0,9,4,5,3,2,5,0,1,1,1,0,0,0,0
"Mar 2, 2019 9:00 PM",18,11,7,,,,,,,,,,2,1,1,1,,,,4,3,1,3,3,1,0,1,4,0,0,1,1,0,0,0,0
"Mar 2, 2019 10:00 PM",11,3,8,,,,,,,,,,0,0,0,1,,,,6,6,0,5,1,0,0,0,6,1,0,1,1,0,0,0,0
"Mar 2, 2019 11:00 PM",5,2,3,,,,,,,,,,1,0,1,2,,,,5,4,1,2,2,3,1,2,9,0,0,0,0,0,0,0,0
"Mar 3, 2019 12:00 AM",5,2,3,,,,,,,,,,1,0,1,0,,,,1,1,0,1,3,2,0,2,4,0,1,0,0,0,0,0,0
"Mar 3, 2019 1:00 AM",7,1,6,,,,,,,,,,0,0,0,0,,,,3,3,0,4,4,2,1,1,1,0,0,0,0,0,0,0,0
"Mar 3, 2019 2:00 AM",2,1,1,,,,,,,,,,0,0,0,0,,,,0,0,0,0,3,0,0,0,1,0,3,1,0,1,0,0,0
"Mar 3, 2019 3:00 AM",2,1,1,,,,,,,,,,0,0,0,0,,,,1,1,0,0,0,0,0,0,0,0,0,1,1,0,0,0,0
"Mar 3, 2019 4:00 AM",2,0,2,,,,,,,,,,1,0,1,0,,,,2,2,0,0,2,0,0,0,1,0,0,0,0,0,0,0,0
"Mar 3, 2019 5:00 AM",4,2,2,,,,,,,,,,2,2,0,0,,,,0,0,0,1,1,0,0,0,0,0,0,0,0,0,0,0,0
"Mar 3, 2019 6:00 AM",9,4,5,,,,,,,,,,0,0,0,0,,,,4,4,0,2,7,1,1,0,10,1,0,1,1,0,0,0,0
"Mar 3, 2019 7:00 AM",11,4,7,,,,,,,,,,1,1,0,0,,,,4,3,1,6,9,3,1,2,6,0,1,1,1,0,1,0,1
"Mar 3, 2019 8:00 AM",16,11,5,,,,,,,,,,6,3,3,8,,,,3,2,1,11,10,4,2,2,8,0,5,0,0,0,0,0,0
"Mar 3, 2019 9:00 AM",37,30,7,,,,,,,,,,6,0,6,7,,,,17,10,7,15,18,19,8,11,37,5,4,5,3,2,1,1,0
"Mar 3, 2019 10:00 AM",31,21,10,,,,,,,,,,14,9,5,10,,,,2,1,1,17,13,17,4,13,17,6,4,6,1,5,1,1,0
"Mar 3, 2019 11:00 AM",27,16,11,,,,,,,,,,16,3,13,10,,,,11,10,1,7,18,6,3,3,21,4,0,0,0,0,0,0,0
"Mar 3, 2019 12:00 PM",18,7,11,,,,,,,,,,6,2,4,2,,,,7,7,0,6,9,6,1,5,13,10,1,2,2,0,0,0,0
"Mar 3, 2019 1:00 PM",24,13,11,,,,,,,,,,3,3,0,3,,,,2,2,0,8,5,3,1,2,16,0,1,2,2,0,0,0,0
"Mar 3, 2019 2:00 PM",17,5,12,,,,,,,,,,8,3,5,3,,,,7,5,2,4,5,1,1,0,4,2,3,0,0,0,1,1,0
"Mar 3, 2019 3:00 PM",20,10,10,,,,,,,,,,5,3,2,2,,,,4,1,3,4,3,1,1,0,5,1,2,1,1,0,0,0,0
"Mar 3, 2019 4:00 PM",12,2,10,,,,,,,,,,2,2,0,1,,,,6,5,1,1,1,1,0,1,6,0,0,0,0,0,1,0,1
"Mar 3, 2019 5:00 PM",15,7,8,,,,,,,,,,0,0,0,3,,,,13,11,2,1,6,3,1,2,0,0,0,1,0,1,0,0,0
"Mar 3, 2019 6:00 PM",16,4,12,,,,,,,,,,1,1,0,2,,,,4,4,0,3,6,0,0,0,5,0,0,0,0,0,0,0,0
"Mar 3, 2019 7:00 PM",7,3,4,,,,,,,,,,1,1,0,2,,,,3,3,0,3,4,1,0,1,4,0,0,0,0,0,2,1,1
"Mar 3, 2019 8:00 PM",10,4,6,,,,,,,,,,4,3,1,0,,,,6,5,1,3,5,1,0,1,6,0,1,1,1,0,3,1,2
"Mar 3, 2019 9:00 PM",8,2,6,,,,,,,,,,0,0,0,2,,,,3,2,1,0,3,3,0,3,2,0,0,0,0,0,0,0,0
"Mar 3, 2019 10:00 PM",4,0,4,,,,,,,,,,0,0,0,2,,,,1,1,0,2,2,1,1,0,4,0,1,0,0,0,1,0,1
"Mar 3, 2019 11:00 PM",2,1,1,,,,,,,,,,0,0,0,0,,,,1,1,0,0,2,0,0,0,0,1,1,0,0,0,0,0,0
"Mar 4, 2019 12:00 AM",2,1,1,,,,,,,,,,0,0,0,0,,,,0,0,0,2,1,0,0,0,0,0,2,0,0,0,0,0,0
"Mar 4, 2019 1:00 AM",0,0,0,,,,,,,,,,1,1,0,0,,,,0,0,0,0,1,0,0,0,0,0,0,0,0,0,0,0,0
"Mar 4, 2019 2:00 AM",0,0,0,,,,,,,,,,0,0,0,0,,,,0,0,0,0,1,0,0,0,0,0,0,0,0,0,0,0,0
"Mar 4, 2019 3:00 AM",1,1,0,,,,,,,,,,0,0,0,0,,,,1,1,0,0,1,0,0,0,0,0,0,0,0,0,0,0,0
"Mar 4, 2019 4:00 AM",0,0,0,,,,,,,,,,0,0,0,0,,,,0,0,0,0,0,0,0,0,1,0,0,0,0,0,0,0,0
"Mar 4, 2019 5:00 AM",4,3,1,,,,,,,,,,0,0,0,1,,,,0,0,0,2,1,0,0,0,10,2,0,0,0,0,0,0,0
"Mar 4, 2019 6:00 AM",38,27,11,,,,,,,,,,1,0,1,4,,,,4,2,2,18,10,2,1,1,37,1,0,3,1,2,1,0,1
"Mar 4, 2019 7:00 AM",153,127,26,,,,,,,,,,5,0,5,11,,,,19,16,3,96,15,20,13,7,137,0,4,1,0,1,0,0,0
"Mar 4, 2019 8:00 AM",369,304,65,,,,,,,,,,21,3,18,28,,,,38,23,15,254,55,79,67,12,313,5,4,11,9,2,7,3,4
"Mar 4, 2019 9:00 AM",232,207,25,,,,,,,,,,16,8,8,7,,,,24,9,15,113,24,37,27,10,107,1,1,5,3,2,3,1,2
"Mar 4, 2019 10:00 AM",74,65,9,,,,,,,,,,6,2,4,7,,,,23,10,13,59,9,13,5,8,27,1,1,2,1,1,2,1,1
"Mar 4, 2019 11:00 AM",74,54,20,,,,,,,,,,9,0,9,5,,,,15,11,4,27,10,12,3,9,18,0,2,5,2,3,0,0,0
"Mar 4, 2019 12:00 PM",67,40,27,,,,,,,,,,10,3,7,7,,,,13,9,4,31,7,7,2,5,18,3,1,2,1,1,1,1,0
"Mar 4, 2019 1:00 PM",74,32,42,,,,,,,,,,9,6,3,7,,,,16,15,1,13,19,6,1,5,15,2,0,1,1,0,1,0,1
"Mar 4, 2019 2:00 PM",67,31,36,,,,,,,,,,9,6,3,10,,,,33,27,6,11,11,14,2,12,11,1,0,3,2,1,1,0,1
"Mar 4, 2019 3:00 PM",84,21,63,,,,,,,,,,9,4,5,8,,,,32,28,4,14,19,7,3,4,21,2,1,5,2,3,2,2,0
"Mar 4, 2019 4:00 PM",129,25,104,,,,,,,,,,15,3,12,11,,,,60,58,2,22,50,17,4,13,33,2,1,1,1,0,4,3,1
"Mar 4, 2019 5:00 PM",273,47,226,,,,,,,,,,18,13,5,18,,,,146,137,9,27,117,52,8,44,56,3,0,3,2,1,0,0,0
"Mar 4, 2019 6:00 PM",311,59,252,,,,,,,,,,20,15,5,18,,,,183,179,4,29,151,99,8,91,37,5,6,4,1,3,2,0,2
"Mar 4, 2019 7:00 PM",162,38,124,,,,,,,,,,8,5,3,6,,,,75,71,4,19,73,27,3,24,26,4,2,4,2,2,3,2,1
"Mar 4, 2019 8:00 PM",103,25,78,,,,,,,,,,3,2,1,7,,,,56,53,3,16,29,6,0,6,9,3,3,3,0,3,0,0,0
"Mar 4, 2019 9:00 PM",78,10,68,,,,,,,,,,3,3,0,2,,,,38,38,0,10,9,10,0,10,15,3,0,1,1,0,1,0,1
"Mar 4, 2019 10:00 PM",43,10,33,,,,,,,,,,4,4,0,1,,,,23,23,0,6,13,3,0,3,7,0,1,0,0,0,1,1,0
"Mar 4, 2019 11:00 PM",19,3,16,,,,,,,,,,1,1,0,0,,,,8,8,0,1,10,1,0,1,1,1,2,1,1,0,0,0,0
"Mar 5, 2019 12:00 AM",3,1,2,,,,,,,,,,0,0,0,0,,,,1,1,0,0,1,1,0,1,1,0,1,0,0,0,0,0,0
"Mar 5, 2019 1:00 AM",2,1,1,,,,,,,,,,0,0,0,0,,,,2,2,0,0,0,0,0,0,0,0,1,0,0,0,0,0,0
"Mar 5, 2019 2:00 AM",0,0,0,,,,,,,,,,0,0,0,0,,,,0,0,0,0,0,1,0,1,0,0,0,0,0,0,0,0,0
"Mar 5, 2019 3:00 AM",1,1,0,,,,,,,,,,0,0,0,0,,,,1,1,0,0,0,1,0,1,0,0,0,0,0,0,0,0,0
"Mar 5, 2019 4:00 AM",3,2,1,,,,,,,,,,0,0,0,0,,,,1,1,0,0,0,0,0,0,0,0,0,0,0,0,0,0,0
"Mar 5, 2019 5:00 AM",7,5,2,,,,,,,,,,0,0,0,1,,,,0,0,0,8,2,0,0,0,9,2,0,0,0,0,0,0,0
"Mar 5, 2019 6:00 AM",45,36,9,,,,,,,,,,1,0,1,6,,,,6,5,1,25,6,1,1,0,46,0,1,1,1,0,1,0,1
"Mar 5, 2019 7:00 AM",201,169,32,,,,,,,,,,11,2,9,12,,,,35,26,9,123,24,23,18,5,143,2,2,1,1,0,3,1,2
"Mar 5, 2019 8:00 AM",405,347,58,,,,,,,,,,21,4,17,29,,,,54,31,23,272,47,72,59,13,309,4,4,10,7,3,5,3,2
"Mar 5, 2019 9:00 AM",237,211,26,,,,,,,,,,16,6,10,8,,,,26,11,15,136,23,51,36,15,111,2,5,2,0,2,1,0,1
"Mar 5, 2019 10:00 AM",107,87,20,,,,,,,,,,7,1,6,2,,,,12,5,7,57,12,10,3,7,35,1,3,2,2,0,0,0,0
"Mar 5, 2019 11:00 AM",59,40,19,,,,,,,,,,7,4,3,4,,,,10,7,3,23,12,8,7,1,23,1,4,6,3,3,1,1,0
"Mar 5, 2019 12:00 PM",71,35,36,,,,,,,,,,8,4,4,6,,,,19,18,1,26,13,12,6,6,14,4,0,3,2,1,0,0,0
"Mar 5, 2019 1:00 PM",80,40,40,,,,,,,,,,19,13,6,12,,,,19,16,3,22,13,21,6,15,18,3,0,3,1,2,0,0,0
"Mar 5, 2019 2:00 PM",68,32,36,,,,,,,,,,10,8,2,5,,,,32,31,1,23,14,15,5,10,17,0,0,3,1,2,1,0,1
"Mar 5, 2019 3:00 PM",94,18,76,,,,,,,,,,4,2,2,15,,,,36,34,2,18,22,17,5,12,12,2,0,3,1,2,2,1,1
"Mar 5, 2019 4:00 PM",162,35,127,,,,,,,,,,8,5,3,17,,,,78,75,3,25,41,33,9,24,30,2,0,15,9,6,9,6,3
"Mar 5, 2019 5:00 PM",310,69,241,,,,,,,,,,13,9,4,18,,,,166,160,6,43,137,58,6,52,58,6,1,9,8,1,3,2,1
"Mar 5, 2019 6:00 PM",308,55,253,,,,,,,,,,19,15,4,30,,,,181,178,3,34,146,90,12,78,43,3,4,6,1,5,2,0,2
"Mar 5, 2019 7:00 PM",182,22,160,,,,,,,,,,5,3,2,13,,,,78,75,3,15,60,29,5,24,12,2,1,5,3,2,4,3,1
"Mar 5, 2019 8:00 PM",110,18,92,,,,,,,,,,3,3,0,2,,,,47,47,0,9,34,11,1,10,8,3,1,6,5,1,1,0,1
"Mar 5, 2019 9:00 PM",66,6,60,,,,,,,,,,1,0,1,1,,,,28,28,0,7,9,3,0,3,10,1,1,3,2,1,1,1,0
"Mar 5, 2019 10:00 PM",36,7,29,,,,,,,,,,2,1,1,3,,,,15,15,0,4,3,3,2,1,10,0,0,0,0,0,0,0,0
"Mar 5, 2019 11:00 PM",5,1,4,,,,,,,,,,0,0,0,0,,,,5,5,0,0,3,0,0,0,2,1,0,0,0,0,0,0,0
"Mar 6, 2019 12:00 AM",5,2,3,,,,,,,,,,0,0,0,0,,,,4,4,0,0,3,1,0,1,2,0,0,0,0,0,0,0,0
"Mar 6, 2019 1:00 AM",0,0,0,,,,,,,,,,0,0,0,0,,,,1,1,0,0,0,1,0,1,1,0,1,0,0,0,0,0,0
"Mar 6, 2019 2:00 AM",1,0,1,,,,,,,,,,0,0,0,0,,,,0,0,0,0,0,0,0,0,0,0,0,0,0,0,0,0,0
"Mar 6, 2019 3:00 AM",1,1,0,,,,,,,,,,0,0,0,0,,,,1,1,0,0,0,0,0,0,0,0,0,0,0,0,0,0,0
"Mar 6, 2019 4:00 AM",1,1,0,,,,,,,,,,0,0,0,0,,,,0,0,0,0,0,0,0,0,0,0,0,0,0,0,0,0,0
"Mar 6, 2019 5:00 AM",7,6,1,,,,,,,,,,0,0,0,1,,,,3,2,1,6,1,0,0,0,7,2,0,0,0,0,0,0,0
"Mar 6, 2019 6:00 AM",41,34,7,,,,,,,,,,0,0,0,6,,,,3,2,1,19,8,2,1,1,51,2,0,2,0,2,1,0,1
"Mar 6, 2019 7:00 AM",218,175,43,,,,,,,,,,11,2,9,18,,,,25,17,8,140,28,23,16,7,146,1,3,3,1,2,0,0,0
"Mar 6, 2019 8:00 AM",425,361,64,,,,,,,,,,23,5,18,33,,,,47,22,25,283,61,79,69,10,311,8,5,15,13,2,7,1,6
"Mar 6, 2019 9:00 AM",218,188,30,,,,,,,,,,14,6,8,7,,,,23,14,9,132,25,49,32,17,118,3,0,9,5,4,1,0,1
"Mar 6, 2019 10:00 AM",94,71,23,,,,,,,,,,14,3,11,11,,,,16,8,8,50,14,14,10,4,34,3,2,3,3,0,2,0,2
"Mar 6, 2019 11:00 AM",68,51,17,,,,,,,,,,8,4,4,7,,,,14,10,4,34,5,8,6,2,23,2,1,6,3,3,2,2,0
"Mar 6, 2019 12:00 PM",65,38,27,,,,,,,,,,7,5,2,5,,,,25,21,4,27,10,23,4,19,21,0,1,0,0,0,0,0,0
"Mar 6, 2019 1:00 PM",78,28,50,,,,,,,,,,7,6,1,7,,,,30,25,5,21,18,15,7,8,19,4,2,4,2,2,2,2,0
"Mar 6, 2019 2:00 PM",75,29,46,,,,,,,,,,15,11,4,16,,,,25,23,2,17,22,20,6,14,16,4,0,4,2,2,3,1,2
"Mar 6, 2019 3:00 PM",96,25,71,,,,,,,,,,7,2,5,11,,,,44,41,3,15,24,15,3,12,19,2,3,7,3,4,1,1,0
"Mar 6, 2019 4:00 PM",150,32,118,,,,,,,,,,14,11,3,9,,,,65,62,3,24,52,25,2,23,35,3,1,8,7,1,4,1,3
"Mar 6, 2019 5:00 PM",301,65,236,,,,,,,,,,18,9,9,25,,,,153,150,3,41,111,56,8,48,80,6,2,8,5,3,7,4,3
"Mar 6, 2019 6:00 PM",301,60,241,,,,,,,,,,20,18,2,30,,,,193,187,6,32,133,81,6,75,52,5,5,13,9,4,2,2,0
"Mar 6, 2019 7:00 PM",185,33,152,,,,,,,,,,8,3,5,13,,,,87,84,3,15,67,36,2,34,26,3,1,3,1,2,1,1,0
"Mar 6, 2019 8:00 PM",106,17,89,,,,,,,,,,3,1,2,6,,,,51,49,2,12,48,13,4,9,21,2,2,4,1,3,0,0,0
"Mar 6, 2019 9:00 PM",84,11,73,,,,,,,,,,2,2,0,2,,,,40,40,0,8,29,8,1,7,14,2,0,2,1,1,0,0,0
"Mar 6, 2019 10:00 PM",45,7,38,,,,,,,,,,0,0,0,6,,,,15,15,0,0,18,7,2,5,13,0,0,0,0,0,0,0,0
"Mar 6, 2019 11:00 PM",17,2,15,,,,,,,,,,0,0,0,1,,,,14,14,0,3,9,2,0,2,4,0,0,0,0,0,0,0,0
"Mar 7, 2019 12:00 AM",7,2,5,,,,,,,,,,0,0,0,0,,,,8,7,1,3,2,0,0,0,2,0,0,0,0,0,0,0,0
"Mar 7, 2019 1:00 AM",2,0,2,,,,,,,,,,0,0,0,0,,,,4,4,0,0,3,0,0,0,0,0,0,0,0,0,0,0,0
"Mar 7, 2019 2:00 AM",3,1,2,,,,,,,,,,0,0,0,0,,,,1,1,0,0,2,0,0,0,0,0,0,0,0,0,0,0,0
"Mar 7, 2019 3:00 AM",3,1,2,,,,,,,,,,0,0,0,0,,,,2,2,0,0,2,0,0,0,0,0,0,0,0,0,0,0,0
"Mar 7, 2019 4:00 AM",1,1,0,,,,,,,,,,0,0,0,0,,,,1,1,0,1,0,0,0,0,1,1,0,0,0,0,0,0,0
"Mar 7, 2019 5:00 AM",5,5,0,,,,,,,,,,0,0,0,1,,,,1,1,0,10,2,0,0,0,5,2,0,0,0,0,0,0,0
"Mar 7, 2019 6:00 AM",45,39,6,,,,,,,,,,3,0,3,7,,,,7,7,0,21,7,1,0,1,47,0,1,2,1,1,0,0,0
"Mar 7, 2019 7:00 AM",165,137,28,,,,,,,,,,8,1,7,10,,,,24,17,7,102,19,18,11,7,120,0,4,2,1,1,1,0,1
"Mar 7, 2019 8:00 AM",382,328,54,,,,,,,,,,19,3,16,27,,,,43,26,17,238,58,70,55,15,280,3,3,17,14,3,5,4,1
"Mar 7, 2019 9:00 AM",194,166,28,,,,,,,,,,11,5,6,6,,,,14,6,8,110,26,30,21,9,82,1,0,2,1,1,1,0,1
"Mar 7, 2019 10:00 AM",97,87,10,,,,,,,,,,5,1,4,6,,,,10,4,6,47,11,5,3,2,17,0,0,2,1,1,1,0,1
"Mar 7, 2019 11:00 AM",54,31,23,,,,,,,,,,0,0,0,7,,,,9,5,4,30,8,4,0,4,10,1,1,0,0,0,1,1,0
"Mar 7, 2019 12:00 PM",67,40,27,,,,,,,,,,8,2,6,9,,,,22,18,4,23,8,11,1,10,15,1,0,1,1,0,0,0,0
"Mar 7, 2019 1:00 PM",79,32,47,,,,,,,,,,8,5,3,8,,,,19,17,2,18,21,12,4,8,23,1,2,0,0,0,0,0,0
"Mar 7, 2019 2:00 PM",49,10,39,,,,,,,,,,10,6,4,10,,,,26,23,3,14,14,14,6,8,12,2,1,4,3,1,0,0,0
"Mar 7, 2019 3:00 PM",69,18,51,,,,,,,,,,4,3,1,2,,,,36,35,1,18,19,10,1,9,23,6,1,5,1,4,1,1,0
"Mar 7, 2019 4:00 PM",136,20,116,,,,,,,,,,9,7,2,8,,,,76,71,5,20,49,25,8,17,32,2,2,5,1,4,0,0,0
"Mar 7, 2019 5:00 PM",271,40,231,,,,,,,,,,20,13,7,19,,,,127,122,5,29,83,48,6,42,59,7,0,1,0,1,1,1,0
"Mar 7, 2019 6:00 PM",301,60,241,,,,,,,,,,16,14,2,16,,,,173,167,6,32,117,61,8,53,41,6,2,4,2,2,4,3,1
"Mar 7, 2019 7:00 PM",130,30,100,,,,,,,,,,12,9,3,6,,,,73,72,1,18,57,25,4,21,17,0,3,4,1,3,1,1,0
"Mar 7, 2019 8:00 PM",107,21,86,,,,,,,,,,6,2,4,4,,,,45,44,1,16,33,16,4,12,14,3,1,3,2,1,0,0,0
"Mar 7, 2019 9:00 PM",83,13,70,,,,,,,,,,3,2,1,3,,,,28,28,0,10,21,9,2,7,9,0,4,1,0,1,1,1,0
"Mar 7, 2019 10:00 PM",45,8,37,,,,,,,,,,5,2,3,5,,,,22,19,3,3,13,6,0,6,11,0,0,0,0,0,0,0,0
"Mar 7, 2019 11:00 PM",18,4,14,,,,,,,,,,1,1,0,2,,,,10,10,0,4,10,2,1,1,2,2,0,0,0,0,0,0,0
"Mar 8, 2019 12:00 AM",5,0,5,,,,,,,,,,0,0,0,0,,,,7,6,1,3,8,5,1,4,1,0,0,0,0,0,0,0,0
"Mar 8, 2019 1:00 AM",3,0,3,,,,,,,,,,0,0,0,0,,,,1,1,0,0,4,0,0,0,1,0,0,0,0,0,0,0,0
"Mar 8, 2019 2:00 AM",3,0,3,,,,,,,,,,0,0,0,0,,,,1,1,0,0,2,1,0,1,1,0,0,0,0,0,0,0,0
"Mar 8, 2019 3:00 AM",1,1,0,,,,,,,,,,0,0,0,0,,,,1,1,0,0,0,0,0,0,0,0,0,0,0,0,0,0,0
"Mar 8, 2019 4:00 AM",5,1,4,,,,,,,,,,0,0,0,0,,,,1,1,0,0,0,0,0,0,2,0,0,0,0,0,0,0,0
"Mar 8, 2019 5:00 AM",10,9,1,,,,,,,,,,1,0,1,2,,,,1,1,0,8,1,0,0,0,10,2,0,0,0,0,0,0,0
"Mar 8, 2019 6:00 AM",43,32,11,,,,,,,,,,1,0,1,3,,,,6,5,1,25,10,3,3,0,47,3,0,3,0,3,0,0,0
"Mar 8, 2019 7:00 AM",138,101,37,,,,,,,,,,11,1,10,11,,,,22,15,7,102,21,29,20,9,108,0,5,1,0,1,1,0,1
"Mar 8, 2019 8:00 AM",314,257,57,,,,,,,,,,12,2,10,22,,,,38,28,10,191,45,63,56,7,235,4,4,9,6,3,4,0,4
"Mar 8, 2019 9:00 AM",183,161,22,,,,,,,,,,14,4,10,3,,,,18,11,7,95,26,58,30,28,88,3,2,2,1,1,0,0,0
"Mar 8, 2019 10:00 AM",82,63,19,,,,,,,,,,10,3,7,3,,,,9,5,4,42,15,12,7,5,21,1,1,0,0,0,0,0,0
"Mar 8, 2019 11:00 AM",50,32,18,,,,,,,,,,5,2,3,3,,,,15,10,5,18,7,8,3,5,26,1,2,2,1,1,0,0,0
"Mar 8, 2019 12:00 PM",66,30,36,,,,,,,,,,7,3,4,6,,,,20,19,1,18,14,6,3,3,13,2,0,0,0,0,0,0,0
"Mar 8, 2019 1:00 PM",96,34,62,,,,,,,,,,8,4,4,4,,,,22,18,4,13,21,14,5,9,29,0,1,3,3,0,0,0,0
"Mar 8, 2019 2:00 PM",71,29,42,,,,,,,,,,8,5,3,3,,,,27,23,4,23,23,9,1,8,14,1,0,5,2,3,0,0,0
"Mar 8, 2019 3:00 PM",91,29,62,,,,,,,,,,9,5,4,5,,,,42,41,1,14,27,16,4,12,20,4,2,7,2,5,3,3,0
"Mar 8, 2019 4:00 PM",142,30,112,,,,,,,,,,20,11,9,17,,,,71,67,4,23,51,26,5,21,29,2,2,15,8,7,11,8,3
"Mar 8, 2019 5:00 PM",243,44,199,,,,,,,,,,21,13,8,11,,,,124,119,5,32,114,48,8,40,48,4,2,3,1,2,2,2,0
"Mar 8, 2019 6:00 PM",183,32,151,,,,,,,,,,23,18,5,18,,,,109,107,2,28,115,60,5,55,27,1,0,1,1,0,0,0,0
"Mar 8, 2019 7:00 PM",102,21,81,,,,,,,,,,9,6,3,9,,,,57,54,3,10,31,22,2,20,11,1,2,3,2,1,1,1,0
"Mar 8, 2019 8:00 PM",60,20,40,,,,,,,,,,3,2,1,6,,,,25,25,0,11,20,8,0,8,7,1,0,1,1,0,0,0,0
"Mar 8, 2019 9:00 PM",43,14,29,,,,,,,,,,2,1,1,4,,,,16,15,1,3,9,5,1,4,12,2,2,1,0,1,0,0,0
"Mar 8, 2019 10:00 PM",35,12,23,,,,,,,,,,2,1,1,1,,,,15,15,0,3,7,1,0,1,5,0,0,0,0,0,0,0,0
"Mar 8, 2019 11:00 PM",18,8,10,,,,,,,,,,0,0,0,1,,,,5,5,0,1,9,0,0,0,5,0,0,0,0,0,0,0,0
"Mar 9, 2019 12:00 AM",11,2,9,,,,,,,,,,1,1,0,0,,,,8,8,0,2,11,2,2,0,4,0,0,0,0,0,0,0,0
"Mar 9, 2019 1:00 AM",8,2,6,,,,,,,,,,2,0,2,0,,,,8,8,0,1,2,1,1,0,1,0,1,3,2,1,1,0,1
"Mar 9, 2019 2:00 AM",6,0,6,,,,,,,,,,1,1,0,0,,,,0,0,0,0,3,1,0,1,1,0,0,0,0,0,0,0,0
"Mar 9, 2019 3:00 AM",5,1,4,,,,,,,,,,0,0,0,0,,,,1,1,0,0,1,0,0,0,1,0,2,0,0,0,0,0,0
"Mar 9, 2019 4:00 AM",3,1,2,,,,,,,,,,0,0,0,0,,,,0,0,0,0,4,0,0,0,1,0,0,0,0,0,0,0,0
"Mar 9, 2019 5:00 AM",3,2,1,,,,,,,,,,0,0,0,1,,,,2,2,0,1,1,0,0,0,1,0,0,0,0,0,0,0,0
"Mar 9, 2019 6:00 AM",8,6,2,,,,,,,,,,0,0,0,0,,,,1,1,0,1,1,1,1,0,4,0,0,0,0,0,0,0,0
"Mar 9, 2019 7:00 AM",15,7,8,,,,,,,,,,5,1,4,0,,,,1,1,0,6,8,5,4,1,11,0,1,0,0,0,0,0,0
"Mar 9, 2019 8:00 AM",25,14,11,,,,,,,,,,5,1,4,3,,,,7,5,2,15,9,6,2,4,19,1,5,2,1,1,0,0,0
"Mar 9, 2019 9:00 AM",37,27,10,,,,,,,,,,11,4,7,6,,,,17,11,6,17,22,10,3,7,20,0,6,1,0,1,0,0,0
"Mar 9, 2019 10:00 AM",24,11,13,,,,,,,,,,13,4,9,13,,,,11,10,1,20,14,11,4,7,11,2,8,4,1,3,0,0,0
"Mar 9, 2019 11:00 AM",43,26,17,,,,,,,,,,12,6,6,13,,,,20,15,5,25,13,13,5,8,20,4,1,2,0,2,1,0,1
"Mar 9, 2019 12:00 PM",37,19,18,,,,,,,,,,8,7,1,7,,,,20,17,3,25,17,17,4,13,14,6,0,6,5,1,0,0,0
"Mar 9, 2019 1:00 PM",49,28,21,,,,,,,,,,9,4,5,14,,,,26,22,4,17,21,20,5,15,25,5,1,0,0,0,0,0,0
"Mar 9, 2019 2:00 PM",44,27,17,,,,,,,,,,27,10,17,12,,,,5,4,1,13,10,18,6,12,19,2,1,2,2,0,0,0,0
"Mar 9, 2019 3:00 PM",31,13,18,,,,,,,,,,25,15,10,5,,,,15,11,4,10,9,11,5,6,24,4,4,5,3,2,1,0,1
"Mar 9, 2019 4:00 PM",37,16,21,,,,,,,,,,25,14,11,5,,,,19,19,0,13,15,13,2,11,13,0,2,5,2,3,1,1,0
"Mar 9, 2019 5:00 PM",42,14,28,,,,,,,,,,17,12,5,6,,,,18,17,1,14,11,8,3,5,21,1,0,4,3,1,0,0,0
"Mar 9, 2019 6:00 PM",30,11,19,,,,,,,,,,16,6,10,15,,,,11,10,1,9,11,8,4,4,13,2,1,2,1,1,0,0,0
"Mar 9, 2019 7:00 PM",33,14,19,,,,,,,,,,3,1,2,3,,,,12,10,2,4,11,3,3,0,8,0,0,1,1,0,0,0,0
"Mar 9, 2019 8:00 PM",22,13,9,,,,,,,,,,4,3,1,1,,,,6,6,0,9,5,3,1,2,9,1,0,0,0,0,0,0,0
"Mar 9, 2019 9:00 PM",15,5,10,,,,,,,,,,2,0,2,1,,,,3,2,1,4,3,0,0,0,1,0,0,1,0,1,1,1,0
"Mar 9, 2019 10:00 PM",16,7,9,,,,,,,,,,4,2,2,3,,,,6,6,0,0,0,0,0,0,8,0,0,0,0,0,0,0,0
"Mar 9, 2019 11:00 PM",5,0,5,,,,,,,,,,1,1,0,2,,,,5,5,0,1,1,4,2,2,6,0,0,1,0,1,0,0,0
"Mar 10, 2019 12:00 AM",6,1,5,,,,,,,,,,3,2,1,0,,,,1,1,0,2,2,2,1,1,1,0,1,0,0,0,0,0,0
"Mar 10, 2019 1:00 AM",1,1,0,,,,,,,,,,1,1,0,0,,,,1,1,0,2,2,0,0,0,1,0,0,0,0,0,0,0,0
"Mar 10, 2019 2:00 AM",4,2,2,,,,,,,,,,0,0,0,0,,,,1,1,0,1,0,0,0,0,0,0,3,1,1,0,0,0,0
"Mar 10, 2019 3:00 AM",3,1,2,,,,,,,,,,0,0,0,0,,,,3,3,0,0,1,0,0,0,0,0,0,0,0,0,0,0,0
"Mar 10, 2019 4:00 AM",1,0,1,,,,,,,,,,0,0,0,0,,,,0,0,0,0,0,0,0,0,1,0,0,0,0,0,0,0,0
"Mar 10, 2019 5:00 AM",4,2,2,,,,,,,,,,0,0,0,0,,,,1,1,0,0,2,0,0,0,2,0,0,0,0,0,0,0,0
"Mar 10, 2019 6:00 AM",6,4,2,,,,,,,,,,1,1,0,1,,,,3,3,0,2,5,0,0,0,10,0,0,0,0,0,0,0,0
"Mar 10, 2019 7:00 AM",9,6,3,,,,,,,,,,2,0,2,0,,,,3,3,0,5,10,1,1,0,7,0,1,1,1,0,2,0,2
"Mar 10, 2019 8:00 AM",19,10,9,,,,,,,,,,3,0,3,5,,,,3,2,1,11,10,6,4,2,11,0,1,0,0,0,1,1,0
"Mar 10, 2019 9:00 AM",31,22,9,,,,,,,,,,6,2,4,7,,,,3,2,1,19,9,13,4,9,17,1,8,1,0,1,1,0,1
"Mar 10, 2019 10:00 AM",34,15,19,,,,,,,,,,19,10,9,15,,,,9,6,3,21,16,20,7,13,34,1,5,2,1,1,0,0,0
"Mar 10, 2019 11:00 AM",30,20,10,,,,,,,,,,17,10,7,9,,,,12,10,2,7,13,9,4,5,20,4,0,2,2,0,0,0,0
"Mar 10, 2019 12:00 PM",27,14,13,,,,,,,,,,17,10,7,13,,,,8,5,3,17,13,12,7,5,27,2,1,0,0,0,0,0,0
"Mar 10, 2019 1:00 PM",39,20,19,,,,,,,,,,22,7,15,13,,,,7,5,2,10,18,15,4,11,18,2,3,1,1,0,2,1,1
"Mar 10, 2019 2:00 PM",32,20,12,,,,,,,,,,8,6,2,6,,,,10,9,1,11,10,6,3,3,10,1,0,0,0,0,0,0,0
"Mar 10, 2019 3:00 PM",23,13,10,,,,,,,,,,3,1,2,14,,,,4,2,2,4,9,3,0,3,15,0,1,1,0,1,0,0,0
"Mar 10, 2019 4:00 PM",32,14,18,,,,,,,,,,6,4,2,9,,,,8,8,0,7,7,6,0,6,8,0,0,3,2,1,1,1,0
"Mar 10, 2019 5:00 PM",24,7,17,,,,,,,,,,21,17,4,4,,,,12,10,2,3,11,7,3,4,9,0,0,3,2,1,0,0,0
"Mar 10, 2019 6:00 PM",30,9,21,,,,,,,,,,4,3,1,10,,,,9,8,1,7,8,6,3,3,10,1,0,0,0,0,1,1,0
"Mar 10, 2019 7:00 PM",27,11,16,,,,,,,,,,0,0,0,6,,,,7,6,1,4,7,4,2,2,10,0,0,1,1,0,1,1,0
"Mar 10, 2019 8:00 PM",19,6,13,,,,,,,,,,1,1,0,2,,,,4,4,0,2,6,1,0,1,7,1,0,1,0,1,0,0,0
"Mar 10, 2019 9:00 PM",8,2,6,,,,,,,,,,0,0,0,2,,,,2,2,0,3,4,0,0,0,4,0,0,1,0,1,0,0,0
"Mar 10, 2019 10:00 PM",11,1,10,,,,,,,,,,2,0,2,0,,,,2,2,0,2,1,0,0,0,9,1,0,0,0,0,0,0,0
"Mar 10, 2019 11:00 PM",8,1,7,,,,,,,,,,1,0,1,0,,,,4,2,2,1,1,0,0,0,3,0,3,0,0,0,0,0,0
"Mar 11, 2019 12:00 AM",3,0,3,,,,,,,,,,0,0,0,0,,,,1,0,1,2,3,2,0,2,2,0,0,0,0,0,0,0,0
"Mar 11, 2019 1:00 AM",1,0,1,,,,,,,,,,0,0,0,0,,,,1,1,0,0,1,0,0,0,1,0,1,0,0,0,0,0,0
"Mar 11, 2019 2:00 AM",1,0,1,,,,,,,,,,0,0,0,0,,,,0,0,0,0,1,0,0,0,0,0,0,0,0,0,0,0,0
"Mar 11, 2019 3:00 AM",1,0,1,,,,,,,,,,0,0,0,0,,,,0,0,0,0,1,0,0,0,1,0,0,0,0,0,0,0,0
"Mar 11, 2019 4:00 AM",1,0,1,,,,,,,,,,0,0,0,0,,,,0,0,0,0,2,0,0,0,0,0,0,0,0,0,0,0,0
"Mar 11, 2019 5:00 AM",5,4,1,,,,,,,,,,2,0,2,0,,,,1,1,0,3,4,0,0,0,8,2,0,0,0,0,0,0,0
"Mar 11, 2019 6:00 AM",42,27,15,,,,,,,,,,3,0,3,5,,,,3,1,2,26,7,2,1,1,45,1,1,1,0,1,0,0,0
"Mar 11, 2019 7:00 AM",181,147,34,,,,,,,,,,9,1,8,15,,,,35,28,7,114,21,29,19,10,138,1,7,3,1,2,2,0,2
"Mar 11, 2019 8:00 AM",364,296,68,,,,,,,,,,20,7,13,32,,,,41,30,11,237,62,74,61,13,310,5,8,10,9,1,4,0,4
"Mar 11, 2019 9:00 AM",186,170,16,,,,,,,,,,13,4,9,8,,,,25,16,9,98,29,58,41,17,107,3,2,2,1,1,4,0,4
"Mar 11, 2019 10:00 AM",55,42,13,,,,,,,,,,2,0,2,6,,,,10,5,5,37,10,21,13,8,20,3,1,2,1,1,1,0,1
"Mar 11, 2019 11:00 AM",43,33,10,,,,,,,,,,7,2,5,5,,,,5,5,0,21,12,10,0,10,16,1,0,1,1,0,3,1,2
"Mar 11, 2019 12:00 PM",52,34,18,,,,,,,,,,7,3,4,3,,,,14,12,2,16,9,7,3,4,14,2,0,0,0,0,0,0,0
"Mar 11, 2019 1:00 PM",50,23,27,,,,,,,,,,7,5,2,2,,,,19,17,2,16,17,17,6,11,18,0,2,1,0,1,2,1,1
"Mar 11, 2019 2:00 PM",48,28,20,,,,,,,,,,9,6,3,11,,,,19,17,2,14,16,17,6,11,22,1,2,3,1,2,1,0,1
"Mar 11, 2019 3:00 PM",51,21,30,,,,,,,,,,4,2,2,13,,,,26,24,2,18,18,16,7,9,17,4,2,4,2,2,1,1,0
"Mar 11, 2019 4:00 PM",130,26,104,,,,,,,,,,8,5,3,14,,,,61,57,4,17,48,28,9,19,31,1,1,4,1,3,1,1,0
"Mar 11, 2019 5:00 PM",309,49,260,,,,,,,,,,18,15,3,23,,,,153,148,5,30,107,54,4,50,61,3,3,4,3,1,0,0,0
"Mar 11, 2019 6:00 PM",281,38,243,,,,,,,,,,19,17,2,22,,,,158,157,1,37,179,72,6,66,43,5,1,7,2,5,0,0,0
"Mar 11, 2019 7:00 PM",103,25,78,,,,,,,,,,10,8,2,6,,,,68,68,0,10,57,29,2,27,14,1,2,4,1,3,1,1,0
"Mar 11, 2019 8:00 PM",67,13,54,,,,,,,,,,3,3,0,3,,,,31,30,1,14,33,13,1,12,10,2,1,1,1,0,1,1,0
"Mar 11, 2019 9:00 PM",51,13,38,,,,,,,,,,5,5,0,3,,,,21,19,2,5,19,4,1,3,16,2,0,0,0,0,0,0,0
"Mar 11, 2019 10:00 PM",29,3,26,,,,,,,,,,1,1,0,2,,,,13,13,0,4,5,2,0,2,7,0,0,0,0,0,2,2,0
"Mar 11, 2019 11:00 PM",7,0,7,,,,,,,,,,0,0,0,1,,,,6,6,0,0,8,2,1,1,2,0,0,0,0,0,0,0,0
"Mar 12, 2019 12:00 AM",5,0,5,,,,,,,,,,1,0,1,0,,,,1,1,0,0,1,0,0,0,0,0,2,1,0,1,0,0,0
"Mar 12, 2019 1:00 AM",3,0,3,,,,,,,,,,0,0,0,0,,,,1,1,0,0,1,0,0,0,0,0,0,0,0,0,0,0,0
"Mar 12, 2019 2:00 AM",0,0,0,,,,,,,,,,0,0,0,0,,,,0,0,0,0,1,0,0,0,0,0,0,0,0,0,0,0,0
"Mar 12, 2019 3:00 AM",0,0,0,,,,,,,,,,0,0,0,0,,,,1,1,0,0,0,0,0,0,0,0,0,0,0,0,0,0,0
"Mar 12, 2019 4:00 AM",1,1,0,,,,,,,,,,0,0,0,0,,,,1,1,0,0,0,0,0,0,1,0,0,0,0,0,0,0,0
"Mar 12, 2019 5:00 AM",6,4,2,,,,,,,,,,0,0,0,2,,,,0,0,0,5,3,0,0,0,6,2,0,0,0,0,0,0,0
"Mar 12, 2019 6:00 AM",34,25,9,,,,,,,,,,2,0,2,3,,,,1,1,0,19,6,3,3,0,44,2,1,2,1,1,0,0,0
"Mar 12, 2019 7:00 AM",145,113,32,,,,,,,,,,8,2,6,14,,,,1,1,0,106,26,21,13,8,116,1,3,3,2,1,2,0,2
"Mar 12, 2019 8:00 AM",353,292,61,,,,,,,,,,15,5,10,23,,,,29,24,5,186,52,80,71,9,252,2,8,10,8,2,1,0,1
"Mar 12, 2019 9:00 AM",149,133,16,,,,,,,,,,24,12,12,5,,,,29,13,16,73,19,43,28,15,67,4,1,6,4,2,1,0,1
"Mar 12, 2019 10:00 AM",53,42,11,,,,,,,,,,18,10,8,5,,,,14,9,5,30,14,11,9,2,24,1,2,2,1,1,2,1,1
"Mar 12, 2019 11:00 AM",28,19,9,,,,,,,,,,11,8,3,5,,,,8,6,2,15,6,4,2,2,28,0,0,1,1,0,2,1,1
"Mar 12, 2019 12:00 PM",36,23,13,,,,,,,,,,11,3,8,9,,,,5,5,0,12,11,7,2,5,14,1,2,2,1,1,1,0,1
"Mar 12, 2019 1:00 PM",58,24,34,,,,,,,,,,8,6,2,5,,,,12,11,1,20,16,9,3,6,13,1,1,0,0,0,0,0,0
"Mar 12, 2019 2:00 PM",49,24,25,,,,,,,,,,3,1,2,9,,,,15,12,3,9,19,7,2,5,9,2,0,2,1,1,1,1,0
"Mar 12, 2019 3:00 PM",51,17,34,,,,,,,,,,8,4,4,1,,,,14,11,3,10,17,9,0,9,11,1,0,4,1,3,0,0,0
"Mar 12, 2019 4:00 PM",103,29,74,,,,,,,,,,8,3,5,8,,,,17,16,1,23,33,20,6,14,18,3,0,3,3,0,2,1,1
"Mar 12, 2019 5:00 PM",236,46,190,,,,,,,,,,19,14,5,16,,,,59,57,2,29,107,34,3,31,44,5,1,4,0,4,1,1,0
"Mar 12, 2019 6:00 PM",227,39,188,,,,,,,,,,16,13,3,16,,,,109,105,4,30,132,62,3,59,41,3,0,2,1,1,0,0,0
"Mar 12, 2019 7:00 PM",125,22,103,,,,,,,,,,9,7,2,11,,,,119,117,2,11,49,23,3,20,10,2,1,2,2,0,1,1,0
"Mar 12, 2019 8:00 PM",65,14,51,,,,,,,,,,6,5,1,1,,,,60,60,0,6,32,6,0,6,11,2,1,4,2,2,0,0,0
"Mar 12, 2019 9:00 PM",38,2,36,,,,,,,,,,1,1,0,2,,,,34,34,0,3,15,3,0,3,7,0,0,1,1,0,1,1,0
"Mar 12, 2019 10:00 PM",17,4,13,,,,,,,,,,3,3,0,0,,,,21,18,3,4,7,5,0,5,1,0,1,1,0,1,1,1,0
"Mar 12, 2019 11:00 PM",10,0,10,,,,,,,,,,0,0,0,2,,,,10,10,0,1,11,3,1,2,3,1,0,0,0,0,1,1,0
"Mar 13, 2019 12:00 AM",3,1,2,,,,,,,,,,1,0,1,0,,,,7,7,0,2,0,0,0,0,1,0,1,1,0,1,0,0,0
"Mar 13, 2019 1:00 AM",1,0,1,,,,,,,,,,0,0,0,0,,,,6,6,0,0,3,0,0,0,0,0,0,0,0,0,0,0,0
"Mar 13, 2019 2:00 AM",0,0,0,,,,,,,,,,0,0,0,0,,,,1,1,0,0,3,0,0,0,0,0,0,0,0,0,0,0,0
"Mar 13, 2019 3:00 AM",1,1,0,,,,,,,,,,0,0,0,0,,,,0,0,0,0,0,0,0,0,0,0,0,0,0,0,0,0,0
"Mar 13, 2019 4:00 AM",1,1,0,,,,,,,,,,0,0,0,0,,,,0,0,0,0,0,0,0,0,1,0,0,0,0,0,0,0,0
"Mar 13, 2019 5:00 AM",2,2,0,,,,,,,,,,0,0,0,1,,,,1,1,0,4,2,0,0,0,8,2,0,0,0,0,0,0,0
"Mar 13, 2019 6:00 AM",40,34,6,,,,,,,,,,1,0,1,7,,,,8,5,3,17,3,3,3,0,23,0,0,1,0,1,0,0,0
"Mar 13, 2019 7:00 AM",155,127,28,,,,,,,,,,3,0,3,6,,,,16,13,3,84,20,18,12,6,95,0,4,1,1,0,0,0,0
"Mar 13, 2019 8:00 AM",301,251,50,,,,,,,,,,11,3,8,33,,,,36,19,17,186,46,46,36,10,250,1,5,6,5,1,2,0,2
"Mar 13, 2019 9:00 AM",139,110,29,,,,,,,,,,4,1,3,7,,,,8,5,3,69,15,15,10,5,72,2,2,2,1,1,0,0,0
"Mar 13, 2019 10:00 AM",61,50,11,,,,,,,,,,5,2,3,3,,,,9,7,2,23,12,4,4,0,17,3,2,2,2,0,0,0,0
"Mar 13, 2019 11:00 AM",35,27,8,,,,,,,,,,9,3,6,4,,,,7,3,4,21,8,11,3,8,18,2,2,1,1,0,1,0,1
"Mar 13, 2019 12:00 PM",31,18,13,,,,,,,,,,4,3,1,4,,,,9,8,1,17,5,6,2,4,13,2,1,2,1,1,0,0,0
"Mar 13, 2019 1:00 PM",45,22,23,,,,,,,,,,3,2,1,6,,,,14,11,3,13,13,6,3,3,20,2,1,1,1,0,1,1,0
"Mar 13, 2019 2:00 PM",42,23,19,,,,,,,,,,8,7,1,4,,,,17,15,2,7,12,4,1,3,16,2,2,2,1,1,2,2,0
"Mar 13, 2019 3:00 PM",51,23,28,,,,,,,,,,6,4,2,3,,,,18,17,1,6,21,8,1,7,8,2,1,3,2,1,0,0,0
"Mar 13, 2019 4:00 PM",103,21,82,,,,,,,,,,4,4,0,8,,,,37,33,4,18,43,21,4,17,15,4,0,2,2,0,1,0,1
"Mar 13, 2019 5:00 PM",240,41,199,,,,,,,,,,12,8,4,24,,,,93,89,4,26,94,40,8,32,38,2,0,6,4,2,0,0,0
"Mar 13, 2019 6:00 PM",237,31,206,,,,,,,,,,12,11,1,16,,,,132,131,1,37,122,50,6,44,26,4,0,5,3,2,0,0,0
"Mar 13, 2019 7:00 PM",135,29,106,,,,,,,,,,5,3,2,12,,,,62,60,2,13,64,26,1,25,23,1,5,2,1,1,0,0,0
"Mar 13, 2019 8:00 PM",76,15,61,,,,,,,,,,2,2,0,4,,,,33,31,2,4,32,9,2,7,18,1,0,3,1,2,7,2,5
"Mar 13, 2019 9:00 PM",36,10,26,,,,,,,,,,4,3,1,9,,,,16,16,0,8,20,4,1,3,11,1,1,1,0,1,0,0,0
"Mar 13, 2019 10:00 PM",21,4,17,,,,,,,,,,0,0,0,1,,,,12,12,0,4,7,7,1,6,9,0,0,0,0,0,1,1,0
"Mar 13, 2019 11:00 PM",13,4,9,,,,,,,,,,2,2,0,0,,,,9,9,0,2,4,2,0,2,6,0,1,2,2,0,0,0,0
"Mar 14, 2019 12:00 AM",5,1,4,,,,,,,,,,0,0,0,0,,,,4,4,0,1,1,0,0,0,2,1,0,0,0,0,0,0,0
"Mar 14, 2019 1:00 AM",1,0,1,,,,,,,,,,0,0,0,0,,,,6,6,0,0,1,0,0,0,0,0,0,0,0,0,0,0,0
"Mar 14, 2019 2:00 AM",1,0,1,,,,,,,,,,0,0,0,0,,,,1,1,0,0,4,0,0,0,0,0,0,0,0,0,0,0,0
"Mar 14, 2019 3:00 AM",2,2,0,,,,,,,,,,0,0,0,0,,,,0,0,0,0,0,0,0,0,0,0,0,0,0,0,0,0,0
"Mar 14, 2019 4:00 AM",0,0,0,,,,,,,,,,0,0,0,0,,,,0,0,0,0,0,0,0,0,1,0,0,0,0,0,0,0,0
"Mar 14, 2019 5:00 AM",4,2,2,,,,,,,,,,0,0,0,3,,,,3,3,0,7,1,0,0,0,5,2,0,0,0,0,0,0,0
"Mar 14, 2019 6:00 AM",32,25,7,,,,,,,,,,1,0,1,4,,,,4,3,1,15,4,2,2,0,34,0,2,1,1,0,0,0,0
"Mar 14, 2019 7:00 AM",148,119,29,,,,,,,,,,7,2,5,11,,,,17,10,7,90,16,15,8,7,108,1,2,3,2,1,1,0,1
"Mar 14, 2019 8:00 AM",317,263,54,,,,,,,,,,20,4,16,28,,,,34,22,12,197,44,71,56,15,252,4,7,10,9,1,1,0,1
"Mar 14, 2019 9:00 AM",156,131,25,,,,,,,,,,12,5,7,6,,,,13,9,4,86,29,27,16,11,77,1,2,3,3,0,1,0,1
"Mar 14, 2019 10:00 AM",50,39,11,,,,,,,,,,5,1,4,5,,,,6,4,2,28,9,10,3,7,22,0,0,1,0,1,0,0,0
"Mar 14, 2019 11:00 AM",35,16,19,,,,,,,,,,4,1,3,2,,,,5,2,3,12,6,13,9,4,20,1,1,0,0,0,0,0,0
"Mar 14, 2019 12:00 PM",40,22,18,,,,,,,,,,6,2,4,5,,,,16,13,3,11,10,8,3,5,21,0,1,2,1,1,0,0,0
"Mar 14, 2019 1:00 PM",59,21,38,,,,,,,,,,13,6,7,4,,,,12,12,0,12,16,4,3,1,16,0,1,2,1,1,0,0,0
"Mar 14, 2019 2:00 PM",38,18,20,,,,,,,,,,16,11,5,4,,,,17,14,3,9,14,9,3,6,15,2,2,1,1,0,0,0,0
"Mar 14, 2019 3:00 PM",47,18,29,,,,,,,,,,6,3,3,3,,,,19,18,1,20,25,10,1,9,12,2,0,4,2,2,0,0,0
"Mar 14, 2019 4:00 PM",105,27,78,,,,,,,,,,7,5,2,14,,,,52,48,4,19,49,18,7,11,20,0,1,3,1,2,1,1,0
"Mar 14, 2019 5:00 PM",240,32,208,,,,,,,,,,12,7,5,14,,,,122,119,3,24,97,39,5,34,47,6,1,2,2,0,0,0,0
"Mar 14, 2019 6:00 PM",237,52,185,,,,,,,,,,14,10,4,13,,,,119,117,2,22,126,68,9,59,40,1,1,4,2,2,1,0,1
"Mar 14, 2019 7:00 PM",102,27,75,,,,,,,,,,14,7,7,11,,,,52,50,2,13,61,24,5,19,12,2,2,6,2,4,4,4,0
"Mar 14, 2019 8:00 PM",87,15,72,,,,,,,,,,7,5,2,2,,,,32,30,2,8,27,10,0,10,21,2,1,0,0,0,0,0,0
"Mar 14, 2019 9:00 PM",40,5,35,,,,,,,,,,2,2,0,4,,,,18,17,1,6,16,6,0,6,13,0,0,0,0,0,0,0,0
"Mar 14, 2019 10:00 PM",34,5,29,,,,,,,,,,1,1,0,0,,,,11,11,0,3,11,6,1,5,6,0,0,0,0,0,0,0,0
"Mar 14, 2019 11:00 PM",9,1,8,,,,,,,,,,0,0,0,2,,,,6,6,0,2,6,0,0,0,3,0,0,0,0,0,0,0,0
"Mar 15, 2019 12:00 AM",4,1,3,,,,,,,,,,4,3,1,0,,,,3,3,0,1,2,0,0,0,3,0,1,0,0,0,0,0,0
"Mar 15, 2019 1:00 AM",4,3,1,,,,,,,,,,0,0,0,0,,,,2,2,0,1,2,1,0,1,0,0,0,0,0,0,0,0,0
"Mar 15, 2019 2:00 AM",3,0,3,,,,,,,,,,0,0,0,0,,,,0,0,0,1,4,0,0,0,0,0,0,0,0,0,0,0,0
"Mar 15, 2019 3:00 AM",4,1,3,,,,,,,,,,0,0,0,0,,,,0,0,0,0,0,0,0,0,0,0,0,0,0,0,0,0,0
"Mar 15, 2019 4:00 AM",1,1,0,,,,,,,,,,0,0,0,0,,,,0,0,0,0,0,0,0,0,0,0,0,0,0,0,0,0,0
"Mar 15, 2019 5:00 AM",8,6,2,,,,,,,,,,0,0,0,3,,,,3,3,0,4,1,0,0,0,5,2,0,0,0,0,0,0,0
"Mar 15, 2019 6:00 AM",37,25,12,,,,,,,,,,3,1,2,4,,,,2,2,0,25,3,4,3,1,32,1,0,1,1,0,0,0,0
"Mar 15, 2019 7:00 AM",129,102,27,,,,,,,,,,5,1,4,9,,,,21,17,4,71,19,14,11,3,83,0,5,0,0,0,0,0,0
"Mar 15, 2019 8:00 AM",250,203,47,,,,,,,,,,15,6,9,22,,,,34,21,13,128,45,47,38,9,181,0,2,3,2,1,1,0,1
"Mar 15, 2019 9:00 AM",127,108,19,,,,,,,,,,14,2,12,4,,,,17,11,6,67,22,24,16,8,66,3,2,3,1,2,0,0,0
"Mar 15, 2019 10:00 AM",41,25,16,,,,,,,,,,11,3,8,2,,,,13,12,1,27,8,12,6,6,17,2,0,0,0,0,0,0,0
"Mar 15, 2019 11:00 AM",23,19,4,,,,,,,,,,11,7,4,3,,,,3,3,0,22,9,10,4,6,12,0,2,1,0,1,0,0,0
"Mar 15, 2019 12:00 PM",59,29,30,,,,,,,,,,11,3,8,7,,,,17,15,2,23,13,5,2,3,25,0,1,0,0,0,0,0,0
"Mar 15, 2019 1:00 PM",63,24,39,,,,,,,,,,14,7,7,6,,,,18,17,1,19,19,9,2,7,21,1,1,2,2,0,0,0,0
"Mar 15, 2019 2:00 PM",53,22,31,,,,,,,,,,13,7,6,6,,,,25,23,2,8,19,15,4,11,12,3,2,1,0,1,0,0,0
"Mar 15, 2019 3:00 PM",67,20,47,,,,,,,,,,14,7,7,13,,,,27,24,3,12,23,9,4,5,18,5,1,3,2,1,1,1,0
"Mar 15, 2019 4:00 PM",134,27,107,,,,,,,,,,18,12,6,18,,,,53,51,2,20,45,27,8,19,27,5,1,4,3,1,6,4,2
"Mar 15, 2019 5:00 PM",195,35,160,,,,,,,,,,19,13,6,12,,,,100,94,6,24,104,54,9,45,44,4,3,2,2,0,1,1,0
"Mar 15, 2019 6:00 PM",156,26,130,,,,,,,,,,19,11,8,15,,,,72,72,0,14,86,37,6,31,29,8,2,2,1,1,1,0,1
"Mar 15, 2019 7:00 PM",84,23,61,,,,,,,,,,14,7,7,6,,,,40,39,1,13,45,11,2,9,17,1,1,2,1,1,0,0,0
"Mar 15, 2019 8:00 PM",48,8,40,,,,,,,,,,3,3,0,3,,,,19,17,2,9,16,9,1,8,6,3,2,1,0,1,3,2,1
"Mar 15, 2019 9:00 PM",30,14,16,,,,,,,,,,2,1,1,2,,,,16,15,1,3,16,5,2,3,8,0,0,3,1,2,2,1,1
"Mar 15, 2019 10:00 PM",22,3,19,,,,,,,,,,2,1,1,3,,,,6,5,1,3,9,2,1,1,7,0,0,1,0,1,0,0,0
"Mar 15, 2019 11:00 PM",8,1,7,,,,,,,,,,0,0,0,3,,,,5,4,1,1,5,0,0,0,5,0,0,1,1,0,0,0,0
"Mar 16, 2019 12:00 AM",6,1,5,,,,,,,,,,0,0,0,1,,,,1,1,0,1,4,0,0,0,4,0,1,1,1,0,0,0,0
"Mar 16, 2019 1:00 AM",4,1,3,,,,,,,,,,0,0,0,0,,,,3,3,0,2,3,1,1,0,3,0,0,0,0,0,0,0,0
"Mar 16, 2019 2:00 AM",1,0,1,,,,,,,,,,1,0,1,0,,,,4,4,0,0,2,2,0,2,2,0,1,0,0,0,0,0,0
"Mar 16, 2019 3:00 AM",2,1,1,,,,,,,,,,0,0,0,1,,,,0,0,0,1,1,0,0,0,0,0,1,0,0,0,0,0,0
"Mar 16, 2019 4:00 AM",1,1,0,,,,,,,,,,0,0,0,0,,,,1,1,0,0,1,0,0,0,0,0,0,0,0,0,0,0,0
"Mar 16, 2019 5:00 AM",2,1,1,,,,,,,,,,1,1,0,0,,,,0,0,0,0,1,0,0,0,0,0,0,0,0,0,0,0,0
"Mar 16, 2019 6:00 AM",10,7,3,,,,,,,,,,0,0,0,0,,,,5,4,1,3,0,1,0,1,7,1,0,0,0,0,0,0,0
"Mar 16, 2019 7:00 AM",8,3,5,,,,,,,,,,1,1,0,0,,,,4,4,0,1,4,3,1,2,3,0,0,0,0,0,0,0,0
"Mar 16, 2019 8:00 AM",8,4,4,,,,,,,,,,4,4,0,2,,,,0,0,0,9,7,1,1,0,7,1,0,0,0,0,0,0,0
"Mar 16, 2019 9:00 AM",7,6,1,,,,,,,,,,3,3,0,2,,,,3,2,1,4,4,8,2,6,7,0,0,0,0,0,0,0,0
"Mar 16, 2019 10:00 AM",18,12,6,,,,,,,,,,10,10,0,0,,,,7,4,3,8,8,5,3,2,6,1,4,3,0,3,1,1,0
"Mar 16, 2019 11:00 AM",11,8,3,,,,,,,,,,10,10,0,9,,,,11,10,1,10,5,3,1,2,9,1,1,0,0,0,0,0,0
"Mar 16, 2019 12:00 PM",17,8,9,,,,,,,,,,4,4,0,2,,,,9,7,2,8,5,5,2,3,11,3,2,3,2,1,2,2,0
"Mar 16, 2019 1:00 PM",21,12,9,,,,,,,,,,7,5,2,1,,,,5,5,0,7,9,11,3,8,7,0,1,4,1,3,4,2,2
"Mar 16, 2019 2:00 PM",22,7,15,,,,,,,,,,7,6,1,3,,,,6,5,1,4,5,10,7,3,9,3,0,1,1,0,1,1,0
"Mar 16, 2019 3:00 PM",16,8,8,,,,,,,,,,6,6,0,4,,,,7,6,1,9,6,4,1,3,6,0,2,2,0,2,2,2,0
"Mar 16, 2019 4:00 PM",22,11,11,,,,,,,,,,7,6,1,2,,,,7,7,0,9,8,14,4,10,7,1,0,6,4,2,4,2,2
"Mar 16, 2019 5:00 PM",28,9,19,,,,,,,,,,7,7,0,3,,,,17,16,1,9,4,4,2,2,7,3,1,2,1,1,0,0,0
"Mar 16, 2019 6:00 PM",20,6,14,,,,,,,,,,5,5,0,4,,,,12,9,3,6,9,4,3,1,6,2,1,0,0,0,0,0,0
"Mar 16, 2019 7:00 PM",18,11,7,,,,,,,,,,3,3,0,0,,,,8,6,2,6,3,5,3,2,7,1,0,1,1,0,0,0,0
"Mar 16, 2019 8:00 PM",21,6,15,,,,,,,,,,1,1,0,3,,,,6,5,1,5,4,1,0,1,7,3,0,2,1,1,1,0,1
"Mar 16, 2019 9:00 PM",7,3,4,,,,,,,,,,2,2,0,0,,,,3,3,0,2,6,1,0,1,5,0,1,1,0,1,0,0,0
"Mar 16, 2019 10:00 PM",9,3,6,,,,,,,,,,0,0,0,0,,,,2,2,0,2,8,1,0,1,5,0,1,2,1,1,0,0,0
"Mar 16, 2019 11:00 PM",4,1,3,,,,,,,,,,0,0,0,1,,,,5,5,0,2,2,0,0,0,6,0,0,7,4,3,3,1,2
"Mar 17, 2019 12:00 AM",2,1,1,,,,,,,,,,2,2,0,0,,,,1,1,0,1,1,0,0,0,2,1,0,0,0,0,0,0,0
"Mar 17, 2019 1:00 AM",3,1,2,,,,,,,,,,0,0,0,0,,,,2,1,1,2,1,1,0,1,2,0,0,1,1,0,0,0,0
"Mar 17, 2019 2:00 AM",0,0,0,,,,,,,,,,0,0,0,2,,,,1,1,0,3,1,0,0,0,3,0,3,0,0,0,0,0,0
"Mar 17, 2019 3:00 AM",0,0,0,,,,,,,,,,1,1,0,0,,,,0,0,0,0,0,0,0,0,0,0,0,0,0,0,0,0,0
"Mar 17, 2019 4:00 AM",2,1,1,,,,,,,,,,0,0,0,0,,,,0,0,0,1,1,0,0,0,1,0,0,0,0,0,0,0,0
"Mar 17, 2019 5:00 AM",3,2,1,,,,,,,,,,0,0,0,0,,,,0,0,0,0,2,0,0,0,1,0,0,0,0,0,0,0,0
"Mar 17, 2019 6:00 AM",4,4,0,,,,,,,,,,1,1,0,1,,,,5,4,1,2,3,1,1,0,9,0,1,0,0,0,0,0,0
"Mar 17, 2019 7:00 AM",9,7,2,,,,,,,,,,0,0,0,0,,,,3,3,0,9,11,2,0,2,8,0,2,0,0,0,0,0,0
"Mar 17, 2019 8:00 AM",19,6,13,,,,,,,,,,3,3,0,7,,,,2,2,0,4,9,10,3,7,16,2,8,0,0,0,0,0,0
"Mar 17, 2019 9:00 AM",30,17,13,,,,,,,,,,6,5,1,3,,,,7,6,1,16,19,6,3,3,27,1,19,1,1,0,0,0,0
"Mar 17, 2019 10:00 AM",27,16,11,,,,,,,,,,12,10,2,4,,,,7,4,3,14,24,18,9,9,35,4,9,4,3,1,1,0,1
"Mar 17, 2019 11:00 AM",41,31,10,,,,,,,,,,14,14,0,5,,,,14,11,3,14,23,10,4,6,25,5,3,4,4,0,2,0,2
"Mar 17, 2019 12:00 PM",30,15,15,,,,,,,,,,17,15,2,5,,,,12,10,2,13,16,13,9,4,25,8,3,1,1,0,0,0,0
"Mar 17, 2019 1:00 PM",27,14,13,,,,,,,,,,16,13,3,9,,,,14,12,2,11,11,11,3,8,18,2,2,3,1,2,1,0,1
"Mar 17, 2019 2:00 PM",19,8,11,,,,,,,,,,22,21,1,4,,,,6,5,1,5,21,10,5,5,12,4,3,1,1,0,0,0,0
"Mar 17, 2019 3:00 PM",24,7,17,,,,,,,,,,20,17,3,3,,,,8,6,2,4,14,21,9,12,9,2,1,5,5,0,1,0,1
"Mar 17, 2019 4:00 PM",38,16,22,,,,,,,,,,18,17,1,22,,,,11,10,1,4,21,20,3,17,14,1,1,1,0,1,1,1,0
"Mar 17, 2019 5:00 PM",15,4,11,,,,,,,,,,13,12,1,6,,,,8,6,2,3,6,11,6,5,23,1,1,1,1,0,0,0,0
"Mar 17, 2019 6:00 PM",22,11,11,,,,,,,,,,5,3,2,2,,,,9,9,0,7,9,14,7,7,8,2,2,2,2,0,0,0,0
"Mar 17, 2019 7:00 PM",22,9,13,,,,,,,,,,6,4,2,11,,,,9,6,3,2,7,2,2,0,9,0,0,2,1,1,3,1,2
"Mar 17, 2019 8:00 PM",14,4,10,,,,,,,,,,8,5,3,3,,,,4,2,2,8,10,1,1,0,9,1,1,2,1,1,2,1,1
"Mar 17, 2019 9:00 PM",17,11,6,,,,,,,,,,6,6,0,2,,,,4,4,0,4,5,4,0,4,6,0,0,0,0,0,0,0,0
"Mar 17, 2019 10:00 PM",5,0,5,,,,,,,,,,1,1,0,1,,,,4,4,0,4,1,0,0,0,4,1,0,1,0,1,0,0,0
"Mar 17, 2019 11:00 PM",6,4,2,,,,,,,,,,1,1,0,0,,,,3,3,0,2,1,0,0,0,3,0,2,1,1,0,0,0,0
"Mar 18, 2019 12:00 AM",5,1,4,,,,,,,,,,1,0,1,0,,,,0,0,0,0,5,2,2,0,2,0,0,0,0,0,0,0,0
"Mar 18, 2019 1:00 AM",4,1,3,,,,,,,,,,2,2,0,0,,,,4,3,1,0,0,0,0,0,2,0,0,0,0,0,0,0,0
"Mar 18, 2019 2:00 AM",2,0,2,,,,,,,,,,2,0,2,3,,,,0,0,0,0,1,0,0,0,0,0,1,1,0,1,0,0,0
"Mar 18, 2019 3:00 AM",3,2,1,,,,,,,,,,5,2,3,1,,,,1,0,1,0,1,2,0,2,1,0,0,0,0,0,0,0,0
"Mar 18, 2019 4:00 AM",0,0,0,,,,,,,,,,1,1,0,0,,,,0,0,0,0,1,0,0,0,3,1,0,0,0,0,0,0,0
"Mar 18, 2019 5:00 AM",5,1,4,,,,,,,,,,0,0,0,0,,,,0,0,0,1,4,1,1,0,1,1,0,0,0,0,0,0,0
"Mar 18, 2019 6:00 AM",7,2,5,,,,,,,,,,1,1,0,1,,,,3,2,1,5,4,2,1,1,14,0,0,0,0,0,0,0,0
"Mar 18, 2019 7:00 AM",18,15,3,,,,,,,,,,2,2,0,1,,,,6,6,0,6,4,4,4,0,22,2,6,1,0,1,0,0,0
"Mar 18, 2019 8:00 AM",27,12,15,,,,,,,,,,3,3,0,2,,,,9,6,3,17,13,7,5,2,12,1,2,2,1,1,0,0,0
"Mar 18, 2019 9:00 AM",26,17,9,,,,,,,,,,6,6,0,3,,,,7,5,2,11,8,10,4,6,11,1,17,2,1,1,0,0,0
"Mar 18, 2019 10:00 AM",24,11,13,,,,,,,,,,5,5,0,4,,,,7,5,2,10,21,10,4,6,25,3,6,2,1,1,0,0,0
"Mar 18, 2019 11:00 AM",27,18,9,,,,,,,,,,24,22,2,10,,,,13,9,4,14,15,20,7,13,24,5,5,3,1,2,1,0,1
"Mar 18, 2019 12:00 PM",52,34,18,,,,,,,,,,30,28,2,14,,,,12,12,0,15,25,23,11,12,30,9,3,11,6,5,4,2,2
"Mar 18, 2019 1:00 PM",34,14,20,,,,,,,,,,32,32,0,26,,,,9,8,1,14,15,18,10,8,16,11,7,11,2,9,4,4,0
"Mar 18, 2019 2:00 PM",39,20,19,,,,,,,,,,44,39,5,6,,,,11,8,3,14,27,21,4,17,17,7,1,7,4,3,2,1,1
"Mar 18, 2019 3:00 PM",25,11,14,,,,,,,,,,26,25,1,17,,,,10,10,0,17,17,26,8,18,21,3,2,2,1,1,6,2,4
"Mar 18, 2019 4:00 PM",33,15,18,,,,,,,,,,15,14,1,15,,,,21,19,2,13,13,16,6,10,14,3,1,2,1,1,0,0,0
"Mar 18, 2019 5:00 PM",32,10,22,,,,,,,,,,11,10,1,15,,,,13,11,2,16,21,17,6,11,21,0,2,6,3,3,0,0,0
"Mar 18, 2019 6:00 PM",29,9,20,,,,,,,,,,0,0,0,9,,,,22,21,1,17,17,8,4,4,10,2,1,4,3,1,2,1,1
"Mar 18, 2019 7:00 PM",21,9,12,,,,,,,,,,9,1,8,3,,,,9,7,2,4,13,8,5,3,8,3,0,0,0,0,0,0,0
"Mar 18, 2019 8:00 PM",17,5,12,,,,,,,,,,3,1,2,4,,,,9,9,0,9,8,6,2,4,4,0,0,0,0,0,1,1,0
"Mar 18, 2019 9:00 PM",11,2,9,,,,,,,,,,2,2,0,2,,,,8,8,0,3,4,1,1,0,9,0,1,3,0,3,0,0,0
"Mar 18, 2019 10:00 PM",13,3,10,,,,,,,,,,2,2,0,2,,,,8,8,0,3,6,2,1,1,7,0,1,1,1,0,0,0,0
"Mar 18, 2019 11:00 PM",9,5,4,,,,,,,,,,0,0,0,0,,,,5,5,0,3,1,0,0,0,2,0,0,3,2,1,0,0,0
"Mar 19, 2019 12:00 AM",6,1,5,,,,,,,,,,1,0,1,0,,,,2,2,0,0,1,1,0,1,1,1,1,0,0,0,0,0,0
"Mar 19, 2019 1:00 AM",1,0,1,,,,,,,,,,1,0,1,0,,,,0,0,0,0,1,0,0,0,0,0,1,0,0,0,0,0,0
"Mar 19, 2019 2:00 AM",0,0,0,,,,,,,,,,0,0,0,0,,,,1,1,0,0,0,0,0,0,0,0,0,0,0,0,0,0,0
"Mar 19, 2019 3:00 AM",1,1,0,,,,,,,,,,0,0,0,0,,,,0,0,0,0,0,0,0,0,2,0,0,0,0,0,0,0,0
"Mar 19, 2019 4:00 AM",0,0,0,,,,,,,,,,0,0,0,0,,,,2,2,0,1,0,0,0,0,1,0,0,0,0,0,0,0,0
"Mar 19, 2019 5:00 AM",7,5,2,,,,,,,,,,1,1,0,2,,,,0,0,0,4,2,0,0,0,10,1,0,0,0,0,0,0,0
"Mar 19, 2019 6:00 AM",46,33,13,,,,,,,,,,2,0,2,8,,,,4,4,0,26,7,4,2,2,52,1,2,0,0,0,0,0,0
"Mar 19, 2019 7:00 AM",187,149,38,,,,,,,,,,11,2,9,13,,,,25,21,4,122,32,34,22,12,160,0,5,2,1,1,0,0,0
"Mar 19, 2019 8:00 AM",335,274,61,,,,,,,,,,17,4,13,23,,,,36,27,9,222,62,73,60,13,304,5,7,8,6,2,1,0,1
"Mar 19, 2019 9:00 AM",167,142,25,,,,,,,,,,20,10,10,3,,,,21,12,9,90,33,49,32,17,104,1,2,0,0,0,1,0,1
"Mar 19, 2019 10:00 AM",71,56,15,,,,,,,,,,6,2,4,5,,,,11,5,6,44,6,17,7,10,18,2,4,0,0,0,0,0,0
"Mar 19, 2019 11:00 AM",43,27,16,,,,,,,,,,7,5,2,8,,,,7,6,1,18,5,6,4,2,17,2,2,0,0,0,0,0,0
"Mar 19, 2019 12:00 PM",47,32,15,,,,,,,,,,17,10,7,4,,,,17,13,4,18,8,10,1,9,20,5,1,3,2,1,1,1,0
"Mar 19, 2019 1:00 PM",64,31,33,,,,,,,,,,12,7,5,7,,,,20,17,3,19,15,14,8,6,22,4,2,2,0,2,0,0,0
"Mar 19, 2019 2:00 PM",43,22,21,,,,,,,,,,21,11,10,11,,,,13,12,1,12,15,14,6,8,21,2,2,7,5,2,0,0,0
"Mar 19, 2019 3:00 PM",65,32,33,,,,,,,,,,12,10,2,15,,,,20,20,0,19,25,20,9,11,14,0,0,7,1,6,1,1,0
"Mar 19, 2019 4:00 PM",132,34,98,,,,,,,,,,27,16,11,16,,,,74,69,5,18,52,24,2,22,33,4,0,5,3,2,0,0,0
"Mar 19, 2019 5:00 PM",249,47,202,,,,,,,,,,22,15,7,31,,,,178,175,3,36,142,53,11,42,65,7,3,5,3,2,1,1,0
"Mar 19, 2019 6:00 PM",288,48,240,,,,,,,,,,20,14,6,21,,,,140,138,2,31,177,97,11,86,51,3,2,3,2,1,1,1,0
"Mar 19, 2019 7:00 PM",140,29,111,,,,,,,,,,8,8,0,22,,,,67,66,1,18,82,37,2,35,22,4,3,2,2,0,1,0,1
"Mar 19, 2019 8:00 PM",90,23,67,,,,,,,,,,7,4,3,6,,,,51,50,1,12,38,21,8,13,14,3,1,2,1,1,0,0,0
"Mar 19, 2019 9:00 PM",61,10,51,,,,,,,,,,5,5,0,3,,,,19,18,1,5,32,9,2,7,16,0,0,1,0,1,0,0,0
"Mar 19, 2019 10:00 PM",42,12,30,,,,,,,,,,0,0,0,5,,,,19,18,1,4,11,13,2,11,5,0,1,0,0,0,0,0,0
"Mar 19, 2019 11:00 PM",16,5,11,,,,,,,,,,3,2,1,2,,,,11,11,0,7,4,2,0,2,6,1,1,0,0,0,0,0,0
"Mar 20, 2019 12:00 AM",5,1,4,,,,,,,,,,3,1,2,2,,,,2,1,1,1,2,3,0,3,0,0,1,0,0,0,0,0,0
"Mar 20, 2019 1:00 AM",3,1,2,,,,,,,,,,5,3,2,0,,,,0,0,0,1,1,2,1,1,0,0,0,0,0,0,0,0,0
"Mar 20, 2019 2:00 AM",1,0,1,,,,,,,,,,0,0,0,0,,,,1,1,0,0,2,0,0,0,0,1,0,0,0,0,0,0,0
"Mar 20, 2019 3:00 AM",1,1,0,,,,,,,,,,0,0,0,0,,,,2,2,0,0,0,0,0,0,2,0,0,0,0,0,0,0,0
"Mar 20, 2019 4:00 AM",0,0,0,,,,,,,,,,0,0,0,1,,,,1,1,0,1,0,0,0,0,2,0,0,0,0,0,0,0,0
"Mar 20, 2019 5:00 AM",10,7,3,,,,,,,,,,1,1,0,2,,,,1,0,1,5,5,1,1,0,12,1,0,0,0,0,0,0,0
"Mar 20, 2019 6:00 AM",50,32,18,,,,,,,,,,4,0,4,9,,,,8,6,2,24,9,10,8,2,53,1,3,0,0,0,0,0,0
"Mar 20, 2019 7:00 AM",210,166,44,,,,,,,,,,8,1,7,15,,,,38,31,7,163,39,39,29,10,173,1,7,2,1,1,0,0,0
"Mar 20, 2019 8:00 AM",403,319,84,,,,,,,,,,21,4,17,33,,,,51,34,17,269,85,102,78,24,346,6,10,8,6,2,2,1,1
"Mar 20, 2019 9:00 AM",187,162,25,,,,,,,,,,19,7,12,8,,,,24,13,11,94,27,57,40,17,116,4,1,4,2,2,3,1,2
"Mar 20, 2019 10:00 AM",60,43,17,,,,,,,,,,15,7,8,11,,,,11,8,3,37,16,20,14,6,30,6,4,5,4,1,1,0,1
"Mar 20, 2019 11:00 AM",60,38,22,,,,,,,,,,0,0,0,2,,,,11,10,1,31,14,17,6,11,32,2,2,0,0,0,0,0,0
"Mar 20, 2019 12:00 PM",42,21,21,,,,,,,,,,19,15,4,7,,,,18,18,0,22,19,21,9,12,25,1,3,4,1,3,3,2,1
"Mar 20, 2019 1:00 PM",82,43,39,,,,,,,,,,15,7,8,7,,,,30,24,6,19,22,22,8,14,33,3,2,3,1,2,0,0,0
"Mar 20, 2019 2:00 PM",69,33,36,,,,,,,,,,18,14,4,14,,,,23,21,2,22,18,25,8,17,20,3,2,3,2,1,2,2,0
"Mar 20, 2019 3:00 PM",73,25,48,,,,,,,,,,8,7,1,12,,,,32,28,4,14,31,18,2,16,20,1,3,1,0,1,2,2,0
"Mar 20, 2019 4:00 PM",160,49,111,,,,,,,,,,17,9,8,22,,,,66,62,4,26,61,30,6,24,39,2,1,6,4,2,1,0,1
"Mar 20, 2019 5:00 PM",298,56,242,,,,,,,,,,20,11,9,32,,,,159,155,4,34,156,68,11,57,65,6,4,4,0,4,1,1,0
"Mar 20, 2019 6:00 PM",287,48,239,,,,,,,,,,21,16,5,23,,,,158,157,1,48,188,105,19,86,73,6,3,5,4,1,1,0,1
"Mar 20, 2019 7:00 PM",136,28,108,,,,,,,,,,9,4,5,14,,,,82,81,1,19,104,41,2,39,21,4,1,4,1,3,4,2,2
"Mar 20, 2019 8:00 PM",110,18,92,,,,,,,,,,5,3,2,7,,,,39,38,1,22,37,22,7,15,11,4,0,2,1,1,1,1,0
"Mar 20, 2019 9:00 PM",72,17,55,,,,,,,,,,9,8,1,5,,,,38,35,3,4,24,13,0,13,15,7,1,1,1,0,0,0,0
"Mar 20, 2019 10:00 PM",25,5,20,,,,,,,,,,2,1,1,0,,,,23,23,0,7,12,13,2,11,9,2,1,1,1,0,0,0,0
"Mar 20, 2019 11:00 PM",14,3,11,,,,,,,,,,5,1,4,0,,,,11,10,1,2,11,3,2,1,1,1,0,0,0,0,0,0,0
"Mar 21, 2019 12:00 AM",10,1,9,,,,,,,,,,0,0,0,0,,,,6,5,1,2,4,1,0,1,2,0,1,0,0,0,0,0,0
"Mar 21, 2019 1:00 AM",2,2,0,,,,,,,,,,0,0,0,0,,,,1,1,0,1,2,0,0,0,0,0,0,0,0,0,0,0,0
"Mar 21, 2019 2:00 AM",0,0,0,,,,,,,,,,0,0,0,0,,,,1,1,0,0,1,0,0,0,0,0,0,0,0,0,0,0,0
"Mar 21, 2019 3:00 AM",1,1,0,,,,,,,,,,0,0,0,0,,,,1,1,0,0,1,0,0,0,0,0,0,0,0,0,0,0,0
"Mar 21, 2019 4:00 AM",0,0,0,,,,,,,,,,1,1,0,0,,,,0,0,0,0,0,0,0,0,1,0,0,0,0,0,0,0,0
"Mar 21, 2019 5:00 AM",10,7,3,,,,,,,,,,1,1,0,2,,,,1,0,1,6,3,0,0,0,11,3,0,1,1,0,0,0,0
"Mar 21, 2019 6:00 AM",61,43,18,,,,,,,,,,6,0,6,8,,,,8,7,1,29,11,5,4,1,53,0,1,1,1,0,0,0,0
"Mar 21, 2019 7:00 AM",212,165,47,,,,,,,,,,9,3,6,10,,,,28,22,6,154,30,45,34,11,175,1,10,2,1,1,0,0,0
"Mar 21, 2019 8:00 AM",348,274,74,,,,,,,,,,27,5,22,43,,,,45,27,18,225,85,90,69,21,307,5,7,11,9,2,2,0,2
"Mar 21, 2019 9:00 AM",177,150,27,,,,,,,,,,3,1,2,8,,,,26,16,10,102,19,54,36,18,108,2,6,0,0,0,0,0,0
"Mar 21, 2019 10:00 AM",44,32,12,,,,,,,,,,10,4,6,9,,,,9,8,1,32,17,16,9,7,39,2,3,0,0,0,1,0,1
"Mar 21, 2019 11:00 AM",59,41,18,,,,,,,,,,12,5,7,4,,,,13,8,5,26,16,10,3,7,34,2,5,3,1,2,0,0,0
"Mar 21, 2019 12:00 PM",43,22,21,,,,,,,,,,15,9,6,5,,,,11,10,1,14,22,13,6,7,26,5,1,2,2,0,1,0,1
"Mar 21, 2019 1:00 PM",75,35,40,,,,,,,,,,11,9,2,14,,,,27,26,1,16,23,15,6,9,27,3,0,3,1,2,3,3,0
"Mar 21, 2019 2:00 PM",52,24,28,,,,,,,,,,16,11,5,11,,,,23,21,2,15,28,18,7,11,12,3,8,2,1,1,1,0,1
"Mar 21, 2019 3:00 PM",71,35,36,,,,,,,,,,15,5,10,12,,,,21,21,0,20,23,28,9,19,24,5,2,9,1,8,8,6,2
"Mar 21, 2019 4:00 PM",154,40,114,,,,,,,,,,21,16,5,17,,,,81,79,2,20,64,36,6,30,43,3,0,8,5,3,4,2,2
"Mar 21, 2019 5:00 PM",255,51,204,,,,,,,,,,20,16,4,20,,,,138,133,5,28,142,67,13,54,70,8,0,8,3,5,0,0,0
"Mar 21, 2019 6:00 PM",284,57,227,,,,,,,,,,23,15,8,21,,,,164,157,7,42,177,93,19,74,56,3,2,3,2,1,0,0,0
"Mar 21, 2019 7:00 PM",162,41,121,,,,,,,,,,7,1,6,19,,,,71,67,4,18,90,40,5,35,32,4,1,2,2,0,0,0,0
"Mar 21, 2019 8:00 PM",95,18,77,,,,,,,,,,8,5,3,2,,,,44,42,2,12,46,16,1,15,24,2,0,0,0,0,0,0,0
"Mar 21, 2019 9:00 PM",70,12,58,,,,,,,,,,3,3,0,8,,,,21,21,0,10,24,14,3,11,14,1,1,1,1,0,0,0,0
"Mar 21, 2019 10:00 PM",43,11,32,,,,,,,,,,8,4,4,2,,,,17,16,1,5,19,6,0,6,6,1,0,0,0,0,0,0,0
"Mar 21, 2019 11:00 PM",17,2,15,,,,,,,,,,0,0,0,2,,,,11,11,0,1,10,6,3,3,3,1,2,0,0,0,0,0,0
"Mar 22, 2019 12:00 AM",10,2,8,,,,,,,,,,0,0,0,1,,,,6,6,0,4,8,1,0,1,2,1,0,1,1,0,0,0,0
"Mar 22, 2019 1:00 AM",4,0,4,,,,,,,,,,2,2,0,1,,,,3,3,0,0,2,0,0,0,1,0,0,0,0,0,0,0,0
"Mar 22, 2019 2:00 AM",6,3,3,,,,,,,,,,0,0,0,0,,,,2,2,0,0,2,0,0,0,0,0,0,0,0,0,0,0,0
"Mar 22, 2019 3:00 AM",1,1,0,,,,,,,,,,0,0,0,0,,,,0,0,0,0,0,0,0,0,0,0,0,0,0,0,0,0,0
"Mar 22, 2019 4:00 AM",2,2,0,,,,,,,,,,0,0,0,0,,,,2,2,0,0,0,0,0,0,0,0,0,0,0,0,0,0,0
"Mar 22, 2019 5:00 AM",8,6,2,,,,,,,,,,0,0,0,1,,,,2,1,1,5,0,0,0,0,8,2,0,0,0,0,0,0,0
"Mar 22, 2019 6:00 AM",51,39,12,,,,,,,,,,4,0,4,4,,,,7,5,2,29,9,6,3,3,46,0,3,1,1,0,0,0,0
"Mar 22, 2019 7:00 AM",190,156,34,,,,,,,,,,9,0,9,15,,,,26,19,7,118,31,29,18,11,130,1,5,3,2,1,2,0,2
"Mar 22, 2019 8:00 AM",289,222,67,,,,,,,,,,23,9,14,24,,,,30,18,12,191,70,79,65,14,252,5,5,15,13,2,2,1,1
"Mar 22, 2019 9:00 AM",152,130,22,,,,,,,,,,17,8,9,10,,,,16,13,3,84,30,40,27,13,88,5,3,4,1,3,1,0,1
"Mar 22, 2019 10:00 AM",56,43,13,,,,,,,,,,15,7,8,4,,,,18,9,9,29,14,13,6,7,31,0,1,1,0,1,1,0,1
"Mar 22, 2019 11:00 AM",38,27,11,,,,,,,,,,10,5,5,6,,,,10,7,3,23,14,7,2,5,21,0,0,1,1,0,1,1,0
"Mar 22, 2019 12:00 PM",52,26,26,,,,,,,,,,5,4,1,4,,,,15,13,2,17,17,5,3,2,21,0,4,1,1,0,1,0,1
"Mar 22, 2019 1:00 PM",64,19,45,,,,,,,,,,8,4,4,9,,,,28,22,6,18,20,9,0,9,25,3,1,1,1,0,0,0,0
"Mar 22, 2019 2:00 PM",60,23,37,,,,,,,,,,8,8,0,8,,,,22,19,3,13,31,11,2,9,10,2,0,5,4,1,1,1,0
"Mar 22, 2019 3:00 PM",74,24,50,,,,,,,,,,8,6,2,6,,,,32,27,5,14,30,8,1,7,17,4,1,5,2,3,1,1,0
"Mar 22, 2019 4:00 PM",107,28,79,,,,,,,,,,16,10,6,30,,,,71,69,2,20,42,23,4,19,25,5,1,3,2,1,3,1,2
"Mar 22, 2019 5:00 PM",227,40,187,,,,,,,,,,17,14,3,30,,,,114,112,2,34,137,63,9,54,55,6,0,6,5,1,0,0,0
"Mar 22, 2019 6:00 PM",204,41,163,,,,,,,,,,13,10,3,13,,,,106,105,1,24,117,80,8,72,39,4,2,4,3,1,0,0,0
"Mar 22, 2019 7:00 PM",105,25,80,,,,,,,,,,6,3,3,6,,,,58,57,1,14,64,21,6,15,19,1,2,3,0,3,2,1,1
"Mar 22, 2019 8:00 PM",67,14,53,,,,,,,,,,11,8,3,6,,,,26,25,1,9,23,4,0,4,16,2,1,2,0,2,0,0,0
"Mar 22, 2019 9:00 PM",47,10,37,,,,,,,,,,1,1,0,2,,,,28,25,3,4,18,9,4,5,13,1,1,2,1,1,1,0,1
"Mar 22, 2019 10:00 PM",25,5,20,,,,,,,,,,2,1,1,3,,,,17,17,0,2,11,2,0,2,13,0,1,0,0,0,0,0,0
"Mar 22, 2019 11:00 PM",12,3,9,,,,,,,,,,3,2,1,0,,,,7,5,2,3,10,1,0,1,6,3,0,0,0,0,0,0,0
"Mar 23, 2019 12:00 AM",7,0,7,,,,,,,,,,0,0,0,2,,,,6,5,1,3,5,4,1,3,4,0,0,0,0,0,0,0,0
"Mar 23, 2019 1:00 AM",6,2,4,,,,,,,,,,0,0,0,3,,,,4,4,0,2,5,2,1,1,2,0,1,1,1,0,0,0,0
"Mar 23, 2019 2:00 AM",4,0,4,,,,,,,,,,0,0,0,0,,,,2,2,0,1,2,0,0,0,1,0,0,0,0,0,0,0,0
"Mar 23, 2019 3:00 AM",2,1,1,,,,,,,,,,0,0,0,0,,,,1,1,0,1,4,0,0,0,0,0,2,0,0,0,0,0,0
"Mar 23, 2019 4:00 AM",6,2,4,,,,,,,,,,1,0,1,0,,,,2,2,0,0,2,1,0,1,5,0,0,0,0,0,0,0,0
"Mar 23, 2019 5:00 AM",0,0,0,,,,,,,,,,1,1,0,1,,,,2,2,0,0,3,0,0,0,1,1,0,0,0,0,0,0,0
"Mar 23, 2019 6:00 AM",6,3,3,,,,,,,,,,3,1,2,2,,,,2,2,0,7,5,4,2,2,17,0,0,0,0,0,0,0,0
"Mar 23, 2019 7:00 AM",26,12,14,,,,,,,,,,1,0,1,0,,,,5,5,0,6,13,5,3,2,15,2,0,2,1,1,1,0,1
"Mar 23, 2019 8:00 AM",45,20,25,,,,,,,,,,7,2,5,5,,,,7,5,2,23,16,6,2,4,19,0,15,0,0,0,0,0,0
"Mar 23, 2019 9:00 AM",46,35,11,,,,,,,,,,14,8,6,9,,,,12,9,3,23,24,17,9,8,20,2,7,1,0,1,0,0,0
"Mar 23, 2019 10:00 AM",51,35,16,,,,,,,,,,16,5,11,7,,,,20,15,5,16,21,23,6,17,26,2,6,3,0,3,6,5,1
"Mar 23, 2019 11:00 AM",56,32,24,,,,,,,,,,23,13,10,12,,,,11,10,1,19,28,28,13,15,34,2,4,1,1,0,1,0,1
"Mar 23, 2019 12:00 PM",67,40,27,,,,,,,,,,29,14,15,20,,,,15,15,0,25,25,17,10,7,38,14,3,5,4,1,3,1,2
"Mar 23, 2019 1:00 PM",47,21,26,,,,,,,,,,36,23,13,14,,,,20,16,4,21,32,47,22,25,23,2,5,2,0,2,0,0,0
"Mar 23, 2019 2:00 PM",70,34,36,,,,,,,,,,27,18,9,16,,,,28,20,8,13,21,29,10,19,26,6,3,3,3,0,1,0,1
"Mar 23, 2019 3:00 PM",47,20,27,,,,,,,,,,50,29,21,25,,,,16,14,2,21,16,36,18,18,23,6,3,2,1,1,2,1,1
"Mar 23, 2019 4:00 PM",75,34,41,,,,,,,,,,22,11,11,20,,,,22,18,4,17,12,13,2,11,31,8,3,2,1,1,2,2,0
"Mar 23, 2019 5:00 PM",52,19,33,,,,,,,,,,26,16,10,33,,,,29,27,2,15,19,26,14,12,19,4,4,4,4,0,1,1,0
"Mar 23, 2019 6:00 PM",40,11,29,,,,,,,,,,17,8,9,5,,,,22,19,3,16,15,23,13,10,9,3,2,2,2,0,3,2,1
"Mar 23, 2019 7:00 PM",46,21,25,,,,,,,,,,8,3,5,5,,,,20,18,2,4,9,4,1,3,8,0,1,1,0,1,0,0,0
"Mar 23, 2019 8:00 PM",23,10,13,,,,,,,,,,6,5,1,7,,,,6,6,0,3,9,2,1,1,12,1,1,0,0,0,1,0,1
"Mar 23, 2019 9:00 PM",18,5,13,,,,,,,,,,1,0,1,3,,,,4,4,0,3,1,2,1,1,7,0,0,1,0,1,0,0,0
"Mar 23, 2019 10:00 PM",10,5,5,,,,,,,,,,0,0,0,4,,,,5,5,0,2,7,3,0,3,6,0,0,0,0,0,0,0,0
"Mar 23, 2019 11:00 PM",16,5,11,,,,,,,,,,1,0,1,2,,,,3,3,0,4,3,0,0,0,7,0,0,0,0,0,0,0,0
"Mar 24, 2019 12:00 AM",10,7,3,,,,,,,,,,3,3,0,4,,,,6,6,0,2,3,2,1,1,2,0,1,0,0,0,0,0,0
"Mar 24, 2019 1:00 AM",7,1,6,,,,,,,,,,2,2,0,1,,,,3,3,0,4,3,0,0,0,1,0,1,0,0,0,0,0,0
"Mar 24, 2019 2:00 AM",2,0,2,,,,,,,,,,0,0,0,0,,,,1,1,0,4,2,2,0,2,4,0,1,1,0,1,0,0,0
"Mar 24, 2019 3:00 AM",4,0,4,,,,,,,,,,0,0,0,0,,,,0,0,0,1,2,0,0,0,0,0,1,0,0,0,0,0,0
"Mar 24, 2019 4:00 AM",6,0,6,,,,,,,,,,0,0,0,0,,,,2,2,0,1,0,0,0,0,2,0,0,0,0,0,0,0,0
"Mar 24, 2019 5:00 AM",3,1,2,,,,,,,,,,0,0,0,1,,,,0,0,0,0,2,2,0,2,1,0,0,0,0,0,0,0,0
"Mar 24, 2019 6:00 AM",12,8,4,,,,,,,,,,1,1,0,1,,,,4,4,0,3,7,2,2,0,12,0,0,0,0,0,0,0,0
"Mar 24, 2019 7:00 AM",25,13,12,,,,,,,,,,0,0,0,1,,,,9,7,2,10,13,6,1,5,14,2,3,1,1,0,1,0,1
"Mar 24, 2019 8:00 AM",36,21,15,,,,,,,,,,6,3,3,5,,,,8,5,3,18,15,17,3,14,30,2,5,0,0,0,1,1,0
"Mar 24, 2019 9:00 AM",50,35,15,,,,,,,,,,9,3,6,12,,,,8,4,4,33,34,33,13,20,40,3,12,0,0,0,0,0,0
"Mar 24, 2019 10:00 AM",55,34,21,,,,,,,,,,26,11,15,14,,,,26,22,4,19,37,50,14,36,88,6,19,6,1,5,0,0,0
"Mar 24, 2019 11:00 AM",49,28,21,,,,,,,,,,40,26,14,17,,,,18,12,6,18,30,46,18,28,81,7,4,5,2,3,0,0,0
"Mar 24, 2019 12:00 PM",84,25,59,,,,,,,,,,76,37,39,8,,,,9,9,0,18,47,50,24,26,24,9,3,3,2,1,3,1,2
"Mar 24, 2019 1:00 PM",53,29,24,,,,,,,,,,43,21,22,13,,,,13,9,4,18,54,41,24,17,39,15,5,6,6,0,0,0,0
"Mar 24, 2019 2:00 PM",48,27,21,,,,,,,,,,31,26,5,10,,,,20,18,2,23,39,22,6,16,38,6,3,2,1,1,0,0,0
"Mar 24, 2019 3:00 PM",50,30,20,,,,,,,,,,44,31,13,7,,,,17,14,3,8,14,24,15,9,28,3,3,10,7,3,1,0,1
"Mar 24, 2019 4:00 PM",50,30,20,,,,,,,,,,32,21,11,21,,,,15,10,5,13,14,20,7,13,23,4,5,4,2,2,1,1,0
"Mar 24, 2019 5:00 PM",44,22,22,,,,,,,,,,10,8,2,7,,,,17,15,2,15,21,5,1,4,15,0,2,4,0,4,2,2,0
"Mar 24, 2019 6:00 PM",36,12,24,,,,,,,,,,7,4,3,20,,,,21,20,1,7,12,12,9,3,12,0,1,1,0,1,1,1,0
"Mar 24, 2019 7:00 PM",40,15,25,,,,,,,,,,5,5,0,6,,,,9,9,0,6,6,7,2,5,12,1,1,3,2,1,4,3,1
"Mar 24, 2019 8:00 PM",35,13,22,,,,,,,,,,1,1,0,6,,,,23,23,0,10,15,1,1,0,6,0,0,1,0,1,4,3,1
"Mar 24, 2019 9:00 PM",27,7,20,,,,,,,,,,0,0,0,3,,,,13,12,1,7,7,5,2,3,5,0,0,0,0,0,0,0,0
"Mar 24, 2019 10:00 PM",16,3,13,,,,,,,,,,0,0,0,6,,,,5,4,1,5,3,1,0,1,9,0,1,1,0,1,1,1,0
"Mar 24, 2019 11:00 PM",8,0,8,,,,,,,,,,2,1,1,0,,,,5,5,0,0,2,2,2,0,1,0,1,2,1,1,1,0,1
"Mar 25, 2019 12:00 AM",5,1,4,,,,,,,,,,0,0,0,0,,,,3,3,0,0,2,0,0,0,1,0,1,2,1,1,0,0,0
"Mar 25, 2019 1:00 AM",0,0,0,,,,,,,,,,0,0,0,0,,,,1,1,0,1,0,1,1,0,0,0,0,0,0,0,0,0,0
"Mar 25, 2019 2:00 AM",1,0,1,,,,,,,,,,1,0,1,0,,,,0,0,0,0,0,0,0,0,0,0,0,0,0,0,0,0,0
"Mar 25, 2019 3:00 AM",1,0,1,,,,,,,,,,0,0,0,0,,,,0,0,0,0,0,0,0,0,0,0,0,0,0,0,0,0,0
"Mar 25, 2019 4:00 AM",2,0,2,,,,,,,,,,0,0,0,0,,,,0,0,0,0,1,0,0,0,1,0,0,0,0,0,0,0,0
"Mar 25, 2019 5:00 AM",6,4,2,,,,,,,,,,2,0,2,1,,,,2,2,0,4,2,0,0,0,10,1,0,1,1,0,1,0,1
"Mar 25, 2019 6:00 AM",63,46,17,,,,,,,,,,4,0,4,7,,,,5,2,3,35,4,14,10,4,52,1,2,1,0,1,0,0,0
"Mar 25, 2019 7:00 AM",196,155,41,,,,,,,,,,15,1,14,13,,,,41,31,10,151,39,45,33,12,191,3,6,6,4,2,1,0,1
"Mar 25, 2019 8:00 AM",440,372,68,,,,,,,,,,34,5,29,49,,,,68,43,25,298,88,132,100,32,388,7,8,13,13,0,1,0,1
"Mar 25, 2019 9:00 AM",242,216,26,,,,,,,,,,20,10,10,14,,,,19,10,9,133,33,33,24,9,113,4,3,5,3,2,1,1,0
"Mar 25, 2019 10:00 AM",94,75,19,,,,,,,,,,2,1,1,12,,,,17,8,9,59,15,17,7,10,42,3,0,2,1,1,0,0,0
"Mar 25, 2019 11:00 AM",69,46,23,,,,,,,,,,3,0,3,8,,,,15,11,4,32,14,9,6,3,21,2,4,2,2,0,0,0,0
"Mar 25, 2019 12:00 PM",65,35,30,,,,,,,,,,6,3,3,5,,,,20,17,3,27,13,20,4,16,15,0,1,3,3,0,0,0,0
"Mar 25, 2019 1:00 PM",71,28,43,,,,,,,,,,9,6,3,18,,,,28,21,7,27,24,22,10,12,35,0,2,4,1,3,0,0,0
"Mar 25, 2019 2:00 PM",65,39,26,,,,,,,,,,27,15,12,21,,,,47,45,2,25,30,19,7,12,25,3,2,3,2,1,0,0,0
"Mar 25, 2019 3:00 PM",108,32,76,,,,,,,,,,13,9,4,12,,,,50,47,3,22,29,22,5,17,22,4,0,4,2,2,1,1,0
"Mar 25, 2019 4:00 PM",173,43,130,,,,,,,,,,9,8,1,18,,,,86,82,4,32,65,39,7,32,39,2,0,5,3,2,1,1,0
"Mar 25, 2019 5:00 PM",362,59,303,,,,,,,,,,24,18,6,27,,,,179,175,4,46,181,115,21,94,90,3,4,2,2,0,0,0,0
"Mar 25, 2019 6:00 PM",327,58,269,,,,,,,,,,32,20,12,22,,,,204,194,10,46,173,112,13,99,39,5,2,4,3,1,0,0,0
"Mar 25, 2019 7:00 PM",163,29,134,,,,,,,,,,15,9,6,9,,,,92,89,3,30,76,34,4,30,26,1,1,5,4,1,0,0,0
"Mar 25, 2019 8:00 PM",97,19,78,,,,,,,,,,2,2,0,4,,,,46,44,2,9,39,7,0,7,21,1,2,2,2,0,0,0,0
"Mar 25, 2019 9:00 PM",87,11,76,,,,,,,,,,6,4,2,12,,,,31,31,0,6,23,4,1,3,18,2,0,1,1,0,1,0,1
"Mar 25, 2019 10:00 PM",45,5,40,,,,,,,,,,3,3,0,2,,,,26,26,0,7,17,8,1,7,8,0,1,0,0,0,0,0,0
"Mar 25, 2019 11:00 PM",32,5,27,,,,,,,,,,0,0,0,3,,,,8,8,0,3,7,2,1,1,4,0,0,0,0,0,0,0,0
"Mar 26, 2019 12:00 AM",6,1,5,,,,,,,,,,0,0,0,1,,,,6,5,1,0,2,0,0,0,2,0,1,0,0,0,0,0,0
"Mar 26, 2019 1:00 AM",0,0,0,,,,,,,,,,0,0,0,0,,,,3,3,0,0,1,0,0,0,1,0,0,0,0,0,0,0,0
"Mar 26, 2019 2:00 AM",0,0,0,,,,,,,,,,0,0,0,0,,,,0,0,0,0,2,0,0,0,0,0,0,0,0,0,0,0,0
"Mar 26, 2019 3:00 AM",2,2,0,,,,,,,,,,0,0,0,0,,,,1,0,1,0,0,0,0,0,2,0,0,0,0,0,0,0,0
"Mar 26, 2019 4:00 AM",3,1,2,,,,,,,,,,0,0,0,0,,,,1,1,0,1,0,0,0,0,1,0,0,0,0,0,0,0,0
"Mar 26, 2019 5:00 AM",10,8,2,,,,,,,,,,1,0,1,1,,,,3,1,2,3,2,0,0,0,10,2,0,0,0,0,0,0,0
"Mar 26, 2019 6:00 AM",62,51,11,,,,,,,,,,5,0,5,7,,,,8,6,2,47,11,13,10,3,51,3,1,2,1,1,0,0,0
"Mar 26, 2019 7:00 AM",259,196,63,,,,,,,,,,13,2,11,18,,,,48,38,10,170,46,53,42,11,226,2,3,2,2,0,5,0,5
"Mar 26, 2019 8:00 AM",452,370,82,,,,,,,,,,32,5,27,42,,,,67,39,28,317,65,133,99,34,364,8,13,11,9,2,3,2,1
"Mar 26, 2019 9:00 AM",255,220,35,,,,,,,,,,21,4,17,16,,,,29,20,9,126,45,49,36,13,130,3,6,4,1,3,1,0,1
"Mar 26, 2019 10:00 AM",124,91,33,,,,,,,,,,11,4,7,13,,,,18,7,11,64,17,23,13,10,37,4,3,3,2,1,1,1,0
"Mar 26, 2019 11:00 AM",60,40,20,,,,,,,,,,17,10,7,4,,,,18,18,0,40,10,13,6,7,36,3,1,2,2,0,2,1,1
"Mar 26, 2019 12:00 PM",69,35,34,,,,,,,,,,15,7,8,5,,,,20,16,4,29,14,18,6,12,23,5,3,1,1,0,1,0,1
"Mar 26, 2019 1:00 PM",79,38,41,,,,,,,,,,16,10,6,14,,,,21,17,4,40,29,33,13,20,49,2,2,1,1,0,1,0,1
"Mar 26, 2019 2:00 PM",79,36,43,,,,,,,,,,13,9,4,9,,,,29,26,3,33,26,24,7,17,26,5,3,3,1,2,2,1,1
"Mar 26, 2019 3:00 PM",106,33,73,,,,,,,,,,18,12,6,11,,,,62,61,1,29,30,24,5,19,25,7,3,7,5,2,1,1,0
"Mar 26, 2019 4:00 PM",179,37,142,,,,,,,,,,23,17,6,28,,,,104,99,5,34,60,48,8,40,48,7,3,9,4,5,4,3,1
"Mar 26, 2019 5:00 PM",357,78,279,,,,,,,,,,15,15,0,20,,,,178,174,4,52,159,114,22,92,74,8,2,3,2,1,2,1,1
"Mar 26, 2019 6:00 PM",364,74,290,,,,,,,,,,34,23,11,32,,,,194,189,5,49,211,101,21,80,63,4,3,6,2,4,1,1,0
"Mar 26, 2019 7:00 PM",196,42,154,,,,,,,,,,10,8,2,16,,,,104,102,2,26,87,37,6,31,25,3,2,4,3,1,2,1,1
"Mar 26, 2019 8:00 PM",122,24,98,,,,,,,,,,10,8,2,12,,,,72,71,1,14,48,16,1,15,28,4,1,3,2,1,1,0,1
"Mar 26, 2019 9:00 PM",76,13,63,,,,,,,,,,2,1,1,4,,,,36,36,0,7,25,16,3,13,16,2,1,0,0,0,0,0,0
"Mar 26, 2019 10:00 PM",54,9,45,,,,,,,,,,7,5,2,1,,,,33,32,1,12,22,7,5,2,8,0,0,0,0,0,0,0,0
"Mar 26, 2019 11:00 PM",30,3,27,,,,,,,,,,3,2,1,0,,,,14,12,2,2,8,1,1,0,4,0,2,0,0,0,0,0,0
"Mar 27, 2019 12:00 AM",8,2,6,,,,,,,,,,0,0,0,0,,,,7,6,1,0,7,1,0,1,1,1,0,0,0,0,0,0,0
"Mar 27, 2019 1:00 AM",8,1,7,,,,,,,,,,0,0,0,0,,,,5,5,0,1,0,0,0,0,2,0,0,0,0,0,0,0,0
"Mar 27, 2019 2:00 AM",3,0,3,,,,,,,,,,0,0,0,0,,,,0,0,0,0,2,0,0,0,1,0,0,0,0,0,0,0,0
"Mar 27, 2019 3:00 AM",1,1,0,,,,,,,,,,0,0,0,0,,,,0,0,0,0,0,0,0,0,1,0,0,0,0,0,0,0,0
"Mar 27, 2019 4:00 AM",2,1,1,,,,,,,,,,0,0,0,0,,,,3,3,0,0,0,0,0,0,0,0,0,0,0,0,0,0,0
"Mar 27, 2019 5:00 AM",8,8,0,,,,,,,,,,0,0,0,1,,,,2,1,1,10,4,0,0,0,13,2,0,0,0,0,0,0,0
"Mar 27, 2019 6:00 AM",67,51,16,,,,,,,,,,3,2,1,7,,,,7,6,1,37,13,13,10,3,59,1,1,3,2,1,0,0,0
"Mar 27, 2019 7:00 AM",233,176,57,,,,,,,,,,11,2,9,16,,,,37,27,10,169,32,50,40,10,186,1,7,5,4,1,3,0,3
"Mar 27, 2019 8:00 AM",480,396,84,,,,,,,,,,27,4,23,47,,,,57,33,24,318,84,113,83,30,393,9,10,21,18,3,3,2,1
"Mar 27, 2019 9:00 AM",240,218,22,,,,,,,,,,18,8,10,11,,,,34,24,10,138,34,40,25,15,116,5,4,5,2,3,0,0,0
"Mar 27, 2019 10:00 AM",101,83,18,,,,,,,,,,11,7,4,7,,,,19,8,11,61,24,14,7,7,43,7,4,4,3,1,0,0,0
"Mar 27, 2019 11:00 AM",69,43,26,,,,,,,,,,7,5,2,4,,,,21,13,8,40,18,20,6,14,34,1,1,3,1,2,2,2,0
"Mar 27, 2019 12:00 PM",92,59,33,,,,,,,,,,14,8,6,9,,,,35,29,6,29,20,21,7,14,46,2,3,6,5,1,1,1,0
"Mar 27, 2019 1:00 PM",99,40,59,,,,,,,,,,8,4,4,12,,,,50,43,7,36,33,35,7,28,34,7,2,3,1,2,0,0,0
"Mar 27, 2019 2:00 PM",67,26,41,,,,,,,,,,18,9,9,19,,,,38,33,5,23,30,21,5,16,27,8,3,13,8,5,1,1,0
"Mar 27, 2019 3:00 PM",103,32,71,,,,,,,,,,22,14,8,17,,,,35,30,5,17,30,33,7,26,31,5,3,3,2,1,0,0,0
"Mar 27, 2019 4:00 PM",162,42,120,,,,,,,,,,21,14,7,25,,,,95,90,5,36,69,48,12,36,46,8,1,5,1,4,3,2,1
"Mar 27, 2019 5:00 PM",378,74,304,,,,,,,,,,30,21,9,23,,,,177,173,4,39,148,115,19,96,87,5,3,7,6,1,3,3,0
"Mar 27, 2019 6:00 PM",330,55,275,,,,,,,,,,21,17,4,32,,,,225,220,5,49,210,87,13,74,54,5,1,4,0,4,3,3,0
"Mar 27, 2019 7:00 PM",198,48,150,,,,,,,,,,14,9,5,11,,,,89,87,2,23,90,48,1,47,31,2,1,3,1,2,1,0,1
"Mar 27, 2019 8:00 PM",130,24,106,,,,,,,,,,8,5,3,16,,,,75,70,5,15,38,8,0,8,18,2,0,2,0,2,1,1,0
"Mar 27, 2019 9:00 PM",97,17,80,,,,,,,,,,5,5,0,6,,,,37,37,0,13,22,9,1,8,19,0,0,1,1,0,0,0,0
"Mar 27, 2019 10:00 PM",48,8,40,,,,,,,,,,4,1,3,2,,,,19,18,1,10,19,0,0,0,9,1,0,1,0,1,1,1,0
"Mar 27, 2019 11:00 PM",37,7,30,,,,,,,,,,1,1,0,6,,,,16,16,0,4,14,4,3,1,10,0,2,0,0,0,0,0,0
"Mar 28, 2019 12:00 AM",13,2,11,,,,,,,,,,3,3,0,2,,,,6,6,0,0,2,1,0,1,5,0,1,1,1,0,0,0,0
"Mar 28, 2019 1:00 AM",11,1,10,,,,,,,,,,0,0,0,0,,,,3,3,0,1,3,1,0,1,0,0,0,0,0,0,0,0,0
"Mar 28, 2019 2:00 AM",9,0,9,,,,,,,,,,0,0,0,0,,,,2,2,0,0,4,0,0,0,0,1,0,0,0,0,0,0,0
"Mar 28, 2019 3:00 AM",3,1,2,,,,,,,,,,0,0,0,0,,,,5,5,0,0,0,0,0,0,0,0,0,0,0,0,0,0,0
"Mar 28, 2019 4:00 AM",3,1,2,,,,,,,,,,0,0,0,0,,,,0,0,0,1,0,0,0,0,0,0,0,0,0,0,0,0,0
"Mar 28, 2019 5:00 AM",7,5,2,,,,,,,,,,0,0,0,2,,,,2,1,1,6,3,0,0,0,11,2,0,0,0,0,0,0,0
"Mar 28, 2019 6:00 AM",62,36,26,,,,,,,,,,4,2,2,8,,,,5,3,2,27,17,11,6,5,55,3,2,4,3,1,0,0,0
"Mar 28, 2019 7:00 AM",222,171,51,,,,,,,,,,11,1,10,17,,,,39,30,9,153,38,59,45,14,180,2,7,4,3,1,3,0,3
"Mar 28, 2019 8:00 AM",440,372,68,,,,,,,,,,44,10,34,46,,,,60,36,24,280,70,113,93,20,354,12,9,16,12,4,5,3,2
"Mar 28, 2019 9:00 AM",232,204,28,,,,,,,,,,17,3,14,9,,,,40,23,17,120,23,54,35,19,113,2,6,4,2,2,2,1,1
"Mar 28, 2019 10:00 AM",111,88,23,,,,,,,,,,13,2,11,9,,,,22,13,9,71,24,18,10,8,37,2,3,2,2,0,1,0,1
"Mar 28, 2019 11:00 AM",76,51,25,,,,,,,,,,12,5,7,6,,,,19,15,4,44,22,27,14,13,23,7,0,1,1,0,1,0,1
"Mar 28, 2019 12:00 PM",84,42,42,,,,,,,,,,13,6,7,7,,,,34,30,4,36,25,30,7,23,32,2,1,4,2,2,0,0,0
"Mar 28, 2019 1:00 PM",86,39,47,,,,,,,,,,15,7,8,11,,,,24,24,0,22,36,38,10,28,27,6,5,5,2,3,0,0,0
"Mar 28, 2019 2:00 PM",100,45,55,,,,,,,,,,23,14,9,12,,,,43,42,1,19,32,35,9,26,29,0,7,2,2,0,0,0,0
"Mar 28, 2019 3:00 PM",113,34,79,,,,,,,,,,28,11,17,13,,,,41,38,3,17,54,39,11,28,32,2,2,12,8,4,2,2,0
"Mar 28, 2019 4:00 PM",206,54,152,,,,,,,,,,25,20,5,53,,,,120,116,4,33,91,49,15,34,54,9,2,8,3,5,2,2,0
"Mar 28, 2019 5:00 PM",326,79,247,,,,,,,,,,17,11,6,39,,,,172,170,2,53,191,95,13,82,97,10,8,2,1,1,1,0,1
"Mar 28, 2019 6:00 PM",341,68,273,,,,,,,,,,21,17,4,25,,,,183,182,1,43,152,108,20,88,67,9,8,4,2,2,0,0,0
"Mar 28, 2019 7:00 PM",166,35,131,,,,,,,,,,19,7,12,16,,,,92,90,2,32,63,38,13,25,46,2,2,1,1,0,4,2,2
"Mar 28, 2019 8:00 PM",109,23,86,,,,,,,,,,8,3,5,5,,,,57,54,3,23,48,14,3,11,14,2,2,6,4,2,2,2,0
"Mar 28, 2019 9:00 PM",86,15,71,,,,,,,,,,7,5,2,6,,,,42,41,1,9,20,16,5,11,14,1,1,6,2,4,2,1,1
"Mar 28, 2019 10:00 PM",56,10,46,,,,,,,,,,8,7,1,7,,,,25,24,1,7,17,11,0,11,11,1,0,1,1,0,0,0,0
"Mar 28, 2019 11:00 PM",21,3,18,,,,,,,,,,1,0,1,3,,,,17,17,0,4,8,5,2,3,7,0,0,0,0,0,0,0,0
"Mar 29, 2019 12:00 AM",11,3,8,,,,,,,,,,0,0,0,1,,,,12,11,1,4,6,0,0,0,4,0,1,1,0,1,0,0,0
"Mar 29, 2019 1:00 AM",6,1,5,,,,,,,,,,1,0,1,1,,,,6,6,0,2,4,1,0,1,2,0,0,2,1,1,0,0,0
"Mar 29, 2019 2:00 AM",4,2,2,,,,,,,,,,0,0,0,0,,,,3,3,0,0,5,0,0,0,0,0,0,0,0,0,0,0,0
"Mar 29, 2019 3:00 AM",4,3,1,,,,,,,,,,0,0,0,0,,,,1,1,0,0,1,0,0,0,1,0,0,0,0,0,0,0,0
"Mar 29, 2019 4:00 AM",1,1,0,,,,,,,,,,0,0,0,0,,,,1,1,0,2,1,1,0,1,0,0,0,0,0,0,0,0,0
"Mar 29, 2019 5:00 AM",9,7,2,,,,,,,,,,0,0,0,1,,,,1,0,1,10,6,0,0,0,8,2,0,0,0,0,0,0,0
"Mar 29, 2019 6:00 AM",57,41,16,,,,,,,,,,3,1,2,6,,,,6,6,0,27,13,12,7,5,43,4,3,2,1,1,0,0,0
"Mar 29, 2019 7:00 AM",177,140,37,,,,,,,,,,11,2,9,15,,,,24,17,7,115,40,42,31,11,140,6,1,4,3,1,5,0,5
"Mar 29, 2019 8:00 AM",349,289,60,,,,,,,,,,18,4,14,32,,,,48,31,17,215,58,102,82,20,251,9,9,19,16,3,5,3,2
"Mar 29, 2019 9:00 AM",196,173,23,,,,,,,,,,16,7,9,8,,,,25,15,10,109,25,41,28,13,96,4,3,2,1,1,1,0,1
"Mar 29, 2019 10:00 AM",91,68,23,,,,,,,,,,10,7,3,3,,,,21,12,9,48,13,13,7,6,31,5,4,3,1,2,0,0,0
"Mar 29, 2019 11:00 AM",74,42,32,,,,,,,,,,13,4,9,11,,,,26,20,6,42,13,13,5,8,19,3,1,3,2,1,0,0,0
"Mar 29, 2019 12:00 PM",89,45,44,,,,,,,,,,10,8,2,8,,,,34,32,2,34,16,12,3,9,26,6,1,6,2,4,2,2,0
"Mar 29, 2019 1:00 PM",96,37,59,,,,,,,,,,13,5,8,3,,,,42,37,5,32,28,27,10,17,25,2,2,3,2,1,2,1,1
"Mar 29, 2019 2:00 PM",100,32,68,,,,,,,,,,12,10,2,15,,,,27,24,3,20,26,28,9,19,22,3,4,2,1,1,1,1,0
"Mar 29, 2019 3:00 PM",128,43,85,,,,,,,,,,10,6,4,13,,,,48,43,5,20,39,43,15,28,25,4,3,7,0,7,2,1,1
"Mar 29, 2019 4:00 PM",177,50,127,,,,,,,,,,25,19,6,56,,,,85,83,2,22,86,39,5,34,47,4,4,7,4,3,3,2,1
"Mar 29, 2019 5:00 PM",282,58,224,,,,,,,,,,31,19,12,26,,,,144,142,2,34,187,86,20,66,55,5,1,3,1,2,1,1,0
"Mar 29, 2019 6:00 PM",219,53,166,,,,,,,,,,20,14,6,23,,,,119,115,4,26,106,56,10,46,45,2,2,5,3,2,4,3,1
"Mar 29, 2019 7:00 PM",112,27,85,,,,,,,,,,13,12,1,5,,,,57,56,1,17,43,32,6,26,26,0,2,2,0,2,0,0,0
"Mar 29, 2019 8:00 PM",65,24,41,,,,,,,,,,2,2,0,2,,,,34,33,1,13,20,17,3,14,13,2,1,0,0,0,1,1,0
"Mar 29, 2019 9:00 PM",47,9,38,,,,,,,,,,2,2,0,13,,,,19,19,0,7,14,1,1,0,16,0,1,2,1,1,1,1,0
"Mar 29, 2019 10:00 PM",36,7,29,,,,,,,,,,2,2,0,1,,,,18,17,1,5,11,4,1,3,11,0,0,0,0,0,0,0,0
"Mar 29, 2019 11:00 PM",28,5,23,,,,,,,,,,2,2,0,2,,,,11,9,2,2,11,2,1,1,4,0,1,0,0,0,0,0,0
"Mar 30, 2019 12:00 AM",12,5,7,,,,,,,,,,0,0,0,2,,,,7,7,0,2,6,1,0,1,6,1,0,0,0,0,0,0,0
"Mar 30, 2019 1:00 AM",4,0,4,,,,,,,,,,1,1,0,3,,,,1,1,0,1,1,0,0,0,1,0,1,0,0,0,0,0,0
"Mar 30, 2019 2:00 AM",5,2,3,,,,,,,,,,1,1,0,0,,,,3,2,1,0,4,1,0,1,0,0,1,0,0,0,0,0,0
"Mar 30, 2019 3:00 AM",3,1,2,,,,,,,,,,0,0,0,2,,,,2,2,0,0,0,0,0,0,3,1,1,0,0,0,0,0,0
"Mar 30, 2019 4:00 AM",2,1,1,,,,,,,,,,1,1,0,0,,,,2,2,0,1,1,1,0,1,2,0,0,0,0,0,0,0,0
"Mar 30, 2019 5:00 AM",4,2,2,,,,,,,,,,1,1,0,0,,,,2,2,0,1,4,0,0,0,3,0,0,0,0,0,0,0,0
"Mar 30, 2019 6:00 AM",7,4,3,,,,,,,,,,2,1,1,2,,,,4,4,0,8,3,2,0,2,10,0,0,1,1,0,0,0,0
"Mar 30, 2019 7:00 AM",29,7,22,,,,,,,,,,3,0,3,0,,,,9,5,4,7,10,6,1,5,23,1,2,0,0,0,0,0,0
"Mar 30, 2019 8:00 AM",36,23,13,,,,,,,,,,10,2,8,4,,,,10,9,1,20,17,11,5,6,16,2,11,0,0,0,0,0,0
"Mar 30, 2019 9:00 AM",72,48,24,,,,,,,,,,11,8,3,14,,,,16,13,3,14,28,25,15,10,37,1,6,5,3,2,1,0,1
"Mar 30, 2019 10:00 AM",55,40,15,,,,,,,,,,25,12,13,6,,,,18,13,5,36,18,33,18,15,28,6,5,5,2,3,0,0,0
"Mar 30, 2019 11:00 AM",72,38,34,,,,,,,,,,32,14,18,21,,,,14,12,2,21,28,29,10,19,29,4,6,2,2,0,0,0,0
"Mar 30, 2019 12:00 PM",65,37,28,,,,,,,,,,24,7,17,18,,,,17,17,0,16,26,18,3,15,39,7,5,2,2,0,3,1,2
"Mar 30, 2019 1:00 PM",64,38,26,,,,,,,,,,11,6,5,11,,,,28,22,6,28,24,26,11,15,23,5,10,3,2,1,2,0,2
"Mar 30, 2019 2:00 PM",61,34,27,,,,,,,,,,10,8,2,34,,,,16,14,2,15,21,16,7,9,28,5,1,1,0,1,2,2,0
"Mar 30, 2019 3:00 PM",57,26,31,,,,,,,,,,15,10,5,11,,,,22,21,1,21,9,13,6,7,21,5,1,6,5,1,0,0,0
"Mar 30, 2019 4:00 PM",49,19,30,,,,,,,,,,17,12,5,18,,,,25,18,7,21,12,19,10,9,22,2,1,5,2,3,0,0,0
"Mar 30, 2019 5:00 PM",50,19,31,,,,,,,,,,16,8,8,6,,,,15,14,1,14,20,17,9,8,15,2,0,4,3,1,0,0,0
"Mar 30, 2019 6:00 PM",46,15,31,,,,,,,,,,8,3,5,9,,,,14,14,0,12,17,8,3,5,9,1,0,3,1,2,1,1,0
"Mar 30, 2019 7:00 PM",31,11,20,,,,,,,,,,5,3,2,10,,,,9,8,1,10,11,6,3,3,10,1,0,1,1,0,1,0,1
"Mar 30, 2019 8:00 PM",37,11,26,,,,,,,,,,2,1,1,5,,,,16,15,1,3,8,1,1,0,8,1,0,0,0,0,1,0,1
"Mar 30, 2019 9:00 PM",22,8,14,,,,,,,,,,0,0,0,2,,,,6,4,2,4,5,4,2,2,10,2,0,1,0,1,0,0,0
"Mar 30, 2019 10:00 PM",17,0,17,,,,,,,,,,2,1,1,1,,,,5,5,0,6,5,7,2,5,4,0,0,0,0,0,0,0,0
"Mar 30, 2019 11:00 PM",7,4,3,,,,,,,,,,0,0,0,1,,,,11,11,0,1,2,1,1,0,8,0,0,1,1,0,0,0,0
"Mar 31, 2019 12:00 AM",7,3,4,,,,,,,,,,0,0,0,1,,,,1,1,0,3,6,0,0,0,1,1,0,0,0,0,0,0,0
"Mar 31, 2019 2:00 AM",,,,,,,,,,,,,,,,,,,,,,,,,,,,,,,,,,,,
"Mar 31, 2019 2:00 AM",6,1,5,,,,,,,,,,1,0,1,0,,,,2,2,0,2,1,2,1,1,1,0,1,0,0,0,0,0,0
"Mar 31, 2019 3:00 AM",7,0,7,,,,,,,,,,0,0,0,3,,,,2,2,0,2,0,1,0,1,2,0,3,0,0,0,0,0,0
"Mar 31, 2019 4:00 AM",2,0,2,,,,,,,,,,0,0,0,0,,,,2,2,0,1,4,2,0,2,3,0,0,0,0,0,0,0,0
"Mar 31, 2019 5:00 AM",6,1,5,,,,,,,,,,0,0,0,0,,,,1,1,0,0,3,0,0,0,3,0,0,0,0,0,0,0,0
"Mar 31, 2019 6:00 AM",9,8,1,,,,,,,,,,2,1,1,1,,,,3,3,0,2,3,0,0,0,8,0,0,0,0,0,0,0,0
"Mar 31, 2019 7:00 AM",14,10,4,,,,,,,,,,1,1,0,0,,,,3,2,1,7,9,2,1,1,15,0,1,0,0,0,0,0,0
"Mar 31, 2019 8:00 AM",20,5,15,,,,,,,,,,6,2,4,3,,,,7,6,1,5,15,5,2,3,15,0,6,0,0,0,0,0,0
"Mar 31, 2019 9:00 AM",42,35,7,,,,,,,,,,6,5,1,7,,,,9,7,2,9,22,17,13,4,44,4,15,0,0,0,0,0,0
"Mar 31, 2019 10:00 AM",39,27,12,,,,,,,,,,19,5,14,15,,,,11,8,3,19,18,23,9,14,46,10,6,1,1,0,0,0,0
"Mar 31, 2019 11:00 AM",37,18,19,,,,,,,,,,20,5,15,12,,,,14,14,0,16,15,36,11,25,23,5,1,4,4,0,2,1,1
"Mar 31, 2019 12:00 PM",50,26,24,,,,,,,,,,24,10,14,12,,,,8,8,0,14,37,28,7,21,16,15,5,11,6,5,6,2,4
"Mar 31, 2019 1:00 PM",51,29,22,,,,,,,,,,28,18,10,20,,,,17,16,1,22,19,24,2,22,27,8,5,1,0,1,3,3,0
"Mar 31, 2019 2:00 PM",44,24,20,,,,,,,,,,38,25,13,9,,,,16,11,5,13,31,19,7,12,25,3,2,2,1,1,0,0,0
"Mar 31, 2019 3:00 PM",49,34,15,,,,,,,,,,29,16,13,19,,,,15,13,2,12,17,31,11,20,15,3,3,0,0,0,0,0,0
"Mar 31, 2019 4:00 PM",34,9,25,,,,,,,,,,46,32,14,15,,,,22,18,4,11,10,28,20,8,20,5,2,2,2,0,0,0,0
"Mar 31, 2019 5:00 PM",44,18,26,,,,,,,,,,34,16,18,13,,,,17,15,2,7,9,22,14,8,23,3,4,8,4,4,1,1,0
"Mar 31, 2019 6:00 PM",53,20,33,,,,,,,,,,14,9,5,13,,,,17,16,1,9,14,28,13,15,12,0,6,4,3,1,0,0,0
"Mar 31, 2019 7:00 PM",29,14,15,,,,,,,,,,13,6,7,7,,,,12,12,0,11,18,11,5,6,20,1,3,2,0,2,0,0,0
"Mar 31, 2019 8:00 PM",52,19,33,,,,,,,,,,4,4,0,5,,,,19,17,2,6,9,5,3,2,14,1,2,0,0,0,1,1,0
"Mar 31, 2019 9:00 PM",17,4,13,,,,,,,,,,3,2,1,3,,,,8,7,1,3,5,2,0,2,8,0,0,2,1,1,0,0,0
"Mar 31, 2019 10:00 PM",15,5,10,,,,,,,,,,0,0,0,2,,,,6,5,1,8,5,3,0,3,11,0,0,2,2,0,2,0,2
"Mar 31, 2019 11:00 PM",15,5,10,,,,,,,,,,2,2,0,1,,,,6,6,0,4,3,1,0,1,4,0,2,0,0,0,0,0,0
"Apr 1, 2019 12:00 AM",6,1,5,,,,,,,,,,1,0,1,0,,,,2,2,0,0,2,0,0,0,0,0,1,0,0,0,0,0,0
"Apr 1, 2019 1:00 AM",1,0,1,,,,,,,,,,0,0,0,0,,,,1,1,0,2,1,0,0,0,1,0,1,0,0,0,0,0,0
"Apr 1, 2019 2:00 AM",1,0,1,,,,,,,,,,0,0,0,0,,,,2,2,0,0,1,0,0,0,0,0,0,0,0,0,0,0,0
"Apr 1, 2019 3:00 AM",1,1,0,,,,,,,,,,0,0,0,0,,,,0,0,0,0,0,0,0,0,1,0,0,0,0,0,0,0,0
"Apr 1, 2019 4:00 AM",1,0,1,,,,,,,,,,0,0,0,0,,,,0,0,0,0,1,1,1,0,2,0,0,0,0,0,0,0,0
"Apr 1, 2019 5:00 AM",6,5,1,,,,,,,,,,1,0,1,2,,,,1,1,0,6,3,0,0,0,9,1,0,0,0,0,0,0,0
"Apr 1, 2019 6:00 AM",45,34,11,,,,,,,,,,3,0,3,4,,,,5,1,4,33,11,10,5,5,45,1,1,1,0,1,0,0,0
"Apr 1, 2019 7:00 AM",191,151,40,,,,,,,,,,8,4,4,14,,,,39,26,13,119,37,50,40,10,141,3,4,3,3,0,2,0,2
"Apr 1, 2019 8:00 AM",420,354,66,,,,,,,,,,29,5,24,38,,,,61,35,26,301,66,107,80,27,345,4,6,8,8,0,3,1,2
"Apr 1, 2019 9:00 AM",236,211,25,,,,,,,,,,20,8,12,12,,,,30,17,13,122,27,39,28,11,129,2,5,1,1,0,3,0,3
"Apr 1, 2019 10:00 AM",88,66,22,,,,,,,,,,8,2,6,11,,,,22,11,11,58,13,12,6,6,38,1,1,3,2,1,1,1,0
"Apr 1, 2019 11:00 AM",80,61,19,,,,,,,,,,12,7,5,7,,,,12,8,4,43,13,8,4,4,33,1,1,0,0,0,0,0,0
"Apr 1, 2019 12:00 PM",77,47,30,,,,,,,,,,20,11,9,4,,,,11,8,3,27,19,4,2,2,24,1,1,1,1,0,0,0,0
"Apr 1, 2019 1:00 PM",84,34,50,,,,,,,,,,7,1,6,7,,,,24,20,4,23,22,13,6,7,23,2,3,3,1,2,2,0,2
"Apr 1, 2019 2:00 PM",83,34,49,,,,,,,,,,18,12,6,14,,,,31,28,3,13,22,22,6,16,16,2,2,3,1,2,1,1,0
"Apr 1, 2019 3:00 PM",81,31,50,,,,,,,,,,9,5,4,16,,,,57,52,5,20,30,19,6,13,21,2,0,7,2,5,0,0,0
"Apr 1, 2019 4:00 PM",151,42,109,,,,,,,,,,13,8,5,21,,,,76,72,4,37,75,46,6,40,39,3,3,3,2,1,0,0,0
"Apr 1, 2019 5:00 PM",344,56,288,,,,,,,,,,24,16,8,19,,,,181,174,7,37,187,91,12,79,81,6,2,2,1,1,0,0,0
"Apr 1, 2019 6:00 PM",353,65,288,,,,,,,,,,19,17,2,19,,,,210,202,8,37,151,94,7,87,57,6,4,6,3,3,0,0,0
"Apr 1, 2019 7:00 PM",185,38,147,,,,,,,,,,9,7,2,15,,,,97,96,1,23,70,41,8,33,37,2,2,7,4,3,4,0,4
"Apr 1, 2019 8:00 PM",93,16,77,,,,,,,,,,7,4,3,8,,,,60,59,1,8,34,15,5,10,15,4,3,5,2,3,3,1,2
"Apr 1, 2019 9:00 PM",75,10,65,,,,,,,,,,7,5,2,4,,,,32,30,2,5,11,6,1,5,18,2,0,2,1,1,1,1,0
"Apr 1, 2019 10:00 PM",52,4,48,,,,,,,,,,2,2,0,5,,,,20,19,1,3,13,5,2,3,7,1,1,0,0,0,0,0,0
"Apr 1, 2019 11:00 PM",17,3,14,,,,,,,,,,0,0,0,0,,,,6,6,0,2,1,2,1,1,1,0,1,0,0,0,0,0,0
"Apr 2, 2019 12:00 AM",8,3,5,,,,,,,,,,0,0,0,0,,,,5,5,0,2,5,1,0,1,0,0,0,0,0,0,0,0,0
"Apr 2, 2019 1:00 AM",2,1,1,,,,,,,,,,0,0,0,0,,,,2,2,0,0,2,0,0,0,3,0,0,0,0,0,0,0,0
"Apr 2, 2019 2:00 AM",1,0,1,,,,,,,,,,0,0,0,0,,,,0,0,0,0,1,0,0,0,0,0,0,0,0,0,0,0,0
"Apr 2, 2019 3:00 AM",2,1,1,,,,,,,,,,0,0,0,0,,,,1,1,0,0,0,1,1,0,0,0,0,0,0,0,0,0,0
"Apr 2, 2019 4:00 AM",2,1,1,,,,,,,,,,0,0,0,0,,,,1,1,0,0,0,0,0,0,0,0,0,0,0,0,0,0,0
"Apr 2, 2019 5:00 AM",8,6,2,,,,,,,,,,0,0,0,2,,,,0,0,0,5,4,1,0,1,13,2,0,0,0,0,0,0,0
"Apr 2, 2019 6:00 AM",46,36,10,,,,,,,,,,2,0,2,5,,,,8,7,1,34,17,9,4,5,51,2,2,2,1,1,2,0,2
"Apr 2, 2019 7:00 AM",213,161,52,,,,,,,,,,11,2,9,17,,,,45,33,12,139,34,41,32,9,183,1,2,3,3,0,1,0,1
"Apr 2, 2019 8:00 AM",371,296,75,,,,,,,,,,21,4,17,39,,,,55,32,23,304,65,107,82,25,383,6,7,13,9,4,2,0,2
"Apr 2, 2019 9:00 AM",229,202,27,,,,,,,,,,11,2,9,4,,,,30,14,16,153,26,37,28,9,139,4,4,4,2,2,4,1,3
"Apr 2, 2019 10:00 AM",104,82,22,,,,,,,,,,8,4,4,7,,,,11,7,4,60,23,11,7,4,23,2,1,3,1,2,0,0,0
"Apr 2, 2019 11:00 AM",53,35,18,,,,,,,,,,15,6,9,6,,,,17,11,6,31,10,9,4,5,19,2,0,3,1,2,0,0,0
"Apr 2, 2019 12:00 PM",57,35,22,,,,,,,,,,12,6,6,3,,,,21,15,6,24,8,9,3,6,19,1,1,2,2,0,0,0,0
"Apr 2, 2019 1:00 PM",63,35,28,,,,,,,,,,10,6,4,5,,,,29,21,8,31,19,12,5,7,25,1,0,2,1,1,1,0,1
"Apr 2, 2019 2:00 PM",68,30,38,,,,,,,,,,13,10,3,9,,,,20,19,1,19,24,12,3,9,22,2,3,1,1,0,2,0,2
"Apr 2, 2019 3:00 PM",80,18,62,,,,,,,,,,8,6,2,5,,,,46,42,4,15,25,12,1,11,19,3,0,6,2,4,2,2,0
"Apr 2, 2019 4:00 PM",143,32,111,,,,,,,,,,6,6,0,14,,,,86,83,3,26,77,31,5,26,28,3,2,3,0,3,3,3,0
"Apr 2, 2019 5:00 PM",344,71,273,,,,,,,,,,19,14,5,18,,,,179,174,5,40,182,67,8,59,66,6,0,5,5,0,2,1,1
"Apr 2, 2019 6:00 PM",350,60,290,,,,,,,,,,15,13,2,20,,,,196,189,7,41,162,95,7,88,54,4,3,2,1,1,2,2,0
"Apr 2, 2019 7:00 PM",186,41,145,,,,,,,,,,9,6,3,21,,,,91,89,2,23,73,41,9,32,16,4,4,1,0,1,3,3,0
"Apr 2, 2019 8:00 PM",109,23,86,,,,,,,,,,6,4,2,3,,,,62,58,4,14,42,11,2,9,18,0,3,1,0,1,0,0,0
"Apr 2, 2019 9:00 PM",91,11,80,,,,,,,,,,6,5,1,2,,,,26,25,1,3,18,10,0,10,19,1,0,1,1,0,0,0,0
"Apr 2, 2019 10:00 PM",56,11,45,,,,,,,,,,2,2,0,3,,,,29,28,1,6,14,8,4,4,9,0,1,0,0,0,0,0,0
"Apr 2, 2019 11:00 PM",22,2,20,,,,,,,,,,3,2,1,0,,,,14,13,1,2,7,1,0,1,3,0,0,0,0,0,0,0,0
"Apr 3, 2019 12:00 AM",8,2,6,,,,,,,,,,2,2,0,0,,,,4,4,0,3,4,1,0,1,1,0,1,0,0,0,0,0,0
"Apr 3, 2019 1:00 AM",3,0,3,,,,,,,,,,1,1,0,0,,,,3,3,0,1,0,1,0,1,1,0,0,0,0,0,0,0,0
"Apr 3, 2019 2:00 AM",1,0,1,,,,,,,,,,0,0,0,0,,,,2,2,0,0,1,0,0,0,1,0,0,0,0,0,0,0,0
"Apr 3, 2019 3:00 AM",1,1,0,,,,,,,,,,0,0,0,0,,,,0,0,0,0,1,0,0,0,0,0,0,0,0,0,0,0,0
"Apr 3, 2019 4:00 AM",2,1,1,,,,,,,,,,0,0,0,1,,,,1,1,0,0,0,0,0,0,1,2,0,0,0,0,0,0,0
"Apr 3, 2019 5:00 AM",4,4,0,,,,,,,,,,0,0,0,3,,,,0,0,0,6,3,0,0,0,6,2,0,0,0,0,0,0,0
"Apr 3, 2019 6:00 AM",41,30,11,,,,,,,,,,2,0,2,3,,,,3,1,2,28,12,7,7,0,36,1,0,1,1,0,1,0,1
"Apr 3, 2019 7:00 AM",167,132,35,,,,,,,,,,9,2,7,13,,,,33,26,7,120,40,25,20,5,136,0,5,2,2,0,2,0,2
"Apr 3, 2019 8:00 AM",400,344,56,,,,,,,,,,20,4,16,35,,,,53,37,16,254,68,76,61,15,324,8,7,16,12,4,4,1,3
"Apr 3, 2019 9:00 AM",230,205,25,,,,,,,,,,15,5,10,9,,,,22,11,11,146,23,26,17,9,123,2,5,5,3,2,2,0,2
"Apr 3, 2019 10:00 AM",92,79,13,,,,,,,,,,9,4,5,7,,,,25,17,8,67,17,11,6,5,20,1,5,5,1,4,0,0,0
"Apr 3, 2019 11:00 AM",68,45,23,,,,,,,,,,5,0,5,7,,,,16,12,4,26,5,10,3,7,18,0,2,4,2,2,1,0,1
"Apr 3, 2019 12:00 PM",71,43,28,,,,,,,,,,7,6,1,10,,,,17,12,5,14,18,15,6,9,30,4,1,3,1,2,0,0,0
"Apr 3, 2019 1:00 PM",79,36,43,,,,,,,,,,6,3,3,14,,,,31,26,5,27,21,14,3,11,27,4,0,5,2,3,2,2,0
"Apr 3, 2019 2:00 PM",76,28,48,,,,,,,,,,11,9,2,12,,,,28,24,4,17,22,6,3,3,12,2,3,1,0,1,2,2,0
"Apr 3, 2019 3:00 PM",80,21,59,,,,,,,,,,9,7,2,7,,,,39,38,1,16,19,13,2,11,13,1,1,1,1,0,0,0,0
"Apr 3, 2019 4:00 PM",122,31,91,,,,,,,,,,7,6,1,11,,,,75,71,4,26,59,16,5,11,29,1,0,1,0,1,2,2,0
"Apr 3, 2019 5:00 PM",263,39,224,,,,,,,,,,12,8,4,17,,,,132,129,3,19,133,47,7,40,59,2,0,1,1,0,0,0,0
"Apr 3, 2019 6:00 PM",255,36,219,,,,,,,,,,11,8,3,13,,,,151,149,2,34,136,62,1,61,37,5,1,2,1,1,1,1,0
"Apr 3, 2019 7:00 PM",147,18,129,,,,,,,,,,5,5,0,8,,,,92,89,3,17,50,28,2,26,11,3,3,2,2,0,0,0,0
"Apr 3, 2019 8:00 PM",91,9,82,,,,,,,,,,5,4,1,3,,,,43,43,0,16,22,15,3,12,9,2,1,8,3,5,1,1,0
"Apr 3, 2019 9:00 PM",56,4,52,,,,,,,,,,0,0,0,3,,,,23,23,0,4,13,4,1,3,11,0,0,2,2,0,0,0,0
"Apr 3, 2019 10:00 PM",41,4,37,,,,,,,,,,2,2,0,2,,,,20,19,1,3,11,2,1,1,9,1,0,0,0,0,0,0,0
"Apr 3, 2019 11:00 PM",20,2,18,,,,,,,,,,1,1,0,0,,,,8,8,0,0,0,0,0,0,2,0,1,2,0,2,2,2,0
"Apr 4, 2019 12:00 AM",8,1,7,,,,,,,,,,0,0,0,0,,,,2,2,0,1,0,0,0,0,2,1,0,1,1,0,0,0,0
"Apr 4, 2019 1:00 AM",1,1,0,,,,,,,,,,0,0,0,0,,,,4,4,0,0,1,0,0,0,1,0,0,0,0,0,0,0,0
"Apr 4, 2019 2:00 AM",1,0,1,,,,,,,,,,0,0,0,0,,,,1,1,0,0,1,0,0,0,0,0,0,0,0,0,0,0,0
"Apr 4, 2019 3:00 AM",3,1,2,,,,,,,,,,0,0,0,0,,,,0,0,0,0,1,0,0,0,0,0,0,0,0,0,0,0,0
"Apr 4, 2019 4:00 AM",2,1,1,,,,,,,,,,0,0,0,0,,,,0,0,0,0,1,0,0,0,0,0,0,0,0,0,0,0,0
"Apr 4, 2019 5:00 AM",9,6,3,,,,,,,,,,0,0,0,2,,,,0,0,0,6,2,1,0,1,9,3,0,0,0,0,0,0,0
"Apr 4, 2019 6:00 AM",38,28,10,,,,,,,,,,4,0,4,7,,,,6,6,0,19,9,4,3,1,38,0,1,3,2,1,1,1,0
"Apr 4, 2019 7:00 AM",164,130,34,,,,,,,,,,6,2,4,12,,,,23,15,8,101,26,28,23,5,125,2,2,2,2,0,1,0,1
"Apr 4, 2019 8:00 AM",381,310,71,,,,,,,,,,18,1,17,28,,,,39,21,18,209,45,58,52,6,259,1,6,4,4,0,2,0,2
"Apr 4, 2019 9:00 AM",188,167,21,,,,,,,,,,15,8,7,11,,,,28,18,10,116,22,20,11,9,104,2,3,8,4,4,1,1,0
"Apr 4, 2019 10:00 AM",92,81,11,,,,,,,,,,8,2,6,4,,,,17,8,9,27,8,10,8,2,20,2,0,2,2,0,0,0,0
"Apr 4, 2019 11:00 AM",67,42,25,,,,,,,,,,7,3,4,6,,,,11,7,4,17,7,8,3,5,12,4,1,1,1,0,0,0,0
"Apr 4, 2019 12:00 PM",65,28,37,,,,,,,,,,7,4,3,2,,,,15,13,2,10,14,9,3,6,28,2,0,3,2,1,0,0,0
"Apr 4, 2019 1:00 PM",83,38,45,,,,,,,,,,6,4,2,3,,,,22,21,1,14,22,12,4,8,13,2,0,0,0,0,1,1,0
"Apr 4, 2019 2:00 PM",63,29,34,,,,,,,,,,6,5,1,6,,,,21,17,4,11,26,14,4,10,11,0,1,2,1,1,0,0,0
"Apr 4, 2019 3:00 PM",68,15,53,,,,,,,,,,7,5,2,5,,,,33,32,1,13,19,14,2,12,10,2,0,1,1,0,0,0,0
"Apr 4, 2019 4:00 PM",112,25,87,,,,,,,,,,8,5,3,11,,,,52,49,3,18,54,18,4,14,21,3,0,3,2,1,0,0,0
"Apr 4, 2019 5:00 PM",252,44,208,,,,,,,,,,4,4,0,18,,,,117,113,4,16,109,47,3,44,42,2,2,1,0,1,1,1,0
"Apr 4, 2019 6:00 PM",246,37,209,,,,,,,,,,8,4,4,14,,,,136,134,2,22,113,41,3,38,33,3,0,2,1,1,0,0,0
"Apr 4, 2019 7:00 PM",145,25,120,,,,,,,,,,14,11,3,9,,,,67,66,1,12,48,27,3,24,24,0,2,1,0,1,0,0,0
"Apr 4, 2019 8:00 PM",88,13,75,,,,,,,,,,11,6,5,9,,,,47,45,2,6,22,11,2,9,7,0,0,0,0,0,0,0,0
"Apr 4, 2019 9:00 PM",61,10,51,,,,,,,,,,1,1,0,1,,,,20,19,1,4,23,4,0,4,12,1,1,0,0,0,1,1,0
"Apr 4, 2019 10:00 PM",29,5,24,,,,,,,,,,2,2,0,2,,,,9,9,0,1,7,4,1,3,7,1,2,1,1,0,1,0,1
"Apr 4, 2019 11:00 PM",19,2,17,,,,,,,,,,0,0,0,0,,,,5,4,1,2,5,1,1,0,4,0,0,0,0,0,0,0,0
"Apr 5, 2019 12:00 AM",9,2,7,,,,,,,,,,1,0,1,0,,,,10,10,0,1,3,0,0,0,2,0,0,0,0,0,0,0,0
"Apr 5, 2019 1:00 AM",0,0,0,,,,,,,,,,0,0,0,0,,,,3,3,0,1,3,1,0,1,4,0,0,0,0,0,0,0,0
"Apr 5, 2019 2:00 AM",1,1,0,,,,,,,,,,0,0,0,0,,,,2,2,0,0,2,0,0,0,0,0,0,0,0,0,0,0,0
"Apr 5, 2019 3:00 AM",1,1,0,,,,,,,,,,0,0,0,0,,,,1,1,0,0,0,0,0,0,1,0,0,0,0,0,0,0,0
"Apr 5, 2019 4:00 AM",1,1,0,,,,,,,,,,0,0,0,0,,,,0,0,0,0,0,0,0,0,0,0,0,0,0,0,0,0,0
"Apr 5, 2019 5:00 AM",8,5,3,,,,,,,,,,0,0,0,2,,,,1,1,0,6,3,0,0,0,5,3,0,1,1,0,0,0,0
"Apr 5, 2019 6:00 AM",42,29,13,,,,,,,,,,3,1,2,3,,,,4,4,0,14,16,7,5,2,34,1,0,2,1,1,0,0,0
"Apr 5, 2019 7:00 AM",137,104,33,,,,,,,,,,9,4,5,11,,,,22,14,8,82,17,13,9,4,99,2,4,3,3,0,0,0,0
"Apr 5, 2019 8:00 AM",283,236,47,,,,,,,,,,12,4,8,12,,,,32,19,13,145,33,61,51,10,194,6,3,9,7,2,0,0,0
"Apr 5, 2019 9:00 AM",141,125,16,,,,,,,,,,5,0,5,1,,,,13,8,5,75,16,19,14,5,64,3,1,3,3,0,0,0,0
"Apr 5, 2019 10:00 AM",73,54,19,,,,,,,,,,2,0,2,5,,,,11,6,5,36,8,8,4,4,19,1,1,1,1,0,0,0,0
"Apr 5, 2019 11:00 AM",47,33,14,,,,,,,,,,6,2,4,3,,,,14,8,6,17,10,6,1,5,14,4,0,2,1,1,0,0,0
"Apr 5, 2019 12:00 PM",68,43,25,,,,,,,,,,7,2,5,4,,,,16,14,2,24,8,6,2,4,15,0,0,0,0,0,0,0,0
"Apr 5, 2019 1:00 PM",80,29,51,,,,,,,,,,6,5,1,7,,,,17,15,2,18,15,12,2,10,19,0,0,0,0,0,0,0,0
"Apr 5, 2019 2:00 PM",74,29,45,,,,,,,,,,7,2,5,3,,,,23,21,2,15,18,12,1,11,14,1,1,0,0,0,0,0,0
"Apr 5, 2019 3:00 PM",79,27,52,,,,,,,,,,8,4,4,4,,,,27,25,2,11,24,16,3,13,20,0,2,9,3,6,5,5,0
"Apr 5, 2019 4:00 PM",147,30,117,,,,,,,,,,10,6,4,11,,,,57,55,2,19,60,18,5,13,28,1,1,2,2,0,1,0,1
"Apr 5, 2019 5:00 PM",198,34,164,,,,,,,,,,25,15,10,36,,,,125,122,3,24,107,57,3,54,49,8,1,3,0,3,0,0,0
"Apr 5, 2019 6:00 PM",191,34,157,,,,,,,,,,18,12,6,24,,,,98,95,3,16,86,38,7,31,25,3,5,2,1,1,4,1,3
"Apr 5, 2019 7:00 PM",108,26,82,,,,,,,,,,12,7,5,7,,,,42,41,1,11,35,16,0,16,14,2,3,2,1,1,2,2,0
"Apr 5, 2019 8:00 PM",52,12,40,,,,,,,,,,5,4,1,8,,,,23,21,2,8,14,4,1,3,16,2,1,1,1,0,0,0,0
"Apr 5, 2019 9:00 PM",41,9,32,,,,,,,,,,5,3,2,3,,,,16,16,0,8,8,2,2,0,10,1,0,1,1,0,0,0,0
"Apr 5, 2019 10:00 PM",20,1,19,,,,,,,,,,1,1,0,1,,,,14,14,0,6,3,1,0,1,7,0,0,0,0,0,0,0,0
"Apr 5, 2019 11:00 PM",20,3,17,,,,,,,,,,5,2,3,0,,,,10,9,1,1,2,1,0,1,12,0,0,0,0,0,0,0,0
"Apr 6, 2019 12:00 AM",5,1,4,,,,,,,,,,0,0,0,0,,,,4,3,1,2,4,4,2,2,3,1,1,0,0,0,0,0,0
"Apr 6, 2019 1:00 AM",4,1,3,,,,,,,,,,1,0,1,1,,,,3,3,0,1,2,1,0,1,3,0,0,0,0,0,0,0,0
"Apr 6, 2019 2:00 AM",10,0,10,,,,,,,,,,0,0,0,0,,,,2,2,0,2,2,2,1,1,1,0,1,0,0,0,0,0,0
"Apr 6, 2019 3:00 AM",1,1,0,,,,,,,,,,0,0,0,1,,,,0,0,0,1,0,0,0,0,0,0,0,0,0,0,0,0,0
"Apr 6, 2019 4:00 AM",1,0,1,,,,,,,,,,0,0,0,0,,,,0,0,0,0,2,0,0,0,2,1,0,0,0,0,0,0,0
"Apr 6, 2019 5:00 AM",6,2,4,,,,,,,,,,1,1,0,1,,,,1,1,0,1,3,1,1,0,1,0,0,0,0,0,0,0,0
"Apr 6, 2019 6:00 AM",8,4,4,,,,,,,,,,1,0,1,0,,,,6,6,0,2,7,1,0,1,7,0,0,3,1,2,0,0,0
"Apr 6, 2019 7:00 AM",20,10,10,,,,,,,,,,1,0,1,0,,,,9,5,4,8,10,5,2,3,10,0,0,0,0,0,0,0,0
"Apr 6, 2019 8:00 AM",29,16,13,,,,,,,,,,4,2,2,5,,,,9,6,3,8,16,12,6,6,17,0,2,0,0,0,0,0,0
"Apr 6, 2019 9:00 AM",61,42,19,,,,,,,,,,11,1,10,6,,,,12,9,3,19,19,9,6,3,15,1,6,2,1,1,2,0,2
"Apr 6, 2019 10:00 AM",54,45,9,,,,,,,,,,8,2,6,4,,,,9,7,2,22,18,17,5,12,19,3,5,4,1,3,6,4,2
"Apr 6, 2019 11:00 AM",42,22,20,,,,,,,,,,12,3,9,14,,,,11,9,2,13,22,20,9,11,17,6,2,0,0,0,0,0,0
"Apr 6, 2019 12:00 PM",60,35,25,,,,,,,,,,22,11,11,26,,,,23,19,4,19,18,25,7,18,36,7,5,3,2,1,0,0,0
"Apr 6, 2019 1:00 PM",62,34,28,,,,,,,,,,33,20,13,16,,,,11,9,2,26,36,17,11,6,24,8,4,4,3,1,7,0,7
"Apr 6, 2019 2:00 PM",51,28,23,,,,,,,,,,29,18,11,29,,,,19,12,7,13,22,17,4,13,33,9,5,2,2,0,1,0,1
"Apr 6, 2019 3:00 PM",51,24,27,,,,,,,,,,31,12,19,13,,,,12,12,0,16,17,48,13,35,19,3,6,6,4,2,4,0,4
"Apr 6, 2019 4:00 PM",56,24,32,,,,,,,,,,37,27,10,16,,,,22,21,1,26,30,38,25,13,25,6,5,2,2,0,3,3,0
"Apr 6, 2019 5:00 PM",60,21,39,,,,,,,,,,34,22,12,26,,,,24,22,2,8,22,18,8,10,23,3,2,1,0,1,0,0,0
"Apr 6, 2019 6:00 PM",49,17,32,,,,,,,,,,8,3,5,11,,,,19,19,0,13,13,18,5,13,29,2,1,4,1,3,1,1,0
"Apr 6, 2019 7:00 PM",67,35,32,,,,,,,,,,5,4,1,3,,,,12,10,2,11,9,22,10,12,15,1,1,5,2,3,2,1,1
"Apr 6, 2019 8:00 PM",30,6,24,,,,,,,,,,4,2,2,1,,,,11,10,1,8,7,6,6,0,14,2,0,1,0,1,0,0,0
"Apr 6, 2019 9:00 PM",21,4,17,,,,,,,,,,4,4,0,3,,,,12,11,1,7,3,7,4,3,4,1,0,0,0,0,6,6,0
"Apr 6, 2019 10:00 PM",20,5,15,,,,,,,,,,3,3,0,3,,,,7,7,0,5,7,1,0,1,8,1,0,0,0,0,0,0,0
"Apr 6, 2019 11:00 PM",15,3,12,,,,,,,,,,0,0,0,1,,,,5,5,0,4,4,1,1,0,6,0,0,0,0,0,0,0,0
"Apr 7, 2019 12:00 AM",9,3,6,,,,,,,,,,2,1,1,0,,,,7,6,1,3,3,1,1,0,4,0,0,0,0,0,0,0,0
"Apr 7, 2019 1:00 AM",12,5,7,,,,,,,,,,2,1,1,0,,,,3,3,0,1,3,2,1,1,2,0,1,0,0,0,0,0,0
"Apr 7, 2019 2:00 AM",4,2,2,,,,,,,,,,3,3,0,1,,,,1,1,0,1,1,0,0,0,2,0,2,0,0,0,0,0,0
"Apr 7, 2019 3:00 AM",2,0,2,,,,,,,,,,0,0,0,1,,,,2,2,0,2,1,0,0,0,1,0,1,0,0,0,0,0,0
"Apr 7, 2019 4:00 AM",5,2,3,,,,,,,,,,2,2,0,0,,,,1,1,0,1,2,0,0,0,4,0,0,0,0,0,0,0,0
"Apr 7, 2019 5:00 AM",3,1,2,,,,,,,,,,0,0,0,0,,,,1,1,0,0,3,1,0,1,1,0,0,0,0,0,0,0,0
"Apr 7, 2019 6:00 AM",7,6,1,,,,,,,,,,0,0,0,2,,,,5,5,0,1,7,1,1,0,9,0,1,0,0,0,0,0,0
"Apr 7, 2019 7:00 AM",17,5,12,,,,,,,,,,2,2,0,1,,,,6,3,3,1,11,5,3,2,8,0,3,0,0,0,0,0,0
"Apr 7, 2019 8:00 AM",24,9,15,,,,,,,,,,10,5,5,2,,,,9,6,3,8,20,5,3,2,20,0,11,0,0,0,0,0,0
"Apr 7, 2019 9:00 AM",50,36,14,,,,,,,,,,4,0,4,5,,,,15,14,1,16,32,25,15,10,26,3,16,3,3,0,0,0,0
"Apr 7, 2019 10:00 AM",43,29,14,,,,,,,,,,10,5,5,4,,,,17,13,4,16,40,37,11,26,93,6,8,0,0,0,0,0,0
"Apr 7, 2019 11:00 AM",47,21,26,,,,,,,,,,28,12,16,18,,,,11,9,2,30,24,68,21,47,59,9,4,5,5,0,2,0,2
"Apr 7, 2019 12:00 PM",56,38,18,,,,,,,,,,38,21,17,12,,,,19,17,2,13,38,46,17,29,46,18,3,4,4,0,1,1,0
"Apr 7, 2019 1:00 PM",48,25,23,,,,,,,,,,45,24,21,11,,,,22,20,2,29,31,39,16,23,55,6,6,6,6,0,5,0,5
"Apr 7, 2019 2:00 PM",47,25,22,,,,,,,,,,29,18,11,17,,,,18,14,4,14,34,34,15,19,38,8,0,5,3,2,3,1,2
"Apr 7, 2019 3:00 PM",45,20,25,,,,,,,,,,51,31,20,14,,,,18,16,2,17,28,39,20,19,25,3,5,3,2,1,0,0,0
"Apr 7, 2019 4:00 PM",47,22,25,,,,,,,,,,46,34,12,27,,,,13,11,2,10,11,25,13,12,30,7,4,6,5,1,2,0,2
"Apr 7, 2019 5:00 PM",48,22,26,,,,,,,,,,24,14,10,9,,,,18,17,1,7,17,29,10,19,21,6,3,5,4,1,1,1,0
"Apr 7, 2019 6:00 PM",57,25,32,,,,,,,,,,11,3,8,10,,,,14,12,2,7,17,20,8,12,21,3,0,5,4,1,0,0,0
"Apr 7, 2019 7:00 PM",39,19,20,,,,,,,,,,11,8,3,4,,,,8,8,0,9,13,14,6,8,19,1,0,0,0,0,1,1,0
"Apr 7, 2019 8:00 PM",56,16,40,,,,,,,,,,8,4,4,3,,,,11,11,0,4,8,6,4,2,17,2,1,2,1,1,1,1,0
"Apr 7, 2019 9:00 PM",29,12,17,,,,,,,,,,3,3,0,4,,,,8,6,2,7,2,0,0,0,2,1,1,0,0,0,0,0,0
"Apr 7, 2019 10:00 PM",18,7,11,,,,,,,,,,5,4,1,1,,,,4,4,0,6,0,2,1,1,9,1,0,0,0,0,0,0,0
"Apr 7, 2019 11:00 PM",9,3,6,,,,,,,,,,2,1,1,3,,,,4,3,1,0,4,0,0,0,4,0,0,0,0,0,0,0,0
"Apr 8, 2019 12:00 AM",6,1,5,,,,,,,,,,2,2,0,0,,,,2,2,0,0,2,3,1,2,3,0,1,0,0,0,0,0,0
"Apr 8, 2019 1:00 AM",2,0,2,,,,,,,,,,0,0,0,0,,,,0,0,0,0,1,0,0,0,1,0,0,0,0,0,0,0,0
"Apr 8, 2019 2:00 AM",2,1,1,,,,,,,,,,0,0,0,0,,,,1,1,0,0,0,0,0,0,0,0,0,0,0,0,1,0,1
"Apr 8, 2019 3:00 AM",2,0,2,,,,,,,,,,0,0,0,0,,,,0,0,0,0,1,0,0,0,0,0,0,0,0,0,0,0,0
"Apr 8, 2019 4:00 AM",2,0,2,,,,,,,,,,0,0,0,0,,,,2,2,0,1,0,0,0,0,1,0,0,1,1,0,0,0,0
"Apr 8, 2019 5:00 AM",9,8,1,,,,,,,,,,2,1,1,2,,,,1,1,0,4,6,0,0,0,11,3,0,0,0,0,0,0,0
"Apr 8, 2019 6:00 AM",45,30,15,,,,,,,,,,5,1,4,5,,,,2,1,1,28,20,12,8,4,40,2,0,2,1,1,0,0,0
"Apr 8, 2019 7:00 AM",215,168,47,,,,,,,,,,10,4,6,11,,,,33,24,9,143,33,37,27,10,156,8,4,5,4,1,3,0,3
"Apr 8, 2019 8:00 AM",370,317,53,,,,,,,,,,31,6,25,36,,,,69,40,29,277,77,92,75,17,332,8,3,10,8,2,0,0,0
"Apr 8, 2019 9:00 AM",216,191,25,,,,,,,,,,12,7,5,16,,,,19,9,10,98,21,29,21,8,99,2,1,7,4,3,0,0,0
"Apr 8, 2019 10:00 AM",80,64,16,,,,,,,,,,9,3,6,8,,,,20,11,9,47,12,14,11,3,28,1,0,1,1,0,0,0,0
"Apr 8, 2019 11:00 AM",59,47,12,,,,,,,,,,1,1,0,5,,,,6,4,2,34,9,5,3,2,23,0,1,1,1,0,0,0,0
"Apr 8, 2019 12:00 PM",54,31,23,,,,,,,,,,8,3,5,2,,,,12,9,3,17,10,8,3,5,13,1,1,2,2,0,0,0,0
"Apr 8, 2019 1:00 PM",35,15,20,,,,,,,,,,3,1,2,4,,,,10,8,2,15,8,6,1,5,9,0,0,2,1,1,0,0,0
"Apr 8, 2019 2:00 PM",61,27,34,,,,,,,,,,3,2,1,12,,,,22,21,1,7,11,5,1,4,14,0,0,1,1,0,0,0,0
"Apr 8, 2019 3:00 PM",74,19,55,,,,,,,,,,7,5,2,9,,,,33,32,1,26,32,11,2,9,15,3,0,7,5,2,0,0,0
"Apr 8, 2019 4:00 PM",140,28,112,,,,,,,,,,7,5,2,15,,,,63,61,2,23,77,24,5,19,31,2,3,5,5,0,0,0,0
"Apr 8, 2019 5:00 PM",308,57,251,,,,,,,,,,14,12,2,20,,,,152,143,9,33,165,75,13,62,65,4,1,2,1,1,0,0,0
"Apr 8, 2019 6:00 PM",290,42,248,,,,,,,,,,19,12,7,22,,,,198,192,6,29,160,86,4,82,44,6,2,2,1,1,0,0,0
"Apr 8, 2019 7:00 PM",164,36,128,,,,,,,,,,12,10,2,12,,,,79,76,3,14,55,26,3,23,15,1,4,1,0,1,0,0,0
"Apr 8, 2019 8:00 PM",110,16,94,,,,,,,,,,4,2,2,5,,,,45,42,3,9,32,10,1,9,17,1,1,0,0,0,0,0,0
"Apr 8, 2019 9:00 PM",80,13,67,,,,,,,,,,3,2,1,4,,,,43,41,2,9,12,6,0,6,16,4,0,0,0,0,0,0,0
"Apr 8, 2019 10:00 PM",31,3,28,,,,,,,,,,3,2,1,3,,,,19,19,0,5,15,5,0,5,9,1,0,2,1,1,0,0,0
"Apr 8, 2019 11:00 PM",21,3,18,,,,,,,,,,1,1,0,0,,,,6,5,1,1,2,0,0,0,1,0,0,1,1,0,0,0,0
"Apr 9, 2019 12:00 AM",8,2,6,,,,,,,,,,0,0,0,1,,,,5,5,0,1,2,0,0,0,5,0,1,0,0,0,0,0,0
"Apr 9, 2019 1:00 AM",0,0,0,,,,,,,,,,1,1,0,0,,,,2,2,0,0,0,1,0,1,0,0,0,0,0,0,0,0,0
"Apr 9, 2019 2:00 AM",0,0,0,,,,,,,,,,0,0,0,0,,,,0,0,0,0,1,1,1,0,0,0,0,0,0,0,0,0,0
"Apr 9, 2019 3:00 AM",2,1,1,,,,,,,,,,0,0,0,1,,,,0,0,0,0,0,0,0,0,0,0,0,0,0,0,0,0,0
"Apr 9, 2019 4:00 AM",1,0,1,,,,,,,,,,0,0,0,0,,,,0,0,0,1,0,0,0,0,0,0,0,0,0,0,0,0,0
"Apr 9, 2019 5:00 AM",11,9,2,,,,,,,,,,0,0,0,1,,,,0,0,0,5,4,2,1,1,6,1,0,0,0,0,0,0,0
"Apr 9, 2019 6:00 AM",45,34,11,,,,,,,,,,3,0,3,9,,,,5,5,0,26,16,11,8,3,51,1,1,1,1,0,0,0,0
"Apr 9, 2019 7:00 AM",212,155,57,,,,,,,,,,12,4,8,14,,,,42,31,11,130,36,49,37,12,190,3,3,3,2,1,0,0,0
"Apr 9, 2019 8:00 AM",416,351,65,,,,,,,,,,30,6,24,40,,,,54,29,25,278,73,108,88,20,321,6,4,10,8,2,0,0,0
"Apr 9, 2019 9:00 AM",205,179,26,,,,,,,,,,16,6,10,9,,,,26,19,7,134,22,26,17,9,108,4,4,3,1,2,0,0,0
"Apr 9, 2019 10:00 AM",103,87,16,,,,,,,,,,12,5,7,5,,,,18,9,9,56,15,13,7,6,27,1,7,3,3,0,0,0,0
"Apr 9, 2019 11:00 AM",46,33,13,,,,,,,,,,9,1,8,5,,,,13,6,7,33,11,11,7,4,29,3,2,1,1,0,0,0,0
"Apr 9, 2019 12:00 PM",63,33,30,,,,,,,,,,10,3,7,3,,,,18,15,3,28,12,6,2,4,27,2,1,5,3,2,1,0,1
"Apr 9, 2019 1:00 PM",97,56,41,,,,,,,,,,19,11,8,5,,,,25,22,3,19,24,21,5,16,23,4,1,5,2,3,0,0,0
"Apr 9, 2019 2:00 PM",79,36,43,,,,,,,,,,12,10,2,6,,,,28,25,3,13,23,20,7,13,24,2,1,3,2,1,0,0,0
"Apr 9, 2019 3:00 PM",90,20,70,,,,,,,,,,13,7,6,18,,,,37,33,4,24,31,23,3,20,19,6,0,3,1,2,0,0,0
"Apr 9, 2019 4:00 PM",152,32,120,,,,,,,,,,19,15,4,17,,,,69,69,0,26,78,37,10,27,39,4,3,5,3,2,3,3,0
"Apr 9, 2019 5:00 PM",361,81,280,,,,,,,,,,27,16,11,25,,,,186,180,6,37,173,99,15,84,61,4,2,7,4,3,3,3,0
"Apr 9, 2019 6:00 PM",317,53,264,,,,,,,,,,29,21,8,28,,,,187,181,6,38,179,100,17,83,69,11,1,2,2,0,1,1,0
"Apr 9, 2019 7:00 PM",207,35,172,,,,,,,,,,15,9,6,10,,,,100,98,2,16,76,45,6,39,27,4,2,3,3,0,0,0,0
"Apr 9, 2019 8:00 PM",99,27,72,,,,,,,,,,8,6,2,8,,,,58,54,4,13,43,22,1,21,9,0,3,3,3,0,1,1,0
"Apr 9, 2019 9:00 PM",84,20,64,,,,,,,,,,5,2,3,3,,,,47,46,1,10,18,9,1,8,19,1,0,0,0,0,1,1,0
"Apr 9, 2019 10:00 PM",53,8,45,,,,,,,,,,7,5,2,0,,,,29,28,1,7,18,4,1,3,9,1,1,2,0,2,0,0,0
"Apr 9, 2019 11:00 PM",25,7,18,,,,,,,,,,0,0,0,2,,,,8,8,0,4,5,0,0,0,2,0,0,0,0,0,0,0,0
"Apr 10, 2019 12:00 AM",15,2,13,,,,,,,,,,3,2,1,1,,,,3,3,0,0,4,1,0,1,2,0,1,0,0,0,0,0,0
"Apr 10, 2019 1:00 AM",5,2,3,,,,,,,,,,0,0,0,0,,,,3,3,0,0,0,1,1,0,0,1,1,0,0,0,0,0,0
"Apr 10, 2019 2:00 AM",2,1,1,,,,,,,,,,0,0,0,0,,,,3,3,0,1,0,0,0,0,0,0,0,0,0,0,0,0,0
"Apr 10, 2019 3:00 AM",1,1,0,,,,,,,,,,0,0,0,0,,,,1,1,0,0,0,0,0,0,0,0,0,0,0,0,0,0,0
"Apr 10, 2019 4:00 AM",2,0,2,,,,,,,,,,0,0,0,0,,,,1,1,0,1,0,0,0,0,1,0,0,0,0,0,0,0,0
"Apr 10, 2019 5:00 AM",6,5,1,,,,,,,,,,0,0,0,3,,,,0,0,0,7,7,0,0,0,12,1,0,0,0,0,0,0,0
"Apr 10, 2019 6:00 AM",69,54,15,,,,,,,,,,4,0,4,4,,,,9,8,1,30,17,13,12,1,61,3,2,1,1,0,0,0,0
"Apr 10, 2019 7:00 AM",243,182,61,,,,,,,,,,13,5,8,16,,,,33,23,10,161,48,52,42,10,197,2,4,3,2,1,3,0,3
"Apr 10, 2019 8:00 AM",433,373,60,,,,,,,,,,20,4,16,33,,,,45,29,16,307,62,102,74,28,356,6,5,17,12,5,0,0,0
"Apr 10, 2019 9:00 AM",222,196,26,,,,,,,,,,16,7,9,5,,,,33,17,16,130,27,41,26,15,119,3,4,4,2,2,1,0,1
"Apr 10, 2019 10:00 AM",91,76,15,,,,,,,,,,9,5,4,6,,,,14,11,3,68,21,18,15,3,30,8,1,4,3,1,0,0,0
"Apr 10, 2019 11:00 AM",71,53,18,,,,,,,,,,9,6,3,5,,,,21,16,5,35,16,16,8,8,22,1,2,0,0,0,0,0,0
"Apr 10, 2019 12:00 PM",80,44,36,,,,,,,,,,13,7,6,3,,,,38,32,6,26,24,26,7,19,25,1,1,1,1,0,0,0,0
"Apr 10, 2019 1:00 PM",88,39,49,,,,,,,,,,22,13,9,12,,,,30,26,4,29,25,16,7,9,29,1,1,6,1,5,4,2,2
"Apr 10, 2019 2:00 PM",81,33,48,,,,,,,,,,21,11,10,8,,,,40,36,4,16,24,20,5,15,27,6,2,2,1,1,3,3,0
"Apr 10, 2019 3:00 PM",75,25,50,,,,,,,,,,16,12,4,15,,,,48,41,7,23,28,27,11,16,26,5,4,3,3,0,0,0,0
"Apr 10, 2019 4:00 PM",172,45,127,,,,,,,,,,22,14,8,13,,,,82,79,3,28,84,56,14,42,38,8,4,4,2,2,9,9,0
"Apr 10, 2019 5:00 PM",347,71,276,,,,,,,,,,29,20,9,32,,,,202,199,3,48,177,107,11,96,78,10,3,10,7,3,3,3,0
"Apr 10, 2019 6:00 PM",325,63,262,,,,,,,,,,30,24,6,24,,,,203,198,5,37,205,91,13,78,53,6,5,3,3,0,0,0,0
"Apr 10, 2019 7:00 PM",200,42,158,,,,,,,,,,21,9,12,18,,,,98,93,5,21,67,52,16,36,27,2,1,5,1,4,1,1,0
"Apr 10, 2019 8:00 PM",145,25,120,,,,,,,,,,5,4,1,16,,,,47,44,3,12,37,18,3,15,32,2,0,3,1,2,0,0,0
"Apr 10, 2019 9:00 PM",68,18,50,,,,,,,,,,6,5,1,6,,,,50,48,2,8,24,11,6,5,14,1,0,1,1,0,0,0,0
"Apr 10, 2019 10:00 PM",59,13,46,,,,,,,,,,4,3,1,4,,,,24,22,2,6,16,12,1,11,15,0,0,0,0,0,0,0,0
"Apr 10, 2019 11:00 PM",27,4,23,,,,,,,,,,2,1,1,0,,,,16,15,1,2,8,1,1,0,4,1,0,0,0,0,0,0,0
"Apr 11, 2019 12:00 AM",9,1,8,,,,,,,,,,0,0,0,0,,,,2,2,0,4,6,0,0,0,5,0,0,1,1,0,0,0,0
"Apr 11, 2019 1:00 AM",2,0,2,,,,,,,,,,0,0,0,0,,,,3,3,0,0,1,1,0,1,0,0,0,0,0,0,0,0,0
"Apr 11, 2019 2:00 AM",1,0,1,,,,,,,,,,0,0,0,1,,,,2,2,0,0,2,0,0,0,0,1,0,0,0,0,0,0,0
"Apr 11, 2019 3:00 AM",2,1,1,,,,,,,,,,0,0,0,3,,,,2,2,0,0,2,0,0,0,1,1,0,0,0,0,0,0,0
"Apr 11, 2019 4:00 AM",2,0,2,,,,,,,,,,0,0,0,0,,,,2,1,1,0,0,0,0,0,1,0,0,0,0,0,0,0,0
"Apr 11, 2019 5:00 AM",6,5,1,,,,,,,,,,0,0,0,1,,,,1,1,0,10,3,1,1,0,9,2,0,0,0,0,0,0,0
"Apr 11, 2019 6:00 AM",51,41,10,,,,,,,,,,6,3,3,6,,,,6,6,0,33,11,6,5,1,55,0,1,5,4,1,0,0,0
"Apr 11, 2019 7:00 AM",212,158,54,,,,,,,,,,13,5,8,21,,,,41,28,13,128,36,51,37,14,163,3,6,4,3,1,0,0,0
"Apr 11, 2019 8:00 AM",421,342,79,,,,,,,,,,25,9,16,37,,,,56,39,17,272,62,97,76,21,328,9,8,11,9,2,0,0,0
"Apr 11, 2019 9:00 AM",215,187,28,,,,,,,,,,17,9,8,9,,,,21,16,5,143,42,50,32,18,106,3,5,5,2,3,0,0,0
"Apr 11, 2019 10:00 AM",113,93,20,,,,,,,,,,13,4,9,4,,,,18,9,9,62,15,16,11,5,34,3,0,3,1,2,0,0,0
"Apr 11, 2019 11:00 AM",56,30,26,,,,,,,,,,15,7,8,5,,,,17,11,6,28,15,23,14,9,30,0,2,4,3,1,0,0,0
"Apr 11, 2019 12:00 PM",83,44,39,,,,,,,,,,10,5,5,5,,,,23,19,4,26,21,17,8,9,28,1,0,2,1,1,0,0,0
"Apr 11, 2019 1:00 PM",90,39,51,,,,,,,,,,11,7,4,10,,,,37,34,3,20,27,13,5,8,30,2,1,0,0,0,1,0,1
"Apr 11, 2019 2:00 PM",74,29,45,,,,,,,,,,21,15,6,13,,,,30,28,2,23,25,16,2,14,18,2,2,2,1,1,1,0,1
"Apr 11, 2019 3:00 PM",86,27,59,,,,,,,,,,26,17,9,15,,,,45,40,5,23,34,29,9,20,24,6,1,10,7,3,1,1,0
"Apr 11, 2019 4:00 PM",174,45,129,,,,,,,,,,16,11,5,22,,,,72,71,1,24,86,39,10,29,38,4,3,7,3,4,1,1,0
"Apr 11, 2019 5:00 PM",323,71,252,,,,,,,,,,15,7,8,29,,,,181,175,6,41,176,89,15,74,77,12,1,6,4,2,2,2,0
"Apr 11, 2019 6:00 PM",305,56,249,,,,,,,,,,23,17,6,16,,,,164,159,5,37,157,72,8,64,59,7,4,2,1,1,1,1,0
"Apr 11, 2019 7:00 PM",176,45,131,,,,,,,,,,16,9,7,12,,,,71,70,1,19,71,40,7,33,22,4,5,2,0,2,0,0,0
"Apr 11, 2019 8:00 PM",96,19,77,,,,,,,,,,13,8,5,8,,,,45,44,1,19,35,23,5,18,23,2,1,3,1,2,1,1,0
"Apr 11, 2019 9:00 PM",103,17,86,,,,,,,,,,5,4,1,6,,,,43,41,2,11,20,13,3,10,15,2,1,5,3,2,2,1,1
"Apr 11, 2019 10:00 PM",50,7,43,,,,,,,,,,3,1,2,4,,,,25,25,0,6,18,8,1,7,10,0,0,1,1,0,0,0,0
"Apr 11, 2019 11:00 PM",31,4,27,,,,,,,,,,1,1,0,2,,,,18,17,1,2,13,5,0,5,5,0,0,2,1,1,0,0,0
"Apr 12, 2019 12:00 AM",13,2,11,,,,,,,,,,0,0,0,0,,,,6,6,0,1,8,3,0,3,1,0,1,0,0,0,0,0,0
"Apr 12, 2019 1:00 AM",1,0,1,,,,,,,,,,1,1,0,0,,,,8,8,0,2,6,1,0,1,0,0,0,0,0,0,0,0,0
"Apr 12, 2019 2:00 AM",2,0,2,,,,,,,,,,0,0,0,0,,,,3,3,0,1,2,1,0,1,0,0,0,0,0,0,0,0,0
"Apr 12, 2019 3:00 AM",2,1,1,,,,,,,,,,0,0,0,0,,,,1,1,0,0,0,0,0,0,1,1,0,0,0,0,0,0,0
"Apr 12, 2019 4:00 AM",1,0,1,,,,,,,,,,0,0,0,0,,,,1,1,0,1,0,0,0,0,1,0,0,0,0,0,0,0,0
"Apr 12, 2019 5:00 AM",7,5,2,,,,,,,,,,0,0,0,2,,,,2,2,0,6,5,0,0,0,8,2,0,0,0,0,0,0,0
"Apr 12, 2019 6:00 AM",52,40,12,,,,,,,,,,2,0,2,5,,,,7,5,2,27,14,6,5,1,46,0,0,4,3,1,1,0,1
"Apr 12, 2019 7:00 AM",184,129,55,,,,,,,,,,7,1,6,15,,,,29,24,5,98,37,43,30,13,129,3,5,2,1,1,3,1,2
"Apr 12, 2019 8:00 AM",321,255,66,,,,,,,,,,20,4,16,34,,,,39,22,17,212,62,68,53,15,246,7,9,11,10,1,2,0,2
"Apr 12, 2019 9:00 AM",185,162,23,,,,,,,,,,17,5,12,10,,,,23,13,10,95,30,30,19,11,93,2,2,2,2,0,0,0,0
"Apr 12, 2019 10:00 AM",83,57,26,,,,,,,,,,14,2,12,4,,,,15,8,7,54,7,14,9,5,33,2,4,2,2,0,0,0,0
"Apr 12, 2019 11:00 AM",68,42,26,,,,,,,,,,15,6,9,4,,,,13,11,2,23,14,10,1,9,25,0,4,2,2,0,0,0,0
"Apr 12, 2019 12:00 PM",74,33,41,,,,,,,,,,22,13,9,6,,,,21,16,5,24,21,19,7,12,28,1,2,1,1,0,0,0,0
"Apr 12, 2019 1:00 PM",93,43,50,,,,,,,,,,15,6,9,8,,,,23,22,1,36,27,15,7,8,26,3,2,6,2,4,0,0,0
"Apr 12, 2019 2:00 PM",101,39,62,,,,,,,,,,17,7,10,3,,,,38,33,5,17,30,10,3,7,14,0,0,2,2,0,2,1,1
"Apr 12, 2019 3:00 PM",99,27,72,,,,,,,,,,23,17,6,8,,,,45,43,2,22,40,20,4,16,18,6,1,3,1,2,3,2,1
"Apr 12, 2019 4:00 PM",144,41,103,,,,,,,,,,17,11,6,23,,,,73,71,2,18,72,38,5,33,38,7,2,7,4,3,2,2,0
"Apr 12, 2019 5:00 PM",251,40,211,,,,,,,,,,17,12,5,33,,,,135,132,3,42,149,81,16,65,68,6,3,6,5,1,2,0,2
"Apr 12, 2019 6:00 PM",218,53,165,,,,,,,,,,22,17,5,17,,,,110,104,6,22,114,47,3,44,36,4,3,2,1,1,1,0,1
"Apr 12, 2019 7:00 PM",109,29,80,,,,,,,,,,6,4,2,7,,,,64,61,3,19,41,21,5,16,14,0,2,4,1,3,1,1,0
"Apr 12, 2019 8:00 PM",79,19,60,,,,,,,,,,10,5,5,6,,,,43,42,1,9,14,10,2,8,16,4,4,1,0,1,0,0,0
"Apr 12, 2019 9:00 PM",58,16,42,,,,,,,,,,1,1,0,5,,,,17,17,0,8,10,4,0,4,7,1,0,0,0,0,0,0,0
"Apr 12, 2019 10:00 PM",39,6,33,,,,,,,,,,4,4,0,2,,,,21,19,2,7,5,2,1,1,11,0,0,1,1,0,0,0,0
"Apr 12, 2019 11:00 PM",22,3,19,,,,,,,,,,5,4,1,1,,,,10,10,0,3,7,2,1,1,8,0,0,0,0,0,0,0,0
"Apr 13, 2019 12:00 AM",9,2,7,,,,,,,,,,1,0,1,2,,,,5,5,0,4,4,2,0,2,8,0,1,0,0,0,0,0,0
"Apr 13, 2019 1:00 AM",4,1,3,,,,,,,,,,1,1,0,0,,,,3,3,0,3,1,0,0,0,1,0,1,0,0,0,0,0,0
"Apr 13, 2019 2:00 AM",6,0,6,,,,,,,,,,1,1,0,0,,,,2,2,0,0,3,5,2,3,0,0,0,0,0,0,0,0,0
"Apr 13, 2019 3:00 AM",5,2,3,,,,,,,,,,1,1,0,0,,,,0,0,0,0,3,2,2,0,1,1,1,0,0,0,0,0,0
"Apr 13, 2019 4:00 AM",1,0,1,,,,,,,,,,0,0,0,0,,,,1,1,0,1,0,1,0,1,1,0,0,0,0,0,0,0,0
"Apr 13, 2019 5:00 AM",5,2,3,,,,,,,,,,1,0,1,0,,,,2,2,0,0,4,1,0,1,3,0,0,0,0,0,0,0,0
"Apr 13, 2019 6:00 AM",7,6,1,,,,,,,,,,4,1,3,0,,,,1,1,0,1,6,0,0,0,6,1,1,0,0,0,0,0,0
"Apr 13, 2019 7:00 AM",15,6,9,,,,,,,,,,4,1,3,1,,,,6,5,1,9,17,9,5,4,15,1,1,0,0,0,0,0,0
"Apr 13, 2019 8:00 AM",32,17,15,,,,,,,,,,11,6,5,6,,,,9,7,2,14,9,8,4,4,11,1,1,1,1,0,0,0,0
"Apr 13, 2019 9:00 AM",56,41,15,,,,,,,,,,14,6,8,15,,,,10,10,0,16,24,24,11,13,25,2,2,2,1,1,0,0,0
"Apr 13, 2019 10:00 AM",56,41,15,,,,,,,,,,9,5,4,7,,,,12,9,3,21,17,19,10,9,21,1,3,6,2,4,0,0,0
"Apr 13, 2019 11:00 AM",62,37,25,,,,,,,,,,21,9,12,9,,,,13,12,1,20,21,24,12,12,31,5,5,3,2,1,0,0,0
"Apr 13, 2019 12:00 PM",45,21,24,,,,,,,,,,21,12,9,7,,,,19,16,3,23,27,26,13,13,25,5,2,4,2,2,0,0,0
"Apr 13, 2019 1:00 PM",66,37,29,,,,,,,,,,15,6,9,10,,,,18,12,6,16,16,17,4,13,24,6,0,0,0,0,0,0,0
"Apr 13, 2019 2:00 PM",55,34,21,,,,,,,,,,17,13,4,14,,,,23,18,5,19,14,18,7,11,22,3,3,1,1,0,0,0,0
"Apr 13, 2019 3:00 PM",56,27,29,,,,,,,,,,12,7,5,10,,,,17,15,2,12,13,29,6,23,15,3,1,4,3,1,0,0,0
"Apr 13, 2019 4:00 PM",46,22,24,,,,,,,,,,31,14,17,15,,,,17,13,4,9,17,17,11,6,15,4,2,5,2,3,0,0,0
"Apr 13, 2019 5:00 PM",66,21,45,,,,,,,,,,23,13,10,9,,,,16,16,0,12,14,27,11,16,15,3,1,9,4,5,0,0,0
"Apr 13, 2019 6:00 PM",39,9,30,,,,,,,,,,13,5,8,7,,,,11,10,1,9,9,16,9,7,7,2,0,3,2,1,0,0,0
"Apr 13, 2019 7:00 PM",29,16,13,,,,,,,,,,13,8,5,15,,,,15,12,3,6,8,11,0,11,10,1,1,5,2,3,0,0,0
"Apr 13, 2019 8:00 PM",32,10,22,,,,,,,,,,1,1,0,4,,,,10,9,1,5,7,4,2,2,2,0,1,10,5,5,0,0,0
"Apr 13, 2019 9:00 PM",18,6,12,,,,,,,,,,3,3,0,3,,,,9,9,0,8,2,1,0,1,6,1,0,0,0,0,0,0,0
"Apr 13, 2019 10:00 PM",25,7,18,,,,,,,,,,3,3,0,2,,,,3,2,1,2,4,1,1,0,5,1,0,1,0,1,,,
"Apr 13, 2019 11:00 PM",10,3,7,,,,,,,,,,1,0,1,1,,,,5,4,1,0,4,2,2,0,7,0,1,0,0,0,,,
"Apr 14, 2019 12:00 AM",6,1,5,,,,,,,,,,0,0,0,5,,,,5,5,0,3,0,1,1,0,5,0,2,0,0,0,,,
"Apr 14, 2019 1:00 AM",6,3,3,,,,,,,,,,2,1,1,0,,,,1,1,0,4,1,0,0,0,2,0,0,0,0,0,,,
"Apr 14, 2019 2:00 AM",3,1,2,,,,,,,,,,0,0,0,0,,,,3,2,1,0,1,1,0,1,1,0,1,0,0,0,,,
"Apr 14, 2019 3:00 AM",4,1,3,,,,,,,,,,0,0,0,0,,,,0,0,0,1,1,0,0,0,0,0,1,0,0,0,,,
"Apr 14, 2019 4:00 AM",3,0,3,,,,,,,,,,0,0,0,0,,,,0,0,0,0,2,0,0,0,0,1,0,1,1,0,,,
"Apr 14, 2019 5:00 AM",3,1,2,,,,,,,,,,0,0,0,0,,,,0,0,0,0,2,0,0,0,0,0,0,0,0,0,,,
"Apr 14, 2019 6:00 AM",6,5,1,,,,,,,,,,1,1,0,1,,,,3,3,0,2,5,0,0,0,7,0,0,0,0,0,,,
"Apr 14, 2019 7:00 AM",13,9,4,,,,,,,,,,2,1,1,1,,,,7,4,3,4,10,1,1,0,6,0,4,1,1,0,,,
"Apr 14, 2019 8:00 AM",30,15,15,,,,,,,,,,5,3,2,2,,,,2,2,0,4,15,6,4,2,10,0,9,1,0,1,0,0,0
"Apr 14, 2019 9:00 AM",34,24,10,,,,,,,,,,6,4,2,5,,,,7,3,4,14,13,9,3,6,12,1,2,0,0,0,0,0,0
"Apr 14, 2019 10:00 AM",36,23,13,,,,,,,,,,4,0,4,4,,,,5,4,1,9,7,11,7,4,13,4,2,1,1,0,0,0,0
"Apr 14, 2019 11:00 AM",43,27,16,,,,,,,,,,10,6,4,2,,,,11,9,2,16,14,16,7,9,27,1,2,0,0,0,0,0,0
"Apr 14, 2019 12:00 PM",50,27,23,,,,,,,,,,7,1,6,10,,,,15,14,1,14,12,13,4,9,12,5,2,3,2,1,0,0,0
"Apr 14, 2019 1:00 PM",53,30,23,,,,,,,,,,14,8,6,7,,,,10,10,0,13,8,7,3,4,15,1,4,3,2,1,0,0,0
"Apr 14, 2019 2:00 PM",48,22,26,,,,,,,,,,7,6,1,8,,,,10,10,0,12,16,12,8,4,6,3,0,1,0,1,,,
"Apr 14, 2019 3:00 PM",28,14,14,,,,,,,,,,7,3,4,14,,,,6,5,1,6,9,5,4,1,15,1,5,0,0,0,,,
"Apr 14, 2019 4:00 PM",43,18,25,,,,,,,,,,12,7,5,12,,,,9,9,0,8,8,15,3,12,6,1,2,0,0,0,,,
"Apr 14, 2019 5:00 PM",30,8,22,,,,,,,,,,7,5,2,8,,,,15,15,0,12,7,6,4,2,7,2,3,3,2,1,,,
"Apr 14, 2019 6:00 PM",45,16,29,,,,,,,,,,1,0,1,12,,,,13,13,0,4,6,7,5,2,14,1,0,0,0,0,,,
"Apr 14, 2019 7:00 PM",38,14,24,,,,,,,,,,6,5,1,10,,,,9,7,2,2,9,5,2,3,15,1,1,3,1,2,,,
"Apr 14, 2019 8:00 PM",30,9,21,,,,,,,,,,5,3,2,4,,,,9,9,0,8,4,5,3,2,8,0,1,2,2,0,,,
"Apr 14, 2019 9:00 PM",23,6,17,,,,,,,,,,5,1,4,4,,,,9,9,0,6,1,3,2,1,7,1,0,0,0,0,,,
"Apr 14, 2019 10:00 PM",9,3,6,,,,,,,,,,2,2,0,1,,,,2,2,0,2,0,3,1,2,4,0,0,0,0,0,,,
"Apr 14, 2019 11:00 PM",7,1,6,,,,,,,,,,1,0,1,2,,,,1,1,0,0,0,1,0,1,1,0,1,0,0,0,,,
"Apr 15, 2019 12:00 AM",6,1,5,,,,,,,,,,0,0,0,0,,,,2,1,1,1,1,2,0,2,0,0,1,1,0,1,,,
"Apr 15, 2019 1:00 AM",1,0,1,,,,,,,,,,1,1,0,0,,,,1,1,0,1,0,1,0,1,1,0,0,0,0,0,,,
"Apr 15, 2019 2:00 AM",2,1,1,,,,,,,,,,0,0,0,0,,,,2,1,1,0,0,0,0,0,0,0,0,0,0,0,,,
"Apr 15, 2019 3:00 AM",4,2,2,,,,,,,,,,0,0,0,0,,,,1,1,0,0,1,0,0,0,0,1,0,0,0,0,,,
"Apr 15, 2019 4:00 AM",3,1,2,,,,,,,,,,0,0,0,0,,,,0,0,0,0,0,1,0,1,1,0,0,0,0,0,,,
"Apr 15, 2019 5:00 AM",5,4,1,,,,,,,,,,0,0,0,1,,,,0,0,0,4,4,0,0,0,12,1,0,0,0,0,,,
"Apr 15, 2019 6:00 AM",27,25,2,,,,,,,,,,0,0,0,3,,,,1,0,1,14,11,6,3,3,30,0,1,2,2,0,0,0,0
"Apr 15, 2019 7:00 AM",124,103,21,,,,,,,,,,5,1,4,5,,,,19,13,6,78,19,9,7,2,92,1,3,1,1,0,0,0,0
"Apr 15, 2019 8:00 AM",231,207,24,,,,,,,,,,5,1,4,15,,,,19,11,8,150,30,37,31,6,151,1,3,0,0,0,0,0,0
"Apr 15, 2019 9:00 AM",147,131,16,,,,,,,,,,7,2,5,3,,,,11,8,3,65,15,10,8,2,61,2,0,2,2,0,0,0,0
"Apr 15, 2019 10:00 AM",59,52,7,,,,,,,,,,6,0,6,6,,,,12,3,9,28,2,3,1,2,20,0,1,0,0,0,0,0,0
"Apr 15, 2019 11:00 AM",11,0,11,,,,,,,,,,11,6,5,8,,,,3,2,1,28,6,5,2,3,12,0,0,0,0,0,0,0,0
"Apr 15, 2019 12:00 PM",24,0,24,,,,,,,,,,5,3,2,6,,,,13,8,5,25,7,4,1,3,8,0,1,0,0,0,0,0,0
"Apr 15, 2019 1:00 PM",23,0,23,,,,,,,,,,5,3,2,2,,,,14,12,2,11,8,2,0,2,7,1,0,0,0,0,0,0,0
"Apr 15, 2019 2:00 PM",22,0,22,,,,,,,,,,1,1,0,4,,,,14,13,1,7,13,4,1,3,5,0,0,1,1,0,0,0,0
"Apr 15, 2019 3:00 PM",42,0,42,,,,,,,,,,2,2,0,13,,,,21,19,2,8,13,5,1,4,10,2,1,2,2,0,0,0,0
"Apr 15, 2019 4:00 PM",88,17,71,,,,,,,,,,3,2,1,9,,,,44,42,2,10,40,12,3,9,17,4,2,2,2,0,0,0,0
"Apr 15, 2019 5:00 PM",193,19,174,,,,,,,,,,11,8,3,6,,,,99,99,0,27,95,43,3,40,39,3,2,2,1,1,0,0,0
"Apr 15, 2019 6:00 PM",199,31,168,,,,,,,,,,4,3,1,12,,,,125,124,1,17,93,43,3,40,27,4,1,1,1,0,0,0,0
"Apr 15, 2019 7:00 PM",119,27,92,,,,,,,,,,9,6,3,6,,,,54,53,1,8,44,17,3,14,10,1,4,1,0,1,0,0,0
"Apr 15, 2019 8:00 PM",68,11,57,,,,,,,,,,3,3,0,3,,,,35,33,2,8,17,2,0,2,11,0,1,0,0,0,0,0,0
"Apr 15, 2019 9:00 PM",58,6,52,,,,,,,,,,1,1,0,4,,,,25,22,3,3,8,4,0,4,5,2,0,1,1,0,0,0,0
"Apr 15, 2019 10:00 PM",39,6,33,,,,,,,,,,0,0,0,3,,,,14,14,0,3,7,3,0,3,8,0,0,0,0,0,0,0,0
"Apr 15, 2019 11:00 PM",10,2,8,,,,,,,,,,0,0,0,0,,,,5,4,1,1,3,1,0,1,2,0,0,1,1,0,0,0,0
"Apr 16, 2019 12:00 AM",7,1,6,,,,,,,,,,0,0,0,1,,,,3,3,0,2,1,0,0,0,0,0,2,0,0,0,0,0,0
"Apr 16, 2019 1:00 AM",1,0,1,,,,,,,,,,0,0,0,1,,,,0,0,0,0,1,0,0,0,0,0,0,0,0,0,0,0,0
"Apr 16, 2019 2:00 AM",0,0,0,,,,,,,,,,0,0,0,0,,,,2,2,0,0,1,1,0,1,0,0,0,0,0,0,0,0,0
"Apr 16, 2019 3:00 AM",2,2,0,,,,,,,,,,0,0,0,0,,,,0,0,0,0,0,0,0,0,1,1,0,0,0,0,0,0,0
"Apr 16, 2019 4:00 AM",1,0,1,,,,,,,,,,0,0,0,0,,,,1,1,0,0,0,0,0,0,0,0,0,0,0,0,0,0,0
"Apr 16, 2019 5:00 AM",3,2,1,,,,,,,,,,0,0,0,1,,,,1,1,0,4,3,0,0,0,8,2,0,0,0,0,0,0,0
"Apr 16, 2019 6:00 AM",34,31,3,,,,,,,,,,4,0,4,5,,,,5,4,1,24,10,6,4,2,41,0,0,3,2,1,0,0,0
"Apr 16, 2019 7:00 AM",174,129,45,,,,,,,,,,5,1,4,17,,,,30,19,11,111,32,26,21,5,118,2,4,2,1,1,0,0,0
"Apr 16, 2019 8:00 AM",346,299,47,,,,,,,,,,11,0,11,17,,,,27,16,11,185,49,64,48,16,245,2,4,3,3,0,0,0,0
"Apr 16, 2019 9:00 AM",179,163,16,,,,,,,,,,11,2,9,9,,,,18,9,9,108,15,26,17,9,69,2,4,2,2,0,0,0,0
"Apr 16, 2019 10:00 AM",90,77,13,,,,,,,,,,1,0,1,8,,,,12,5,7,49,13,6,4,2,28,1,1,1,0,1,0,0,0
"Apr 16, 2019 11:00 AM",60,40,20,,,,,,,,,,6,3,3,5,,,,13,9,4,25,5,8,5,3,11,0,1,1,1,0,0,0,0
"Apr 16, 2019 12:00 PM",53,28,25,,,,,,,,,,8,2,6,2,,,,12,10,2,16,8,9,4,5,15,0,2,2,1,1,0,0,0
"Apr 16, 2019 1:00 PM",67,28,39,,,,,,,,,,6,3,3,9,,,,13,10,3,25,14,12,4,8,18,4,2,4,3,1,0,0,0
"Apr 16, 2019 2:00 PM",55,21,34,,,,,,,,,,4,3,1,4,,,,24,21,3,13,13,6,2,4,12,3,2,5,3,2,0,0,0
"Apr 16, 2019 3:00 PM",80,24,56,,,,,,,,,,11,5,6,8,,,,30,28,2,11,22,12,2,10,15,2,3,7,4,3,0,0,0
"Apr 16, 2019 4:00 PM",114,27,87,,,,,,,,,,9,7,2,17,,,,52,50,2,15,60,24,9,15,25,3,3,3,2,1,0,0,0
"Apr 16, 2019 5:00 PM",244,47,197,,,,,,,,,,13,8,5,25,,,,139,137,2,35,126,64,9,55,54,4,4,7,6,1,0,0,0
"Apr 16, 2019 6:00 PM",279,42,237,,,,,,,,,,22,15,7,22,,,,157,155,2,25,120,57,9,48,37,5,1,4,4,0,0,0,0
"Apr 16, 2019 7:00 PM",175,27,148,,,,,,,,,,15,10,5,15,,,,88,86,2,11,59,36,5,31,22,7,2,4,0,4,0,0,0
"Apr 16, 2019 8:00 PM",102,15,87,,,,,,,,,,6,3,3,5,,,,48,42,6,13,27,14,2,12,13,1,1,1,0,1,0,0,0
"Apr 16, 2019 9:00 PM",79,12,67,,,,,,,,,,5,3,2,5,,,,37,36,1,6,24,9,1,8,13,1,0,1,1,0,0,0,0
"Apr 16, 2019 10:00 PM",45,8,37,,,,,,,,,,9,9,0,5,,,,23,21,2,11,18,3,0,3,8,2,1,2,0,2,0,0,0
"Apr 16, 2019 11:00 PM",19,2,17,,,,,,,,,,3,2,1,1,,,,12,12,0,2,3,1,0,1,8,0,1,0,0,0,0,0,0
"Apr 17, 2019 12:00 AM",5,0,5,,,,,,,,,,1,0,1,0,,,,8,7,1,1,3,2,0,2,2,0,1,0,0,0,0,0,0
"Apr 17, 2019 1:00 AM",1,0,1,,,,,,,,,,0,0,0,0,,,,3,1,2,0,2,0,0,0,1,1,0,0,0,0,0,0,0
"Apr 17, 2019 2:00 AM",2,0,2,,,,,,,,,,1,0,1,0,,,,2,2,0,0,2,0,0,0,2,0,0,0,0,0,0,0,0
"Apr 17, 2019 3:00 AM",2,1,1,,,,,,,,,,0,0,0,0,,,,0,0,0,0,0,0,0,0,1,1,0,1,1,0,0,0,0
"Apr 17, 2019 4:00 AM",4,2,2,,,,,,,,,,0,0,0,0,,,,2,1,1,0,0,4,0,4,0,0,0,0,0,0,0,0,0
"Apr 17, 2019 5:00 AM",6,5,1,,,,,,,,,,1,0,1,2,,,,1,1,0,5,0,0,0,0,8,1,0,0,0,0,0,0,0
"Apr 17, 2019 6:00 AM",53,48,5,,,,,,,,,,3,1,2,7,,,,7,6,1,23,14,8,8,0,47,2,0,3,2,1,0,0,0
"Apr 17, 2019 7:00 AM",193,145,48,,,,,,,,,,12,3,9,11,,,,38,26,12,134,37,47,35,12,146,1,3,6,4,2,0,0,0
"Apr 17, 2019 8:00 AM",366,312,54,,,,,,,,,,24,6,18,19,,,,34,22,12,247,65,77,56,21,306,3,9,3,1,2,0,0,0
"Apr 17, 2019 9:00 AM",195,163,32,,,,,,,,,,18,5,13,6,,,,16,9,7,125,28,40,28,12,83,6,4,4,3,1,0,0,0
"Apr 17, 2019 10:00 AM",97,85,12,,,,,,,,,,10,6,4,12,,,,22,12,10,54,14,18,9,9,44,2,1,2,1,1,0,0,0
"Apr 17, 2019 11:00 AM",53,37,16,,,,,,,,,,10,6,4,6,,,,16,9,7,24,12,10,3,7,22,5,2,0,0,0,0,0,0
"Apr 17, 2019 12:00 PM",68,43,25,,,,,,,,,,18,11,7,5,,,,27,24,3,27,18,10,3,7,22,4,1,2,1,1,0,0,0
"Apr 17, 2019 1:00 PM",70,32,38,,,,,,,,,,19,10,9,3,,,,26,22,4,42,16,21,7,14,27,6,3,4,3,1,0,0,0
"Apr 17, 2019 2:00 PM",77,28,49,,,,,,,,,,15,12,3,19,,,,40,39,1,21,23,20,8,12,25,3,5,3,2,1,0,0,0
"Apr 17, 2019 3:00 PM",90,31,59,,,,,,,,,,11,7,4,8,,,,30,28,2,17,22,17,6,11,17,3,2,6,4,2,0,0,0
"Apr 17, 2019 4:00 PM",149,36,113,,,,,,,,,,25,20,5,16,,,,64,62,2,14,72,26,8,18,27,2,2,4,3,1,0,0,0
"Apr 17, 2019 5:00 PM",306,59,247,,,,,,,,,,18,13,5,26,,,,150,146,4,25,160,75,13,62,73,7,4,3,1,2,0,0,0
"Apr 17, 2019 6:00 PM",280,54,226,,,,,,,,,,23,12,11,20,,,,186,182,4,42,161,78,9,69,45,7,9,5,3,2,0,0,0
"Apr 17, 2019 7:00 PM",210,45,165,,,,,,,,,,20,13,7,12,,,,89,88,1,31,74,49,11,38,31,2,2,2,1,1,0,0,0
"Apr 17, 2019 8:00 PM",104,20,84,,,,,,,,,,4,1,3,5,,,,57,51,6,10,31,16,5,11,21,5,1,3,1,2,0,0,0
"Apr 17, 2019 9:00 PM",71,9,62,,,,,,,,,,6,5,1,9,,,,36,35,1,11,20,9,0,9,11,0,0,1,0,1,0,0,0
"Apr 17, 2019 10:00 PM",48,10,38,,,,,,,,,,3,3,0,5,,,,35,35,0,5,11,14,2,12,12,0,0,0,0,0,0,0,0
"Apr 17, 2019 11:00 PM",32,6,26,,,,,,,,,,2,1,1,2,,,,8,8,0,1,10,2,0,2,12,0,0,0,0,0,0,0,0
"Apr 18, 2019 12:00 AM",14,3,11,,,,,,,,,,0,0,0,0,,,,9,8,1,2,2,0,0,0,6,0,0,0,0,0,0,0,0
"Apr 18, 2019 1:00 AM",2,0,2,,,,,,,,,,0,0,0,0,,,,5,5,0,0,0,1,0,1,0,0,0,0,0,0,0,0,0
"Apr 18, 2019 2:00 AM",3,1,2,,,,,,,,,,0,0,0,0,,,,6,6,0,0,2,0,0,0,0,0,0,0,0,0,0,0,0
"Apr 18, 2019 3:00 AM",3,2,1,,,,,,,,,,0,0,0,0,,,,1,1,0,1,0,0,0,0,1,0,0,0,0,0,0,0,0
"Apr 18, 2019 4:00 AM",3,1,2,,,,,,,,,,0,0,0,0,,,,1,1,0,0,0,0,0,0,0,0,0,0,0,0,0,0,0
"Apr 18, 2019 5:00 AM",8,6,2,,,,,,,,,,1,1,0,1,,,,0,0,0,4,3,0,0,0,9,2,0,0,0,0,0,0,0
"Apr 18, 2019 6:00 AM",44,31,13,,,,,,,,,,2,0,2,5,,,,8,6,2,21,15,11,10,1,48,2,2,3,2,1,0,0,0
"Apr 18, 2019 7:00 AM",164,120,44,,,,,,,,,,9,3,6,13,,,,27,19,8,113,34,27,24,3,130,1,5,2,0,2,0,0,0
"Apr 18, 2019 8:00 AM",313,265,48,,,,,,,,,,21,6,15,24,,,,40,24,16,176,59,69,44,25,229,3,4,2,1,1,0,0,0
"Apr 18, 2019 9:00 AM",202,174,28,,,,,,,,,,24,6,18,12,,,,21,11,10,113,24,43,28,15,93,2,4,4,3,1,0,0,0
"Apr 18, 2019 10:00 AM",94,74,20,,,,,,,,,,21,5,16,4,,,,14,13,1,70,16,19,13,6,35,3,5,2,1,1,0,0,0
"Apr 18, 2019 11:00 AM",73,45,28,,,,,,,,,,14,7,7,7,,,,17,13,4,27,12,16,7,9,20,5,3,3,3,0,0,0,0
"Apr 18, 2019 12:00 PM",71,35,36,,,,,,,,,,31,14,17,4,,,,20,18,2,35,13,24,9,15,28,1,1,1,1,0,0,0,0
"Apr 18, 2019 1:00 PM",89,31,58,,,,,,,,,,21,14,7,16,,,,25,22,3,18,37,23,12,11,20,1,3,3,2,1,0,0,0
"Apr 18, 2019 2:00 PM",71,29,42,,,,,,,,,,7,4,3,28,,,,32,28,4,22,20,17,2,15,15,3,4,2,2,0,0,0,0
"Apr 18, 2019 3:00 PM",105,34,71,,,,,,,,,,12,5,7,26,,,,49,38,11,24,28,30,9,21,21,5,3,4,3,1,0,0,0
"Apr 18, 2019 4:00 PM",162,33,129,,,,,,,,,,14,8,6,15,,,,75,71,4,27,73,41,6,35,36,4,2,4,4,0,1,1,0
"Apr 18, 2019 5:00 PM",279,50,229,,,,,,,,,,21,13,8,26,,,,128,126,2,42,141,85,10,75,67,7,6,4,2,2,1,0,1
"Apr 18, 2019 6:00 PM",218,55,163,,,,,,,,,,31,20,11,23,,,,121,115,6,31,88,59,12,47,47,7,7,4,2,2,1,1,0
"Apr 18, 2019 7:00 PM",142,32,110,,,,,,,,,,17,13,4,24,,,,55,52,3,20,63,34,5,29,31,4,2,6,3,3,3,3,0
"Apr 18, 2019 8:00 PM",104,22,82,,,,,,,,,,16,8,8,8,,,,44,43,1,18,24,10,2,8,19,3,1,8,2,6,0,0,0
"Apr 18, 2019 9:00 PM",66,14,52,,,,,,,,,,3,2,1,7,,,,36,35,1,9,27,8,1,7,11,1,1,4,2,2,0,0,0
"Apr 18, 2019 10:00 PM",46,7,39,,,,,,,,,,3,2,1,5,,,,21,19,2,7,15,2,1,1,9,0,2,0,0,0,0,0,0
"Apr 18, 2019 11:00 PM",34,7,27,,,,,,,,,,4,4,0,1,,,,10,10,0,2,7,1,0,1,5,1,1,0,0,0,0,0,0
"Apr 19, 2019 12:00 AM",19,6,13,,,,,,,,,,5,4,1,5,,,,14,13,1,4,4,2,0,2,9,0,0,1,1,0,0,0,0
"Apr 19, 2019 1:00 AM",5,0,5,,,,,,,,,,0,0,0,0,,,,7,7,0,2,2,1,0,1,2,0,1,0,0,0,0,0,0
"Apr 19, 2019 2:00 AM",7,1,6,,,,,,,,,,0,0,0,0,,,,1,1,0,1,2,0,0,0,1,0,0,0,0,0,0,0,0
"Apr 19, 2019 3:00 AM",3,1,2,,,,,,,,,,0,0,0,0,,,,2,2,0,0,1,0,0,0,1,1,0,0,0,0,0,0,0
"Apr 19, 2019 4:00 AM",3,1,2,,,,,,,,,,0,0,0,0,,,,2,2,0,0,0,1,0,1,2,0,0,0,0,0,0,0,0
"Apr 19, 2019 5:00 AM",8,5,3,,,,,,,,,,1,0,1,2,,,,0,0,0,2,2,0,0,0,4,1,0,0,0,0,0,0,0
"Apr 19, 2019 6:00 AM",27,21,6,,,,,,,,,,4,1,3,7,,,,8,7,1,13,10,4,3,1,23,1,2,1,1,0,0,0,0
"Apr 19, 2019 7:00 AM",56,32,24,,,,,,,,,,1,1,0,6,,,,13,8,5,28,26,10,7,3,36,2,4,1,0,1,0,0,0
"Apr 19, 2019 8:00 AM",66,39,27,,,,,,,,,,7,4,3,10,,,,16,12,4,39,34,28,10,18,32,2,10,0,0,0,0,0,0
"Apr 19, 2019 9:00 AM",74,47,27,,,,,,,,,,3,1,2,7,,,,20,15,5,29,21,35,22,13,29,4,8,3,1,2,0,0,0
"Apr 19, 2019 10:00 AM",42,21,21,,,,,,,,,,18,3,15,15,,,,9,9,0,22,21,28,15,13,27,2,14,1,0,1,0,0,0
"Apr 19, 2019 11:00 AM",61,33,28,,,,,,,,,,27,11,16,11,,,,16,11,5,18,22,24,8,16,28,4,9,3,1,2,0,0,0
"Apr 19, 2019 12:00 PM",57,36,21,,,,,,,,,,25,17,8,8,,,,19,19,0,26,36,33,17,16,34,6,1,5,4,1,1,0,1
"Apr 19, 2019 1:00 PM",75,26,49,,,,,,,,,,11,6,5,12,,,,27,23,4,27,34,39,22,17,38,2,7,4,2,2,1,0,1
"Apr 19, 2019 2:00 PM",73,42,31,,,,,,,,,,20,10,10,28,,,,23,20,3,16,41,38,13,25,30,4,4,2,1,1,0,0,0
"Apr 19, 2019 3:00 PM",65,22,43,,,,,,,,,,26,16,10,12,,,,27,25,2,18,32,45,10,35,35,15,6,4,2,2,3,3,0
"Apr 19, 2019 4:00 PM",74,32,42,,,,,,,,,,20,9,11,21,,,,39,35,4,37,27,32,10,22,41,8,1,3,2,1,1,1,0
"Apr 19, 2019 5:00 PM",80,27,53,,,,,,,,,,16,9,7,13,,,,35,33,2,18,36,63,32,31,39,2,3,12,6,6,0,0,0
"Apr 19, 2019 6:00 PM",75,26,49,,,,,,,,,,18,11,7,26,,,,19,16,3,19,29,23,8,15,27,3,1,4,0,4,0,0,0
"Apr 19, 2019 7:00 PM",70,30,40,,,,,,,,,,14,5,9,7,,,,33,30,3,11,25,17,3,14,14,1,0,4,3,1,0,0,0
"Apr 19, 2019 8:00 PM",48,11,37,,,,,,,,,,7,4,3,4,,,,23,21,2,12,15,12,5,7,18,0,0,2,2,0,0,0,0
"Apr 19, 2019 9:00 PM",38,6,32,,,,,,,,,,0,0,0,3,,,,17,16,1,2,9,6,3,3,15,0,0,3,0,3,0,0,0
"Apr 19, 2019 10:00 PM",24,14,10,,,,,,,,,,0,0,0,2,,,,8,7,1,9,8,1,1,0,8,1,0,0,0,0,0,0,0
"Apr 19, 2019 11:00 PM",8,3,5,,,,,,,,,,4,4,0,2,,,,7,7,0,2,1,1,0,1,1,1,0,0,0,0,0,0,0
"Apr 20, 2019 12:00 AM",5,1,4,,,,,,,,,,6,3,3,0,,,,5,5,0,3,1,2,1,1,5,0,0,0,0,0,0,0,0
"Apr 20, 2019 1:00 AM",6,1,5,,,,,,,,,,0,0,0,0,,,,6,6,0,1,0,1,0,1,2,0,1,0,0,0,0,0,0
"Apr 20, 2019 2:00 AM",3,0,3,,,,,,,,,,0,0,0,0,,,,2,2,0,1,3,3,0,3,2,0,0,0,0,0,0,0,0
"Apr 20, 2019 3:00 AM",7,2,5,,,,,,,,,,0,0,0,0,,,,2,2,0,0,3,0,0,0,2,1,0,0,0,0,0,0,0
"Apr 20, 2019 4:00 AM",2,0,2,,,,,,,,,,0,0,0,0,,,,0,0,0,0,0,0,0,0,1,0,2,0,0,0,0,0,0
"Apr 20, 2019 5:00 AM",1,0,1,,,,,,,,,,0,0,0,2,,,,0,0,0,1,6,3,2,1,0,0,0,0,0,0,0,0,0
"Apr 20, 2019 6:00 AM",7,3,4,,,,,,,,,,0,0,0,2,,,,4,4,0,7,7,0,0,0,12,1,0,0,0,0,0,0,0
"Apr 20, 2019 7:00 AM",20,10,10,,,,,,,,,,2,1,1,1,,,,4,2,2,7,4,9,5,4,8,0,0,1,0,1,0,0,0
"Apr 20, 2019 8:00 AM",31,18,13,,,,,,,,,,3,0,3,4,,,,8,7,1,13,24,15,2,13,15,1,4,2,1,1,0,0,0
"Apr 20, 2019 9:00 AM",41,29,12,,,,,,,,,,12,4,8,2,,,,16,12,4,16,21,23,15,8,30,3,8,2,1,1,0,0,0
"Apr 20, 2019 10:00 AM",44,30,14,,,,,,,,,,24,8,16,13,,,,13,13,0,20,28,39,16,23,24,6,12,8,5,3,0,0,0
"Apr 20, 2019 11:00 AM",51,26,25,,,,,,,,,,29,11,18,25,,,,14,13,1,23,37,37,18,19,30,4,3,6,3,3,2,1,1
"Apr 20, 2019 12:00 PM",50,33,17,,,,,,,,,,36,0,36,25,,,,13,10,3,17,50,52,15,37,45,11,2,8,7,1,0,0,0
"Apr 20, 2019 1:00 PM",49,24,25,,,,,,,,,,22,7,15,26,,,,20,19,1,18,30,54,14,40,31,4,5,3,2,1,0,0,0
"Apr 20, 2019 2:00 PM",53,27,26,,,,,,,,,,30,9,21,22,,,,17,9,8,16,30,61,28,33,39,7,7,3,2,1,0,0,0
"Apr 20, 2019 3:00 PM",44,22,22,,,,,,,,,,28,18,10,18,,,,28,25,3,17,25,42,16,26,20,4,5,4,3,1,,,
"Apr 20, 2019 4:00 PM",53,25,28,,,,,,,,,,32,26,6,16,,,,12,9,3,17,14,41,28,13,20,2,1,1,0,1,,,
"Apr 20, 2019 5:00 PM",41,17,24,,,,,,,,,,19,10,9,8,,,,20,16,4,10,18,38,21,17,37,4,3,3,1,2,,,
"Apr 20, 2019 6:00 PM",50,21,29,,,,,,,,,,17,11,6,11,,,,21,19,2,11,14,14,6,8,29,7,1,9,3,6,,,
"Apr 20, 2019 7:00 PM",48,19,29,,,,,,,,,,17,15,2,4,,,,15,13,2,8,14,15,7,8,11,2,0,2,2,0,,,
"Apr 20, 2019 8:00 PM",26,8,18,,,,,,,,,,5,5,0,7,,,,11,10,1,10,12,8,3,5,21,0,0,1,0,1,,,
"Apr 20, 2019 9:00 PM",26,8,18,,,,,,,,,,7,6,1,5,,,,7,7,0,9,3,8,4,4,14,0,0,0,0,0,,,
"Apr 20, 2019 10:00 PM",14,6,8,,,,,,,,,,2,0,2,2,,,,3,3,0,6,4,2,1,1,7,0,0,2,0,2,0,0,0
"Apr 20, 2019 11:00 PM",13,5,8,,,,,,,,,,0,0,0,2,,,,9,7,2,9,2,3,1,2,3,0,0,0,0,0,0,0,0
"Apr 21, 2019 12:00 AM",7,2,5,,,,,,,,,,0,0,0,1,,,,3,3,0,3,3,0,0,0,10,0,1,0,0,0,0,0,0
"Apr 21, 2019 1:00 AM",5,1,4,,,,,,,,,,0,0,0,0,,,,1,1,0,1,2,0,0,0,1,0,1,1,1,0,0,0,0
"Apr 21, 2019 2:00 AM",7,2,5,,,,,,,,,,0,0,0,1,,,,2,2,0,2,3,0,0,0,6,0,0,0,0,0,0,0,0
"Apr 21, 2019 3:00 AM",5,1,4,,,,,,,,,,1,1,0,0,,,,0,0,0,0,1,0,0,0,1,0,2,0,0,0,,,
"Apr 21, 2019 4:00 AM",2,0,2,,,,,,,,,,1,1,0,0,,,,1,1,0,0,1,0,0,0,0,0,0,0,0,0,0,0,0
"Apr 21, 2019 5:00 AM",2,0,2,,,,,,,,,,0,0,0,0,,,,2,1,1,3,3,2,1,1,4,0,0,0,0,0,,,
"Apr 21, 2019 6:00 AM",5,4,1,,,,,,,,,,1,0,1,1,,,,3,3,0,4,4,2,0,2,4,1,2,0,0,0,0,0,0
"Apr 21, 2019 7:00 AM",14,6,8,,,,,,,,,,0,0,0,0,,,,5,2,3,8,11,6,3,3,8,0,2,0,0,0,0,0,0
"Apr 21, 2019 8:00 AM",13,10,3,,,,,,,,,,5,4,1,4,,,,5,4,1,12,25,10,6,4,25,1,6,0,0,0,0,0,0
"Apr 21, 2019 9:00 AM",20,11,9,,,,,,,,,,5,2,3,2,,,,11,9,2,12,35,22,11,11,30,2,1,0,0,0,0,0,0
"Apr 21, 2019 10:00 AM",36,24,12,,,,,,,,,,24,6,18,11,,,,16,11,5,19,24,33,11,22,25,4,2,5,4,1,0,0,0
"Apr 21, 2019 11:00 AM",45,30,15,,,,,,,,,,15,7,8,6,,,,14,13,1,20,40,38,9,29,30,9,6,6,4,2,0,0,0
"Apr 21, 2019 12:00 PM",54,29,25,,,,,,,,,,23,7,16,12,,,,26,24,2,13,50,42,8,34,30,4,3,4,2,2,1,1,0
"Apr 21, 2019 1:00 PM",33,21,12,,,,,,,,,,28,11,17,12,,,,8,7,1,20,40,60,20,40,39,5,7,5,5,0,2,1,1
"Apr 21, 2019 2:00 PM",43,25,18,,,,,,,,,,15,9,6,16,,,,10,10,0,28,35,42,13,29,42,4,6,9,6,3,0,0,0
"Apr 21, 2019 3:00 PM",22,12,10,,,,,,,,,,29,17,12,10,,,,10,8,2,14,31,42,22,20,28,7,4,6,0,6,2,2,0
"Apr 21, 2019 4:00 PM",25,10,15,,,,,,,,,,17,7,10,10,,,,15,15,0,15,12,44,19,25,33,3,4,4,3,1,3,1,2
"Apr 21, 2019 5:00 PM",32,10,22,,,,,,,,,,14,8,6,9,,,,23,20,3,16,19,42,22,20,30,4,1,3,1,2,0,0,0
"Apr 21, 2019 6:00 PM",49,20,29,,,,,,,,,,8,4,4,15,,,,19,15,4,14,18,22,18,4,29,0,0,5,3,2,3,2,1
"Apr 21, 2019 7:00 PM",37,13,24,,,,,,,,,,6,3,3,6,,,,10,10,0,5,15,9,4,5,33,0,3,2,2,0,0,0,0
"Apr 21, 2019 8:00 PM",26,6,20,,,,,,,,,,13,7,6,4,,,,11,11,0,5,9,14,4,10,22,0,0,0,0,0,1,0,1
"Apr 21, 2019 9:00 PM",25,7,18,,,,,,,,,,1,0,1,9,,,,8,8,0,13,5,2,1,1,13,0,0,1,1,0,0,0,0
"Apr 21, 2019 10:00 PM",11,2,9,,,,,,,,,,3,2,1,1,,,,3,2,1,10,5,2,2,0,7,1,0,0,0,0,0,0,0
"Apr 21, 2019 11:00 PM",9,2,7,,,,,,,,,,3,2,1,5,,,,7,7,0,2,5,4,3,1,8,0,1,0,0,0,0,0,0
"Apr 22, 2019 12:00 AM",4,1,3,,,,,,,,,,1,1,0,6,,,,0,0,0,3,1,2,2,0,4,0,0,0,0,0,0,0,0
"Apr 22, 2019 1:00 AM",3,0,3,,,,,,,,,,0,0,0,0,,,,1,1,0,2,2,2,1,1,1,0,1,1,0,1,0,0,0
"Apr 22, 2019 2:00 AM",4,0,4,,,,,,,,,,1,1,0,0,,,,1,1,0,2,2,0,0,0,0,1,0,0,0,0,0,0,0
"Apr 22, 2019 3:00 AM",4,0,4,,,,,,,,,,0,0,0,0,,,,0,0,0,0,2,0,0,0,0,0,0,0,0,0,0,0,0
"Apr 22, 2019 4:00 AM",2,0,2,,,,,,,,,,3,1,2,0,,,,1,1,0,0,0,0,0,0,1,0,0,0,0,0,0,0,0
"Apr 22, 2019 5:00 AM",1,1,0,,,,,,,,,,0,0,0,1,,,,0,0,0,1,3,2,1,1,1,0,0,0,0,0,0,0,0
"Apr 22, 2019 6:00 AM",7,4,3,,,,,,,,,,1,1,0,1,,,,3,3,0,2,7,2,0,2,5,0,1,0,0,0,0,0,0
"Apr 22, 2019 7:00 AM",27,17,10,,,,,,,,,,3,2,1,1,,,,6,5,1,11,8,5,2,3,12,1,1,0,0,0,0,0,0
"Apr 22, 2019 8:00 AM",30,18,12,,,,,,,,,,2,2,0,5,,,,9,6,3,14,15,15,5,10,15,0,5,0,0,0,0,0,0
"Apr 22, 2019 9:00 AM",44,26,18,,,,,,,,,,12,3,9,4,,,,11,6,5,20,17,26,14,12,23,4,8,4,1,3,5,2,3
"Apr 22, 2019 10:00 AM",59,45,14,,,,,,,,,,25,7,18,5,,,,13,10,3,25,29,34,11,23,24,6,12,2,2,0,3,1,2
"Apr 22, 2019 11:00 AM",54,30,24,,,,,,,,,,25,16,9,13,,,,21,13,8,23,37,75,41,34,40,4,8,1,1,0,1,1,0
"Apr 22, 2019 12:00 PM",56,36,20,,,,,,,,,,45,23,22,24,,,,20,16,4,22,50,53,21,32,33,12,3,0,0,0,0,0,0
"Apr 22, 2019 1:00 PM",47,18,29,,,,,,,,,,33,15,18,22,,,,9,7,2,14,34,54,16,38,33,11,7,6,5,1,0,0,0
"Apr 22, 2019 2:00 PM",64,37,27,,,,,,,,,,38,21,17,16,,,,15,13,2,16,52,57,7,50,29,6,1,7,5,2,2,1,1
"Apr 22, 2019 3:00 PM",42,18,24,,,,,,,,,,42,24,18,16,,,,21,16,5,20,31,72,39,33,43,3,4,2,1,1,0,0,0
"Apr 22, 2019 4:00 PM",62,26,36,,,,,,,,,,27,12,15,13,,,,20,20,0,22,22,52,41,11,40,8,0,4,2,2,1,1,0
"Apr 22, 2019 5:00 PM",69,24,45,,,,,,,,,,35,25,10,32,,,,20,18,2,17,18,26,18,8,35,7,5,2,2,0,4,2,2
"Apr 22, 2019 6:00 PM",69,19,50,,,,,,,,,,13,3,10,21,,,,24,20,4,7,14,20,9,11,28,5,4,2,2,0,0,0,0
"Apr 22, 2019 7:00 PM",44,16,28,,,,,,,,,,19,12,7,14,,,,19,18,1,6,14,10,7,3,31,1,1,4,4,0,2,1,1
"Apr 22, 2019 8:00 PM",51,14,37,,,,,,,,,,10,8,2,13,,,,24,24,0,16,13,7,2,5,16,2,3,2,1,1,1,1,0
"Apr 22, 2019 9:00 PM",36,9,27,,,,,,,,,,2,2,0,5,,,,11,10,1,7,5,5,3,2,16,2,0,2,0,2,0,0,0
"Apr 22, 2019 10:00 PM",19,1,18,,,,,,,,,,1,1,0,2,,,,4,4,0,1,7,3,2,1,10,0,0,0,0,0,0,0,0
"Apr 22, 2019 11:00 PM",8,4,4,,,,,,,,,,3,3,0,3,,,,7,6,1,2,2,0,0,0,3,0,1,0,0,0,0,0,0
"Apr 23, 2019 12:00 AM",12,2,10,,,,,,,,,,1,1,0,2,,,,3,3,0,1,1,1,0,1,2,0,0,0,0,0,0,0,0
"Apr 23, 2019 1:00 AM",2,2,0,,,,,,,,,,0,0,0,1,,,,1,1,0,0,0,1,0,1,0,1,0,0,0,0,0,0,0
"Apr 23, 2019 2:00 AM",2,0,2,,,,,,,,,,0,0,0,0,,,,0,0,0,0,1,0,0,0,0,0,0,0,0,0,0,0,0
"Apr 23, 2019 3:00 AM",1,1,0,,,,,,,,,,0,0,0,0,,,,1,1,0,0,0,1,1,0,1,1,0,0,0,0,0,0,0
"Apr 23, 2019 4:00 AM",3,0,3,,,,,,,,,,0,0,0,0,,,,0,0,0,2,0,0,0,0,0,0,0,0,0,0,0,0,0
"Apr 23, 2019 5:00 AM",5,4,1,,,,,,,,,,0,0,0,3,,,,2,2,0,5,4,0,0,0,10,2,0,0,0,0,0,0,0
"Apr 23, 2019 6:00 AM",54,45,9,,,,,,,,,,9,3,6,3,,,,6,4,2,28,16,15,7,8,47,0,1,4,4,0,0,0,0
"Apr 23, 2019 7:00 AM",177,130,47,,,,,,,,,,11,4,7,11,,,,30,23,7,128,39,33,25,8,145,1,0,2,1,1,0,0,0
"Apr 23, 2019 8:00 AM",385,332,53,,,,,,,,,,14,5,9,21,,,,31,21,10,259,53,79,57,22,288,2,7,2,0,2,0,0,0
"Apr 23, 2019 9:00 AM",202,177,25,,,,,,,,,,14,3,11,6,,,,21,11,10,101,21,26,13,13,96,2,4,4,3,1,0,0,0
"Apr 23, 2019 10:00 AM",87,68,19,,,,,,,,,,6,2,4,6,,,,14,5,9,54,14,12,8,4,27,4,5,3,1,2,0,0,0
"Apr 23, 2019 11:00 AM",57,40,17,,,,,,,,,,7,5,2,16,,,,15,10,5,35,9,15,5,10,27,2,2,2,0,2,0,0,0
"Apr 23, 2019 12:00 PM",70,30,40,,,,,,,,,,12,4,8,10,,,,21,18,3,32,14,8,6,2,19,2,1,2,1,1,0,0,0
"Apr 23, 2019 1:00 PM",67,39,28,,,,,,,,,,12,7,5,10,,,,28,24,4,23,18,23,8,15,30,3,0,0,0,0,0,0,0
"Apr 23, 2019 2:00 PM",80,30,50,,,,,,,,,,17,10,7,21,,,,27,24,3,13,26,15,2,13,16,3,5,3,2,1,0,0,0
"Apr 23, 2019 3:00 PM",96,27,69,,,,,,,,,,19,10,9,6,,,,36,34,2,20,28,24,5,19,21,8,3,7,3,4,0,0,0
"Apr 23, 2019 4:00 PM",149,49,100,,,,,,,,,,27,20,7,23,,,,83,82,1,23,83,50,15,35,31,4,3,3,2,1,0,0,0
"Apr 23, 2019 5:00 PM",319,62,257,,,,,,,,,,33,14,19,19,,,,170,169,1,35,180,101,20,81,81,5,1,6,4,2,0,0,0
"Apr 23, 2019 6:00 PM",292,56,236,,,,,,,,,,36,27,9,30,,,,178,176,2,39,142,77,13,64,63,6,1,5,5,0,0,0,0
"Apr 23, 2019 7:00 PM",189,42,147,,,,,,,,,,11,8,3,22,,,,58,56,2,28,66,32,8,24,33,3,1,6,3,3,0,0,0
"Apr 23, 2019 8:00 PM",125,31,94,,,,,,,,,,22,15,7,15,,,,68,65,3,22,39,19,8,11,12,1,1,3,0,3,0,0,0
"Apr 23, 2019 9:00 PM",96,11,85,,,,,,,,,,7,4,3,4,,,,43,43,0,15,27,7,2,5,16,0,1,2,1,1,0,0,0
"Apr 23, 2019 10:00 PM",53,7,46,,,,,,,,,,3,2,1,8,,,,37,35,2,5,10,7,2,5,14,0,0,0,0,0,0,0,0
"Apr 23, 2019 11:00 PM",20,5,15,,,,,,,,,,2,1,1,3,,,,10,9,1,2,6,2,1,1,4,0,1,0,0,0,0,0,0
"Apr 24, 2019 12:00 AM",3,1,2,,,,,,,,,,0,0,0,5,,,,4,4,0,5,4,0,0,0,0,1,0,2,1,1,0,0,0
"Apr 24, 2019 1:00 AM",4,1,3,,,,,,,,,,1,1,0,0,,,,2,2,0,1,1,2,1,1,0,0,0,0,0,0,0,0,0
"Apr 24, 2019 2:00 AM",1,1,0,,,,,,,,,,0,0,0,0,,,,0,0,0,0,1,0,0,0,0,0,0,0,0,0,0,0,0
"Apr 24, 2019 3:00 AM",2,1,1,,,,,,,,,,1,1,0,0,,,,1,1,0,0,1,0,0,0,0,1,0,0,0,0,0,0,0
"Apr 24, 2019 4:00 AM",2,1,1,,,,,,,,,,1,0,1,0,,,,1,1,0,2,0,0,0,0,0,0,0,0,0,0,0,0,0
"Apr 24, 2019 5:00 AM",9,8,1,,,,,,,,,,0,0,0,5,,,,3,2,1,8,3,0,0,0,9,2,0,0,0,0,0,0,0
"Apr 24, 2019 6:00 AM",63,54,9,,,,,,,,,,3,2,1,6,,,,3,2,1,34,17,13,9,4,52,1,2,2,1,1,0,0,0
"Apr 24, 2019 7:00 AM",193,151,42,,,,,,,,,,15,4,11,16,,,,33,18,15,139,39,40,31,9,148,0,4,4,4,0,0,0,0
"Apr 24, 2019 8:00 AM",386,333,53,,,,,,,,,,12,6,6,12,,,,30,19,11,250,67,88,66,22,283,1,7,4,2,2,0,0,0
"Apr 24, 2019 9:00 AM",225,202,23,,,,,,,,,,11,5,6,10,,,,21,8,13,110,30,34,20,14,97,4,6,4,2,2,0,0,0
"Apr 24, 2019 10:00 AM",94,75,19,,,,,,,,,,9,7,2,10,,,,25,17,8,41,10,7,3,4,30,4,1,5,5,0,0,0,0
"Apr 24, 2019 11:00 AM",72,51,21,,,,,,,,,,25,14,11,10,,,,15,12,3,33,9,17,10,7,23,6,0,1,1,0,0,0,0
"Apr 24, 2019 12:00 PM",78,43,35,,,,,,,,,,19,7,12,14,,,,19,12,7,27,13,12,0,12,14,1,2,4,3,1,0,0,0
"Apr 24, 2019 1:00 PM",88,41,47,,,,,,,,,,16,7,9,8,,,,25,22,3,18,23,20,8,12,26,1,3,3,1,2,0,0,0
"Apr 24, 2019 2:00 PM",87,32,55,,,,,,,,,,28,23,5,18,,,,17,16,1,17,28,12,6,6,15,2,2,4,1,3,0,0,0
"Apr 24, 2019 3:00 PM",77,25,52,,,,,,,,,,13,11,2,12,,,,40,36,4,19,24,19,8,11,17,4,2,6,5,1,0,0,0
"Apr 24, 2019 4:00 PM",122,22,100,,,,,,,,,,11,9,2,13,,,,51,49,2,15,66,28,5,23,27,2,1,4,4,0,0,0,0
"Apr 24, 2019 5:00 PM",280,52,228,,,,,,,,,,10,7,3,17,,,,129,126,3,20,148,49,10,39,67,5,1,4,1,3,0,0,0
"Apr 24, 2019 6:00 PM",250,43,207,,,,,,,,,,15,13,2,15,,,,147,147,0,30,144,65,6,59,42,2,3,1,1,0,0,0,0
"Apr 24, 2019 7:00 PM",166,31,135,,,,,,,,,,5,1,4,8,,,,80,79,1,17,64,37,1,36,25,3,0,4,3,1,0,0,0
"Apr 24, 2019 8:00 PM",102,13,89,,,,,,,,,,0,0,0,5,,,,42,41,1,14,30,9,1,8,9,0,0,1,1,0,0,0,0
"Apr 24, 2019 9:00 PM",83,8,75,,,,,,,,,,4,3,1,5,,,,31,30,1,7,23,11,3,8,10,0,0,0,0,0,0,0,0
"Apr 24, 2019 10:00 PM",56,7,49,,,,,,,,,,6,5,1,3,,,,26,26,0,0,14,4,1,3,9,0,0,0,0,0,0,0,0
"Apr 24, 2019 11:00 PM",23,3,20,,,,,,,,,,2,1,1,1,,,,13,12,1,2,4,3,1,2,6,0,2,0,0,0,0,0,0
"Apr 25, 2019 12:00 AM",8,1,7,,,,,,,,,,1,1,0,1,,,,12,12,0,2,3,1,1,0,2,0,2,0,0,0,0,0,0
"Apr 25, 2019 1:00 AM",3,1,2,,,,,,,,,,0,0,0,2,,,,2,2,0,0,1,0,0,0,0,0,1,0,0,0,0,0,0
"Apr 25, 2019 2:00 AM",1,0,1,,,,,,,,,,0,0,0,0,,,,1,1,0,0,3,0,0,0,0,1,0,0,0,0,0,0,0
"Apr 25, 2019 3:00 AM",5,1,4,,,,,,,,,,0,0,0,0,,,,2,2,0,1,1,0,0,0,0,0,0,0,0,0,0,0,0
"Apr 25, 2019 4:00 AM",3,1,2,,,,,,,,,,1,0,1,0,,,,2,2,0,1,0,0,0,0,1,0,0,0,0,0,,,
"Apr 25, 2019 5:00 AM",6,4,2,,,,,,,,,,0,0,0,3,,,,1,1,0,11,1,0,0,0,8,2,0,0,0,0,0,0,0
"Apr 25, 2019 6:00 AM",59,48,11,,,,,,,,,,6,0,6,7,,,,5,2,3,26,13,10,7,3,37,1,3,2,1,1,0,0,0
"Apr 25, 2019 7:00 AM",183,149,34,,,,,,,,,,11,5,6,8,,,,20,14,6,122,29,41,32,9,139,0,3,4,3,1,0,0,0
"Apr 25, 2019 8:00 AM",326,277,49,,,,,,,,,,13,3,10,13,,,,27,14,13,214,51,68,53,15,227,3,5,2,0,2,0,0,0
"Apr 25, 2019 9:00 AM",176,154,22,,,,,,,,,,9,3,6,14,,,,24,13,11,89,21,16,10,6,82,2,4,1,0,1,0,0,0
"Apr 25, 2019 10:00 AM",83,62,21,,,,,,,,,,7,2,5,4,,,,9,6,3,49,11,5,3,2,20,1,0,0,0,0,0,0,0
"Apr 25, 2019 11:00 AM",52,33,19,,,,,,,,,,9,6,3,4,,,,13,11,2,20,12,5,1,4,13,0,1,4,2,2,0,0,0
"Apr 25, 2019 12:00 PM",59,24,35,,,,,,,,,,9,3,6,1,,,,16,12,4,13,7,14,6,8,19,0,1,1,1,0,0,0,0
"Apr 25, 2019 1:00 PM",45,22,23,,,,,,,,,,5,2,3,4,,,,12,9,3,9,10,5,2,3,14,4,0,0,0,0,0,0,0
"Apr 25, 2019 2:00 PM",44,19,25,,,,,,,,,,14,7,7,5,,,,19,15,4,10,20,3,0,3,12,2,3,2,2,0,0,0,0
"Apr 25, 2019 3:00 PM",64,26,38,,,,,,,,,,13,6,7,12,,,,34,33,1,23,22,9,3,6,19,3,2,2,2,0,0,0,0
"Apr 25, 2019 4:00 PM",130,34,96,,,,,,,,,,14,12,2,13,,,,62,61,1,18,57,27,4,23,33,2,1,4,3,1,0,0,0
"Apr 25, 2019 5:00 PM",295,49,246,,,,,,,,,,17,11,6,9,,,,121,119,2,35,149,69,10,59,57,6,3,6,4,2,0,0,0
"Apr 25, 2019 6:00 PM",213,43,170,,,,,,,,,,22,18,4,16,,,,142,140,2,28,124,59,7,52,41,3,4,2,1,1,0,0,0
"Apr 25, 2019 7:00 PM",143,31,112,,,,,,,,,,8,7,1,13,,,,81,78,3,9,67,32,4,28,26,2,2,4,0,4,0,0,0
"Apr 25, 2019 8:00 PM",114,22,92,,,,,,,,,,13,6,7,6,,,,48,48,0,12,27,11,1,10,25,1,1,4,3,1,0,0,0
"Apr 25, 2019 9:00 PM",58,7,51,,,,,,,,,,7,5,2,5,,,,26,24,2,9,17,4,1,3,9,1,0,1,1,0,0,0,0
"Apr 25, 2019 10:00 PM",45,7,38,,,,,,,,,,3,3,0,2,,,,14,14,0,1,10,5,0,5,8,1,0,0,0,0,0,0,0
"Apr 25, 2019 11:00 PM",22,4,18,,,,,,,,,,1,1,0,2,,,,7,6,1,4,8,0,0,0,3,0,0,0,0,0,0,0,0
"Apr 26, 2019 12:00 AM",12,4,8,,,,,,,,,,6,6,0,0,,,,8,8,0,3,5,2,0,2,3,0,1,0,0,0,0,0,0
"Apr 26, 2019 1:00 AM",2,0,2,,,,,,,,,,0,0,0,0,,,,3,3,0,2,1,0,0,0,0,1,0,0,0,0,0,0,0
"Apr 26, 2019 2:00 AM",7,1,6,,,,,,,,,,0,0,0,0,,,,3,3,0,0,2,0,0,0,0,0,0,0,0,0,0,0,0
"Apr 26, 2019 3:00 AM",5,2,3,,,,,,,,,,0,0,0,0,,,,0,0,0,0,1,0,0,0,2,0,0,0,0,0,0,0,0
"Apr 26, 2019 4:00 AM",3,1,2,,,,,,,,,,1,0,1,0,,,,1,1,0,0,0,0,0,0,0,1,0,0,0,0,0,0,0
"Apr 26, 2019 5:00 AM",8,5,3,,,,,,,,,,0,0,0,2,,,,2,2,0,7,4,1,1,0,8,1,0,0,0,0,0,0,0
"Apr 26, 2019 6:00 AM",40,34,6,,,,,,,,,,3,0,3,4,,,,3,3,0,16,13,3,3,0,33,1,0,0,0,0,0,0,0
"Apr 26, 2019 7:00 AM",105,83,22,,,,,,,,,,6,1,5,5,,,,20,15,5,74,19,14,11,3,82,2,4,3,2,1,0,0,0
"Apr 26, 2019 8:00 AM",228,190,38,,,,,,,,,,6,2,4,11,,,,21,11,10,145,29,42,32,10,154,0,3,2,0,2,0,0,0
"Apr 26, 2019 9:00 AM",153,130,23,,,,,,,,,,16,6,10,5,,,,22,12,10,80,14,21,13,8,74,2,7,2,1,1,0,0,0
"Apr 26, 2019 10:00 AM",76,60,16,,,,,,,,,,12,2,10,7,,,,12,7,5,53,10,11,5,6,24,2,4,3,2,1,0,0,0
"Apr 26, 2019 11:00 AM",55,35,20,,,,,,,,,,8,6,2,4,,,,15,13,2,26,9,6,2,4,14,3,3,4,2,2,0,0,0
"Apr 26, 2019 12:00 PM",59,22,37,,,,,,,,,,13,3,10,12,,,,25,23,2,25,14,14,4,10,19,3,2,2,1,1,0,0,0
"Apr 26, 2019 1:00 PM",75,32,43,,,,,,,,,,11,6,5,3,,,,23,19,4,16,12,13,3,10,20,5,2,1,1,0,0,0,0
"Apr 26, 2019 2:00 PM",64,31,33,,,,,,,,,,11,6,5,8,,,,22,18,4,16,15,12,3,9,12,2,4,2,1,1,0,0,0
"Apr 26, 2019 3:00 PM",63,16,47,,,,,,,,,,8,4,4,7,,,,38,33,5,16,22,13,3,10,14,5,1,1,1,0,0,0,0
"Apr 26, 2019 4:00 PM",121,24,97,,,,,,,,,,4,3,1,6,,,,54,50,4,9,41,28,3,25,34,2,0,3,3,0,0,0,0
"Apr 26, 2019 5:00 PM",215,40,175,,,,,,,,,,18,13,5,7,,,,97,95,2,24,114,52,10,42,37,4,2,5,3,2,0,0,0
"Apr 26, 2019 6:00 PM",171,24,147,,,,,,,,,,16,13,3,19,,,,124,119,5,15,65,41,4,37,26,6,0,5,2,3,0,0,0
"Apr 26, 2019 7:00 PM",85,22,63,,,,,,,,,,4,2,2,8,,,,45,45,0,10,34,22,2,20,13,1,1,3,3,0,0,0,0
"Apr 26, 2019 8:00 PM",52,15,37,,,,,,,,,,5,5,0,9,,,,29,24,5,8,24,5,1,4,10,1,1,0,0,0,0,0,0
"Apr 26, 2019 9:00 PM",46,8,38,,,,,,,,,,3,2,1,3,,,,23,22,1,8,12,3,2,1,5,0,0,4,2,2,0,0,0
"Apr 26, 2019 10:00 PM",27,4,23,,,,,,,,,,3,2,1,1,,,,8,8,0,4,3,0,0,0,11,0,0,0,0,0,0,0,0
"Apr 26, 2019 11:00 PM",20,7,13,,,,,,,,,,0,0,0,1,,,,8,7,1,1,4,1,1,0,10,0,0,1,0,1,0,0,0
"Apr 27, 2019 12:00 AM",8,4,4,,,,,,,,,,0,0,0,2,,,,6,5,1,0,2,4,2,2,1,1,0,0,0,0,0,0,0
"Apr 27, 2019 1:00 AM",5,0,5,,,,,,,,,,3,0,3,0,,,,2,2,0,2,1,1,0,1,1,0,1,0,0,0,0,0,0
"Apr 27, 2019 2:00 AM",2,2,0,,,,,,,,,,0,0,0,0,,,,2,2,0,1,3,0,0,0,1,0,0,0,0,0,0,0,0
"Apr 27, 2019 3:00 AM",0,0,0,,,,,,,,,,1,1,0,0,,,,2,2,0,0,1,0,0,0,0,1,2,0,0,0,0,0,0
"Apr 27, 2019 4:00 AM",3,1,2,,,,,,,,,,1,0,1,0,,,,0,0,0,1,0,0,0,0,0,0,0,0,0,0,0,0,0
"Apr 27, 2019 5:00 AM",1,0,1,,,,,,,,,,0,0,0,0,,,,1,1,0,0,2,1,1,0,3,0,0,0,0,0,,,
"Apr 27, 2019 6:00 AM",6,4,2,,,,,,,,,,1,0,1,0,,,,0,0,0,2,1,1,0,1,0,0,0,0,0,0,,,
"Apr 27, 2019 7:00 AM",20,12,8,,,,,,,,,,0,0,0,0,,,,1,1,0,2,6,1,1,0,7,0,0,0,0,0,0,0,0
"Apr 27, 2019 8:00 AM",39,22,17,,,,,,,,,,2,1,1,2,,,,5,2,3,14,9,4,1,3,14,0,1,2,2,0,0,0,0
"Apr 27, 2019 9:00 AM",32,22,10,,,,,,,,,,6,0,6,7,,,,7,5,2,9,11,6,3,3,15,1,1,1,0,1,0,0,0
"Apr 27, 2019 10:00 AM",39,26,13,,,,,,,,,,11,5,6,3,,,,10,5,5,11,8,3,0,3,5,0,2,4,1,3,0,0,0
"Apr 27, 2019 11:00 AM",31,23,8,,,,,,,,,,7,3,4,5,,,,15,13,2,12,6,11,1,10,13,0,2,1,0,1,0,0,0
"Apr 27, 2019 12:00 PM",25,11,14,,,,,,,,,,11,8,3,3,,,,8,6,2,9,10,6,2,4,9,2,0,2,2,0,0,0,0
"Apr 27, 2019 1:00 PM",38,27,11,,,,,,,,,,8,5,3,8,,,,7,5,2,16,15,4,1,3,11,2,0,5,1,4,0,0,0
"Apr 27, 2019 2:00 PM",29,16,13,,,,,,,,,,10,3,7,2,,,,11,9,2,11,9,7,1,6,15,0,1,2,0,2,0,0,0
"Apr 27, 2019 3:00 PM",31,19,12,,,,,,,,,,9,6,3,9,,,,11,9,2,8,7,10,3,7,13,0,2,1,1,0,0,0,0
"Apr 27, 2019 4:00 PM",33,11,22,,,,,,,,,,16,11,5,14,,,,18,16,2,9,10,22,6,16,6,2,2,1,0,1,,,
"Apr 27, 2019 5:00 PM",55,22,33,,,,,,,,,,26,9,17,16,,,,10,9,1,7,11,8,5,3,10,1,0,5,3,2,0,0,0
"Apr 27, 2019 6:00 PM",37,14,23,,,,,,,,,,16,14,2,4,,,,8,8,0,7,12,11,5,6,12,1,1,6,3,3,0,0,0
"Apr 27, 2019 7:00 PM",37,22,15,,,,,,,,,,7,4,3,10,,,,12,12,0,4,5,6,1,5,8,2,0,4,1,3,0,0,0
"Apr 27, 2019 8:00 PM",44,10,34,,,,,,,,,,10,4,6,1,,,,11,8,3,5,3,2,0,2,11,1,0,0,0,0,0,0,0
"Apr 27, 2019 9:00 PM",19,7,12,,,,,,,,,,8,6,2,1,,,,10,9,1,4,4,3,3,0,3,0,0,0,0,0,0,0,0
"Apr 27, 2019 10:00 PM",13,7,6,,,,,,,,,,0,0,0,1,,,,2,2,0,5,6,5,1,4,3,0,0,1,0,1,0,0,0
"Apr 27, 2019 11:00 PM",12,6,6,,,,,,,,,,6,6,0,4,,,,6,6,0,6,2,1,0,1,4,0,0,0,0,0,0,0,0
"Apr 28, 2019 12:00 AM",5,2,3,,,,,,,,,,5,0,5,1,,,,4,4,0,2,2,1,1,0,4,0,1,1,1,0,0,0,0
"Apr 28, 2019 1:00 AM",3,0,3,,,,,,,,,,0,0,0,2,,,,2,2,0,2,1,0,0,0,1,2,3,0,0,0,0,0,0
"Apr 28, 2019 2:00 AM",5,1,4,,,,,,,,,,1,0,1,0,,,,3,3,0,1,2,0,0,0,1,0,2,0,0,0,0,0,0
"Apr 28, 2019 3:00 AM",6,2,4,,,,,,,,,,0,0,0,0,,,,3,3,0,0,0,1,1,0,0,0,0,0,0,0,0,0,0
"Apr 28, 2019 4:00 AM",1,0,1,,,,,,,,,,2,0,2,0,,,,2,2,0,0,0,0,0,0,1,0,0,0,0,0,0,0,0
"Apr 28, 2019 5:00 AM",4,0,4,,,,,,,,,,0,0,0,0,,,,0,0,0,0,2,3,1,2,1,0,0,1,0,1,0,0,0
"Apr 28, 2019 6:00 AM",9,5,4,,,,,,,,,,1,0,1,2,,,,5,4,1,0,5,0,0,0,5,2,0,0,0,0,0,0,0
"Apr 28, 2019 7:00 AM",11,6,5,,,,,,,,,,3,3,0,1,,,,5,3,2,5,8,3,2,1,11,0,0,0,0,0,0,0,0
"Apr 28, 2019 8:00 AM",20,11,9,,,,,,,,,,5,2,3,2,,,,5,3,2,13,19,7,2,5,14,1,9,1,0,1,0,0,0
"Apr 28, 2019 9:00 AM",34,26,8,,,,,,,,,,4,1,3,3,,,,15,11,4,19,34,21,9,12,23,4,10,0,0,0,0,0,0
"Apr 28, 2019 10:00 AM",34,23,11,,,,,,,,,,7,1,6,8,,,,9,6,3,15,21,36,18,18,80,6,4,1,1,0,0,0,0
"Apr 28, 2019 11:00 AM",44,33,11,,,,,,,,,,6,2,4,12,,,,9,8,1,13,18,25,12,13,28,7,3,0,0,0,0,0,0
"Apr 28, 2019 12:00 PM",44,29,15,,,,,,,,,,23,8,15,15,,,,20,18,2,16,26,27,11,16,18,3,1,4,4,0,0,0,0
"Apr 28, 2019 1:00 PM",33,15,18,,,,,,,,,,17,11,6,8,,,,21,18,3,22,28,34,12,22,29,5,3,2,1,1,0,0,0
"Apr 28, 2019 2:00 PM",43,20,23,,,,,,,,,,26,11,15,11,,,,12,9,3,16,15,15,3,12,24,2,2,3,1,2,0,0,0
"Apr 28, 2019 3:00 PM",49,25,24,,,,,,,,,,29,15,14,14,,,,18,13,5,13,23,18,7,11,18,2,2,5,4,1,0,0,0
"Apr 28, 2019 4:00 PM",42,14,28,,,,,,,,,,21,13,8,8,,,,19,17,2,20,25,13,6,7,15,8,0,3,3,0,,,
"Apr 28, 2019 5:00 PM",56,15,41,,,,,,,,,,20,9,11,14,,,,18,14,4,5,19,16,9,7,14,2,2,0,0,0,0,0,0
"Apr 28, 2019 6:00 PM",27,5,22,,,,,,,,,,4,2,2,21,,,,24,22,2,14,10,18,8,10,19,2,0,0,0,0,0,0,0
"Apr 28, 2019 7:00 PM",40,18,22,,,,,,,,,,2,2,0,7,,,,12,11,1,4,13,7,4,3,25,0,0,0,0,0,0,0,0
"Apr 28, 2019 8:00 PM",39,10,29,,,,,,,,,,1,1,0,1,,,,17,16,1,9,6,9,3,6,11,2,0,4,3,1,0,0,0
"Apr 28, 2019 9:00 PM",28,6,22,,,,,,,,,,1,0,1,3,,,,7,7,0,4,1,4,0,4,10,0,0,1,0,1,0,0,0
"Apr 28, 2019 10:00 PM",22,7,15,,,,,,,,,,2,2,0,0,,,,7,7,0,5,4,1,1,0,12,2,0,0,0,0,0,0,0
"Apr 28, 2019 11:00 PM",8,4,4,,,,,,,,,,3,3,0,3,,,,3,3,0,5,3,0,0,0,2,0,1,0,0,0,0,0,0
"Apr 29, 2019 12:00 AM",9,4,5,,,,,,,,,,0,0,0,0,,,,4,3,1,0,1,0,0,0,1,0,0,0,0,0,0,0,0
"Apr 29, 2019 1:00 AM",4,0,4,,,,,,,,,,0,0,0,0,,,,2,2,0,0,0,0,0,0,0,0,0,2,1,1,0,0,0
"Apr 29, 2019 2:00 AM",1,0,1,,,,,,,,,,0,0,0,0,,,,1,1,0,0,3,0,0,0,0,0,0,0,0,0,0,0,0
"Apr 29, 2019 3:00 AM",2,1,1,,,,,,,,,,0,0,0,0,,,,0,0,0,0,0,4,1,3,0,1,0,0,0,0,0,0,0
"Apr 29, 2019 4:00 AM",2,0,2,,,,,,,,,,3,0,3,0,,,,0,0,0,0,0,0,0,0,0,0,0,0,0,0,0,0,0
"Apr 29, 2019 5:00 AM",9,7,2,,,,,,,,,,0,0,0,1,,,,0,0,0,6,5,0,0,0,10,2,0,0,0,0,0,0,0
"Apr 29, 2019 6:00 AM",53,43,10,,,,,,,,,,5,0,5,6,,,,2,0,2,35,14,15,11,4,48,3,0,6,5,1,0,0,0
"Apr 29, 2019 7:00 AM",203,163,40,,,,,,,,,,4,1,3,13,,,,28,22,6,135,30,42,34,8,145,5,6,5,3,2,0,0,0
"Apr 29, 2019 8:00 AM",401,324,77,,,,,,,,,,23,5,18,29,,,,53,35,18,268,68,100,82,18,328,9,1,13,11,2,0,0,0
"Apr 29, 2019 9:00 AM",181,154,27,,,,,,,,,,13,3,10,13,,,,21,12,9,101,26,29,19,10,103,4,1,5,3,2,0,0,0
"Apr 29, 2019 10:00 AM",71,55,16,,,,,,,,,,7,1,6,6,,,,13,11,2,34,6,12,9,3,30,2,0,1,1,0,0,0,0
"Apr 29, 2019 11:00 AM",41,26,15,,,,,,,,,,9,3,6,10,,,,6,4,2,21,10,7,3,4,18,0,1,0,0,0,0,0,0
"Apr 29, 2019 12:00 PM",59,31,28,,,,,,,,,,11,7,4,6,,,,17,15,2,28,9,15,5,10,24,5,0,2,2,0,0,0,0
"Apr 29, 2019 1:00 PM",61,28,33,,,,,,,,,,11,6,5,6,,,,23,22,1,21,11,11,3,8,25,2,0,3,2,1,0,0,0
"Apr 29, 2019 2:00 PM",54,31,23,,,,,,,,,,8,5,3,8,,,,13,13,0,16,23,13,3,10,15,0,1,1,1,0,0,0,0
"Apr 29, 2019 3:00 PM",56,16,40,,,,,,,,,,9,4,5,19,,,,32,30,2,22,22,20,2,18,19,5,4,7,2,5,0,0,0
"Apr 29, 2019 4:00 PM",142,41,101,,,,,,,,,,14,10,4,25,,,,58,56,2,28,76,30,7,23,29,2,3,5,3,2,0,0,0
"Apr 29, 2019 5:00 PM",337,62,275,,,,,,,,,,13,10,3,19,,,,153,152,1,36,174,79,13,66,81,7,1,6,5,1,0,0,0
"Apr 29, 2019 6:00 PM",320,55,265,,,,,,,,,,17,12,5,16,,,,196,192,4,32,165,94,14,80,45,3,5,1,1,0,0,0,0
"Apr 29, 2019 7:00 PM",157,34,123,,,,,,,,,,13,12,1,12,,,,83,82,1,16,69,35,2,33,22,3,4,8,3,5,0,0,0
"Apr 29, 2019 8:00 PM",88,19,69,,,,,,,,,,6,3,3,2,,,,47,47,0,12,16,21,4,17,12,2,0,0,0,0,0,0,0
"Apr 29, 2019 9:00 PM",85,12,73,,,,,,,,,,3,2,1,5,,,,28,28,0,9,14,9,2,7,7,1,0,1,1,0,0,0,0
"Apr 29, 2019 10:00 PM",45,12,33,,,,,,,,,,1,1,0,1,,,,18,18,0,3,22,3,1,2,10,0,1,2,1,1,0,0,0
"Apr 29, 2019 11:00 PM",22,1,21,,,,,,,,,,0,0,0,2,,,,11,11,0,4,3,0,0,0,1,0,0,0,0,0,0,0,0
"Apr 30, 2019 12:00 AM",4,1,3,,,,,,,,,,1,0,1,1,,,,8,6,2,1,3,1,0,1,1,0,1,0,0,0,0,0,0
"Apr 30, 2019 1:00 AM",4,0,4,,,,,,,,,,0,0,0,0,,,,2,2,0,0,3,0,0,0,1,0,0,0,0,0,0,0,0
"Apr 30, 2019 2:00 AM",2,0,2,,,,,,,,,,0,0,0,0,,,,2,2,0,0,2,0,0,0,0,1,0,0,0,0,0,0,0
"Apr 30, 2019 3:00 AM",2,1,1,,,,,,,,,,0,0,0,0,,,,2,2,0,0,0,0,0,0,0,0,0,0,0,0,0,0,0
"Apr 30, 2019 4:00 AM",3,1,2,,,,,,,,,,1,0,1,0,,,,0,0,0,0,0,2,2,0,3,0,0,0,0,0,0,0,0
"Apr 30, 2019 5:00 AM",8,6,2,,,,,,,,,,0,0,0,1,,,,2,1,1,9,6,1,1,0,16,2,0,1,0,1,0,0,0
"Apr 30, 2019 6:00 AM",57,49,8,,,,,,,,,,8,2,6,7,,,,7,5,2,29,17,12,11,1,45,2,1,1,1,0,0,0,0
"Apr 30, 2019 7:00 AM",210,167,43,,,,,,,,,,8,4,4,10,,,,31,28,3,112,38,30,22,8,142,3,5,5,4,1,0,0,0
"Apr 30, 2019 8:00 AM",371,303,68,,,,,,,,,,16,3,13,26,,,,49,30,19,252,57,80,63,17,308,7,0,15,11,4,0,0,0
"Apr 30, 2019 9:00 AM",217,184,33,,,,,,,,,,12,4,8,7,,,,28,16,12,95,22,33,18,15,82,1,4,1,0,1,0,0,0
"Apr 30, 2019 10:00 AM",70,49,21,,,,,,,,,,8,3,5,9,,,,9,4,5,30,9,7,4,3,22,0,0,0,0,0,0,0,0
"Apr 30, 2019 11:00 AM",39,26,13,,,,,,,,,,2,1,1,2,,,,14,10,4,19,8,11,4,7,22,2,0,1,0,1,0,0,0
"Apr 30, 2019 12:00 PM",46,18,28,,,,,,,,,,14,11,3,6,,,,8,8,0,18,11,7,4,3,19,0,1,1,0,1,0,0,0
"Apr 30, 2019 1:00 PM",64,32,32,,,,,,,,,,9,2,7,8,,,,17,13,4,21,18,11,2,9,14,0,1,0,0,0,0,0,0
"Apr 30, 2019 2:00 PM",61,27,34,,,,,,,,,,12,7,5,5,,,,25,21,4,7,13,20,5,15,17,0,1,3,1,2,0,0,0
"Apr 30, 2019 3:00 PM",62,23,39,,,,,,,,,,14,6,8,9,,,,27,24,3,20,19,7,1,6,24,5,2,8,3,5,0,0,0
"Apr 30, 2019 4:00 PM",120,35,85,,,,,,,,,,9,6,3,25,,,,58,56,2,22,52,28,5,23,28,6,0,6,5,1,0,0,0
"Apr 30, 2019 5:00 PM",291,59,232,,,,,,,,,,15,10,5,21,,,,141,138,3,47,156,76,11,65,76,8,4,5,4,1,0,0,0
"Apr 30, 2019 6:00 PM",324,59,265,,,,,,,,,,17,14,3,28,,,,188,185,3,33,136,89,12,77,63,5,3,7,4,3,0,0,0
"Apr 30, 2019 7:00 PM",178,34,144,,,,,,,,,,8,5,3,23,,,,71,67,4,14,69,35,7,28,23,3,2,0,0,0,0,0,0
"Apr 30, 2019 8:00 PM",105,24,81,,,,,,,,,,4,3,1,6,,,,39,39,0,14,28,12,4,8,14,4,0,3,1,2,0,0,0
"Apr 30, 2019 9:00 PM",65,8,57,,,,,,,,,,2,0,2,6,,,,31,29,2,10,25,5,0,5,15,1,0,1,0,1,0,0,0
"Apr 30, 2019 10:00 PM",52,7,45,,,,,,,,,,8,6,2,4,,,,30,29,1,4,10,4,1,3,11,0,1,0,0,0,0,0,0
"Apr 30, 2019 11:00 PM",17,1,16,,,,,,,,,,1,1,0,2,,,,11,10,1,3,7,3,0,3,3,1,0,0,0,0,0,0,0
"May 1, 2019 12:00 AM",11,2,9,,,,,,,,,,0,0,0,0,,,,4,4,0,2,1,0,0,0,2,0,0,0,0,0,0,0,0
"May 1, 2019 1:00 AM",8,2,6,,,,,,,,,,0,0,0,0,,,,2,2,0,3,2,0,0,0,1,0,1,0,0,0,0,0,0
"May 1, 2019 2:00 AM",5,2,3,,,,,,,,,,0,0,0,0,,,,1,1,0,0,0,0,0,0,0,0,0,1,0,1,0,0,0
"May 1, 2019 3:00 AM",1,1,0,,,,,,,,,,0,0,0,0,,,,4,3,1,0,0,1,0,1,1,0,0,0,0,0,0,0,0
"May 1, 2019 4:00 AM",1,0,1,,,,,,,,,,1,0,1,0,,,,1,1,0,0,0,0,0,0,0,0,0,0,0,0,0,0,0
"May 1, 2019 5:00 AM",9,6,3,,,,,,,,,,0,0,0,1,,,,1,0,1,5,8,0,0,0,10,2,0,0,0,0,0,0,0
"May 1, 2019 6:00 AM",65,52,13,,,,,,,,,,8,2,6,6,,,,5,2,3,42,19,16,11,5,51,1,1,3,2,1,0,0,0
"May 1, 2019 7:00 AM",234,184,50,,,,,,,,,,10,4,6,13,,,,30,22,8,135,32,40,30,10,190,3,2,7,5,2,0,0,0
"May 1, 2019 8:00 AM",383,321,62,,,,,,,,,,27,5,22,23,,,,54,32,22,287,66,103,79,24,369,8,6,10,8,2,0,0,0
"May 1, 2019 9:00 AM",213,178,35,,,,,,,,,,16,3,13,17,,,,24,16,8,114,36,44,31,13,112,8,5,8,2,6,0,0,0
"May 1, 2019 10:00 AM",77,59,18,,,,,,,,,,3,1,2,6,,,,20,13,7,44,9,18,11,7,37,6,4,4,2,2,0,0,0
"May 1, 2019 11:00 AM",74,52,22,,,,,,,,,,13,5,8,6,,,,17,15,2,25,9,14,6,8,28,2,4,0,0,0,0,0,0
"May 1, 2019 12:00 PM",70,44,26,,,,,,,,,,15,9,6,8,,,,25,21,4,24,23,20,8,12,30,4,4,2,1,1,0,0,0
"May 1, 2019 1:00 PM",86,46,40,,,,,,,,,,16,9,7,9,,,,28,20,8,23,31,24,5,19,28,4,1,5,1,4,0,0,0
"May 1, 2019 2:00 PM",72,36,36,,,,,,,,,,14,7,7,13,,,,28,24,4,12,27,16,4,12,25,2,3,7,4,3,0,0,0
"May 1, 2019 3:00 PM",74,21,53,,,,,,,,,,15,10,5,6,,,,37,35,2,20,32,20,9,11,21,2,3,1,0,1,0,0,0
"May 1, 2019 4:00 PM",145,34,111,,,,,,,,,,13,10,3,8,,,,50,48,2,17,82,38,6,32,28,5,2,3,1,2,0,0,0
"May 1, 2019 5:00 PM",340,71,269,,,,,,,,,,13,9,4,27,,,,169,165,4,51,189,92,16,76,88,10,4,6,2,4,0,0,0
"May 1, 2019 6:00 PM",309,56,253,,,,,,,,,,24,15,9,27,,,,205,201,4,45,178,96,9,87,65,3,9,10,6,4,0,0,0
"May 1, 2019 7:00 PM",171,35,136,,,,,,,,,,13,7,6,13,,,,84,81,3,26,71,50,15,35,44,1,5,7,3,4,0,0,0
"May 1, 2019 8:00 PM",129,28,101,,,,,,,,,,9,9,0,13,,,,62,59,3,10,35,18,2,16,25,4,3,2,0,2,0,0,0
"May 1, 2019 9:00 PM",69,11,58,,,,,,,,,,4,4,0,9,,,,33,33,0,15,23,9,1,8,15,4,0,4,3,1,0,0,0
"May 1, 2019 10:00 PM",48,11,37,,,,,,,,,,4,4,0,4,,,,28,28,0,3,12,3,1,2,15,3,1,1,1,0,0,0,0
"May 1, 2019 11:00 PM",35,7,28,,,,,,,,,,2,2,0,2,,,,15,14,1,3,10,4,0,4,5,2,0,2,1,1,0,0,0
"May 2, 2019 12:00 AM",14,1,13,,,,,,,,,,2,1,1,1,,,,5,5,0,2,4,1,0,1,3,0,1,0,0,0,0,0,0
"May 2, 2019 1:00 AM",5,1,4,,,,,,,,,,0,0,0,1,,,,1,1,0,1,2,0,0,0,0,0,0,0,0,0,0,0,0
"May 2, 2019 2:00 AM",2,0,2,,,,,,,,,,1,1,0,0,,,,2,1,1,0,0,0,0,0,0,0,0,0,0,0,0,0,0
"May 2, 2019 3:00 AM",2,1,1,,,,,,,,,,0,0,0,0,,,,0,0,0,0,0,0,0,0,0,1,0,0,0,0,0,0,0
"May 2, 2019 4:00 AM",1,1,0,,,,,,,,,,0,0,0,0,,,,1,1,0,0,0,0,0,0,0,0,0,0,0,0,0,0,0
"May 2, 2019 5:00 AM",9,5,4,,,,,,,,,,1,1,0,1,,,,1,1,0,5,6,0,0,0,10,2,0,0,0,0,0,0,0
"May 2, 2019 6:00 AM",56,45,11,,,,,,,,,,4,0,4,6,,,,8,6,2,35,16,7,5,2,49,2,0,3,1,2,0,0,0
"May 2, 2019 7:00 AM",238,187,51,,,,,,,,,,10,3,7,11,,,,29,24,5,126,29,41,32,9,161,2,5,4,4,0,,,
"May 2, 2019 8:00 AM",369,305,64,,,,,,,,,,15,4,11,24,,,,44,32,12,261,72,97,74,23,303,12,6,9,7,2,,,
"May 2, 2019 9:00 AM",189,151,38,,,,,,,,,,13,3,10,10,,,,24,13,11,95,20,39,32,7,113,0,6,3,2,1,0,0,0
"May 2, 2019 10:00 AM",80,68,12,,,,,,,,,,9,5,4,8,,,,9,3,6,34,13,17,9,8,28,0,2,4,2,2,0,0,0
"May 2, 2019 11:00 AM",48,32,16,,,,,,,,,,7,1,6,8,,,,11,7,4,33,11,13,7,6,17,0,2,1,1,0,0,0,0
"May 2, 2019 12:00 PM",52,27,25,,,,,,,,,,11,6,5,9,,,,12,10,2,21,17,8,3,5,17,2,0,4,3,1,0,0,0
"May 2, 2019 1:00 PM",60,27,33,,,,,,,,,,9,7,2,14,,,,19,18,1,22,24,20,7,13,26,1,0,4,2,2,0,0,0
"May 2, 2019 2:00 PM",80,38,42,,,,,,,,,,14,12,2,7,,,,28,26,2,16,17,18,7,11,17,2,1,5,2,3,1,1,0
"May 2, 2019 3:00 PM",59,16,43,,,,,,,,,,16,10,6,10,,,,28,24,4,19,32,16,7,9,26,7,2,3,3,0,1,1,0
"May 2, 2019 4:00 PM",147,41,106,,,,,,,,,,16,11,5,17,,,,78,76,2,22,71,45,10,35,37,6,3,8,2,6,1,1,0
"May 2, 2019 5:00 PM",301,66,235,,,,,,,,,,26,18,8,19,,,,145,142,3,38,164,86,13,73,69,9,2,6,5,1,2,1,1
"May 2, 2019 6:00 PM",332,72,260,,,,,,,,,,19,15,4,22,,,,162,156,6,34,126,78,13,65,56,5,4,7,3,4,5,2,3
"May 2, 2019 7:00 PM",159,36,123,,,,,,,,,,15,9,6,25,,,,75,73,2,25,79,44,14,30,28,8,3,4,2,2,2,2,0
"May 2, 2019 8:00 PM",116,23,93,,,,,,,,,,17,8,9,11,,,,44,41,3,10,33,14,1,13,23,2,1,2,1,1,0,0,0
"May 2, 2019 9:00 PM",76,17,59,,,,,,,,,,2,2,0,8,,,,41,41,0,13,15,13,3,10,20,0,3,6,2,4,0,0,0
"May 2, 2019 10:00 PM",60,12,48,,,,,,,,,,8,6,2,6,,,,25,24,1,5,5,5,0,5,12,0,0,3,1,2,1,1,0
"May 2, 2019 11:00 PM",28,2,26,,,,,,,,,,2,1,1,0,,,,14,14,0,2,16,2,1,1,6,0,0,2,2,0,0,0,0
"May 3, 2019 12:00 AM",11,1,10,,,,,,,,,,2,2,0,1,,,,6,6,0,3,6,0,0,0,3,0,1,0,0,0,0,0,0
"May 3, 2019 1:00 AM",4,3,1,,,,,,,,,,0,0,0,1,,,,3,3,0,0,2,0,0,0,0,0,0,0,0,0,0,0,0
"May 3, 2019 2:00 AM",1,1,0,,,,,,,,,,0,0,0,1,,,,2,2,0,0,1,0,0,0,0,1,0,0,0,0,0,0,0
"May 3, 2019 3:00 AM",1,1,0,,,,,,,,,,0,0,0,0,,,,2,2,0,0,1,0,0,0,0,0,0,0,0,0,0,0,0
"May 3, 2019 4:00 AM",3,1,2,,,,,,,,,,1,0,1,0,,,,0,0,0,0,0,1,0,1,0,1,0,0,0,0,0,0,0
"May 3, 2019 5:00 AM",10,6,4,,,,,,,,,,1,1,0,1,,,,2,2,0,10,2,0,0,0,7,2,0,0,0,0,0,0,0
"May 3, 2019 6:00 AM",52,41,11,,,,,,,,,,4,2,2,6,,,,7,5,2,28,13,9,6,3,37,2,2,2,2,0,0,0,0
"May 3, 2019 7:00 AM",160,120,40,,,,,,,,,,7,3,4,10,,,,27,23,4,105,26,35,26,9,115,3,3,3,2,1,1,0,1
"May 3, 2019 8:00 AM",320,267,53,,,,,,,,,,19,5,14,19,,,,39,30,9,198,56,78,64,14,237,5,5,11,9,2,2,0,2
"May 3, 2019 9:00 AM",181,151,30,,,,,,,,,,16,3,13,12,,,,18,10,8,77,24,27,17,10,95,3,3,2,0,2,1,1,0
"May 3, 2019 10:00 AM",68,45,23,,,,,,,,,,11,3,8,13,,,,13,11,2,37,6,17,8,9,30,4,2,2,2,0,2,0,2
"May 3, 2019 11:00 AM",58,45,13,,,,,,,,,,8,3,5,10,,,,14,12,2,30,10,15,3,12,18,0,2,0,0,0,1,1,0
"May 3, 2019 12:00 PM",69,35,34,,,,,,,,,,21,15,6,10,,,,22,17,5,19,17,15,5,10,23,2,1,3,2,1,2,0,2
"May 3, 2019 1:00 PM",88,34,54,,,,,,,,,,22,13,9,10,,,,29,25,4,17,35,25,17,8,27,2,0,5,1,4,1,1,0
"May 3, 2019 2:00 PM",73,31,42,,,,,,,,,,5,4,1,3,,,,28,25,3,17,15,24,9,15,15,2,3,2,2,0,0,0,0
"May 3, 2019 3:00 PM",105,36,69,,,,,,,,,,11,5,6,9,,,,24,22,2,20,37,19,7,12,24,2,1,4,1,3,4,4,0
"May 3, 2019 4:00 PM",188,54,134,,,,,,,,,,12,9,3,20,,,,84,81,3,28,83,52,7,45,34,2,3,2,1,1,1,1,0
"May 3, 2019 5:00 PM",238,46,192,,,,,,,,,,19,11,8,28,,,,140,138,2,35,135,59,9,50,62,9,2,6,3,3,2,0,2
"May 3, 2019 6:00 PM",175,39,136,,,,,,,,,,17,13,4,16,,,,107,105,2,18,88,47,8,39,33,5,0,5,4,1,0,0,0
"May 3, 2019 7:00 PM",115,32,83,,,,,,,,,,6,2,4,21,,,,62,59,3,12,45,26,3,23,25,2,1,5,3,2,1,1,0
"May 3, 2019 8:00 PM",84,24,60,,,,,,,,,,13,7,6,6,,,,25,25,0,8,20,13,5,8,15,2,1,3,0,3,3,2,1
"May 3, 2019 9:00 PM",56,14,42,,,,,,,,,,2,2,0,8,,,,28,26,2,10,18,7,1,6,14,3,0,3,1,2,2,2,0
"May 3, 2019 10:00 PM",41,15,26,,,,,,,,,,1,1,0,2,,,,12,11,1,8,9,0,0,0,5,1,0,0,0,0,0,0,0
"May 3, 2019 11:00 PM",24,1,23,,,,,,,,,,3,3,0,3,,,,15,14,1,4,4,0,0,0,9,0,1,1,1,0,0,0,0
"May 4, 2019 12:00 AM",15,3,12,,,,,,,,,,1,1,0,0,,,,6,6,0,7,6,1,0,1,5,0,0,1,0,1,0,0,0
"May 4, 2019 1:00 AM",7,0,7,,,,,,,,,,3,1,2,2,,,,6,6,0,0,4,3,3,0,1,0,1,0,0,0,0,0,0
"May 4, 2019 2:00 AM",5,0,5,,,,,,,,,,0,0,0,0,,,,4,4,0,0,7,0,0,0,3,2,2,2,1,1,0,0,0
"May 4, 2019 3:00 AM",3,1,2,,,,,,,,,,1,1,0,0,,,,1,1,0,0,0,0,0,0,1,1,0,0,0,0,0,0,0
"May 4, 2019 4:00 AM",3,1,2,,,,,,,,,,1,0,1,0,,,,0,0,0,0,0,1,0,1,0,0,0,0,0,0,0,0,0
"May 4, 2019 5:00 AM",3,0,3,,,,,,,,,,0,0,0,1,,,,4,4,0,0,4,1,0,1,1,0,0,0,0,0,0,0,0
"May 4, 2019 6:00 AM",9,6,3,,,,,,,,,,0,0,0,4,,,,2,2,0,2,6,1,0,1,4,1,0,1,1,0,0,0,0
"May 4, 2019 7:00 AM",24,12,12,,,,,,,,,,4,2,2,0,,,,3,3,0,10,10,3,0,3,15,0,0,0,0,0,0,0,0
"May 4, 2019 8:00 AM",46,29,17,,,,,,,,,,4,0,4,7,,,,8,6,2,10,12,11,2,9,19,0,5,0,0,0,1,0,1
"May 4, 2019 9:00 AM",82,56,26,,,,,,,,,,5,1,4,4,,,,12,7,5,22,37,26,14,12,30,5,6,0,0,0,0,0,0
"May 4, 2019 10:00 AM",80,47,33,,,,,,,,,,14,7,7,5,,,,21,19,2,18,19,34,10,24,18,2,7,4,0,4,0,0,0
"May 4, 2019 11:00 AM",61,30,31,,,,,,,,,,15,11,4,15,,,,15,13,2,25,15,17,7,10,34,4,4,5,4,1,0,0,0
"May 4, 2019 12:00 PM",60,31,29,,,,,,,,,,34,16,18,19,,,,13,11,2,18,22,33,11,22,20,5,3,6,5,1,3,0,3
"May 4, 2019 1:00 PM",54,36,18,,,,,,,,,,19,13,6,17,,,,18,17,1,24,24,26,13,13,31,8,7,2,1,1,0,0,0
"May 4, 2019 2:00 PM",58,29,29,,,,,,,,,,19,9,10,17,,,,14,9,5,18,17,31,12,19,23,5,1,1,1,0,1,1,0
"May 4, 2019 3:00 PM",64,38,26,,,,,,,,,,21,10,11,10,,,,14,8,6,21,31,37,9,28,21,5,5,9,5,4,3,2,1
"May 4, 2019 4:00 PM",47,17,30,,,,,,,,,,21,7,14,20,,,,17,16,1,18,35,44,20,24,14,5,5,3,2,1,2,0,2
"May 4, 2019 5:00 PM",56,23,33,,,,,,,,,,28,15,13,15,,,,23,21,2,10,25,34,17,17,34,9,2,5,2,3,3,3,0
"May 4, 2019 6:00 PM",70,24,46,,,,,,,,,,30,22,8,17,,,,19,16,3,21,12,23,17,6,37,8,2,6,3,3,0,0,0
"May 4, 2019 7:00 PM",48,26,22,,,,,,,,,,9,4,5,16,,,,12,10,2,7,7,15,6,9,17,2,3,1,1,0,1,1,0
"May 4, 2019 8:00 PM",30,12,18,,,,,,,,,,1,1,0,3,,,,18,18,0,14,8,8,3,5,7,0,0,1,0,1,1,1,0
"May 4, 2019 9:00 PM",43,9,34,,,,,,,,,,1,1,0,9,,,,9,9,0,5,4,5,2,3,11,2,0,1,1,0,0,0,0
"May 4, 2019 10:00 PM",29,5,24,,,,,,,,,,2,1,1,2,,,,14,14,0,3,5,1,0,1,7,1,0,1,1,0,0,0,0
"May 4, 2019 11:00 PM",24,5,19,,,,,,,,,,1,1,0,2,,,,6,6,0,1,1,2,2,0,2,0,0,0,0,0,0,0,0
"May 5, 2019 12:00 AM",9,2,7,,,,,,,,,,0,0,0,0,,,,6,5,1,0,4,0,0,0,7,0,0,0,0,0,1,1,0
"May 5, 2019 1:00 AM",3,0,3,,,,,,,,,,1,0,1,5,,,,3,3,0,0,1,2,0,2,3,0,2,0,0,0,0,0,0
"May 5, 2019 2:00 AM",5,0,5,,,,,,,,,,0,0,0,0,,,,4,3,1,1,1,0,0,0,0,0,1,0,0,0,0,0,0
"May 5, 2019 3:00 AM",1,1,0,,,,,,,,,,0,0,0,0,,,,0,0,0,0,0,1,0,1,2,0,1,2,1,1,1,0,1
"May 5, 2019 4:00 AM",2,0,2,,,,,,,,,,3,1,2,0,,,,0,0,0,0,0,0,0,0,4,1,0,0,0,0,0,0,0
"May 5, 2019 5:00 AM",3,2,1,,,,,,,,,,0,0,0,2,,,,0,0,0,0,4,0,0,0,0,0,0,0,0,0,0,0,0
"May 5, 2019 6:00 AM",6,3,3,,,,,,,,,,0,0,0,0,,,,3,3,0,5,6,0,0,0,5,0,0,0,0,0,0,0,0
"May 5, 2019 7:00 AM",22,14,8,,,,,,,,,,4,2,2,4,,,,7,5,2,12,17,3,1,2,9,0,2,0,0,0,1,0,1
"May 5, 2019 8:00 AM",37,24,13,,,,,,,,,,9,4,5,8,,,,5,2,3,14,24,11,6,5,29,1,9,0,0,0,1,0,1
"May 5, 2019 9:00 AM",43,26,17,,,,,,,,,,20,4,16,3,,,,16,10,6,15,19,31,17,14,174,2,14,2,2,0,0,0,0
"May 5, 2019 10:00 AM",41,23,18,,,,,,,,,,25,17,8,8,,,,17,15,2,16,28,46,16,30,33,5,11,4,2,2,0,0,0
"May 5, 2019 11:00 AM",51,32,19,,,,,,,,,,17,8,9,4,,,,9,5,4,20,36,34,12,22,27,13,5,1,0,1,3,3,0
"May 5, 2019 12:00 PM",52,34,18,,,,,,,,,,33,16,17,15,,,,17,13,4,14,34,38,12,26,24,8,8,4,4,0,5,2,3
"May 5, 2019 1:00 PM",46,24,22,,,,,,,,,,28,14,14,10,,,,18,13,5,27,31,25,12,13,43,11,3,5,3,2,1,1,0
"May 5, 2019 2:00 PM",50,34,16,,,,,,,,,,18,12,6,17,,,,15,14,1,19,22,19,7,12,29,4,2,1,1,0,0,0,0
"May 5, 2019 3:00 PM",38,17,21,,,,,,,,,,33,24,9,26,,,,21,16,5,12,20,36,11,25,25,5,0,7,6,1,1,0,1
"May 5, 2019 4:00 PM",53,21,32,,,,,,,,,,30,19,11,18,,,,19,18,1,19,13,23,10,13,20,3,1,5,5,0,1,0,1
"May 5, 2019 5:00 PM",48,18,30,,,,,,,,,,25,17,8,21,,,,14,12,2,15,12,40,23,17,22,4,4,1,1,0,0,0,0
"May 5, 2019 6:00 PM",52,20,32,,,,,,,,,,13,10,3,14,,,,16,16,0,5,10,11,7,4,11,1,0,0,0,0,0,0,0
"May 5, 2019 7:00 PM",37,15,22,,,,,,,,,,12,6,6,14,,,,8,8,0,9,19,9,3,6,15,0,1,2,1,1,1,1,0
"May 5, 2019 8:00 PM",42,17,25,,,,,,,,,,4,3,1,7,,,,22,22,0,5,9,6,4,2,26,2,0,3,1,2,2,2,0
"May 5, 2019 9:00 PM",36,5,31,,,,,,,,,,1,1,0,1,,,,14,14,0,5,5,8,3,5,13,0,1,3,2,1,0,0,0
"May 5, 2019 10:00 PM",43,9,34,,,,,,,,,,2,2,0,1,,,,4,4,0,6,5,5,2,3,4,0,0,1,1,0,2,1,1
"May 5, 2019 11:00 PM",24,7,17,,,,,,,,,,3,3,0,4,,,,9,7,2,3,3,4,0,4,4,0,0,0,0,0,0,0,0
"May 6, 2019 12:00 AM",12,7,5,,,,,,,,,,2,2,0,3,,,,5,5,0,2,3,4,3,1,2,0,0,0,0,0,0,0,0
"May 6, 2019 1:00 AM",3,1,2,,,,,,,,,,0,0,0,2,,,,3,3,0,0,1,0,0,0,3,0,1,0,0,0,0,0,0
"May 6, 2019 2:00 AM",2,0,2,,,,,,,,,,0,0,0,6,,,,1,1,0,0,2,1,1,0,1,2,1,1,0,1,0,0,0
"May 6, 2019 3:00 AM",0,0,0,,,,,,,,,,0,0,0,0,,,,1,1,0,0,0,0,0,0,0,1,0,0,0,0,0,0,0
"May 6, 2019 4:00 AM",2,1,1,,,,,,,,,,1,0,1,0,,,,0,0,0,1,0,0,0,0,0,0,0,0,0,0,0,0,0
"May 6, 2019 5:00 AM",0,0,0,,,,,,,,,,0,0,0,0,,,,0,0,0,2,2,0,0,0,2,0,0,0,0,0,0,0,0
"May 6, 2019 6:00 AM",14,7,7,,,,,,,,,,1,0,1,0,,,,5,4,1,5,9,2,1,1,5,0,1,0,0,0,0,0,0
"May 6, 2019 7:00 AM",25,16,9,,,,,,,,,,3,1,2,3,,,,7,6,1,11,16,7,2,5,23,0,3,0,0,0,0,0,0
"May 6, 2019 8:00 AM",65,46,19,,,,,,,,,,5,3,2,3,,,,16,6,10,35,8,9,5,4,26,1,7,1,0,1,0,0,0
"May 6, 2019 9:00 AM",53,42,11,,,,,,,,,,10,5,5,5,,,,9,8,1,18,19,12,9,3,22,5,5,0,0,0,0,0,0
"May 6, 2019 10:00 AM",44,23,21,,,,,,,,,,18,9,9,16,,,,16,11,5,13,23,22,1,21,31,7,13,3,1,2,1,1,0
"May 6, 2019 11:00 AM",48,27,21,,,,,,,,,,26,15,11,20,,,,18,15,3,19,42,34,13,21,25,11,3,2,2,0,4,1,3
"May 6, 2019 12:00 PM",52,30,22,,,,,,,,,,40,15,25,12,,,,19,15,4,21,30,31,11,20,35,12,2,4,3,1,2,2,0
"May 6, 2019 1:00 PM",59,37,22,,,,,,,,,,71,59,12,11,,,,13,12,1,26,16,39,24,15,28,8,6,4,2,2,0,0,0
"May 6, 2019 2:00 PM",42,25,17,,,,,,,,,,161,35,126,14,,,,21,20,1,20,26,33,13,20,29,5,1,6,5,1,1,0,1
"May 6, 2019 3:00 PM",64,27,37,,,,,,,,,,54,36,18,15,,,,14,13,1,12,27,29,11,18,25,6,11,7,4,3,0,0,0
"May 6, 2019 4:00 PM",56,29,27,,,,,,,,,,53,30,23,17,,,,19,15,4,20,23,36,22,14,25,4,5,2,1,1,0,0,0
"May 6, 2019 5:00 PM",66,35,31,,,,,,,,,,25,9,16,8,,,,29,27,2,9,20,32,9,23,27,3,3,2,1,1,0,0,0
"May 6, 2019 6:00 PM",64,20,44,,,,,,,,,,27,19,8,17,,,,24,24,0,12,17,24,13,11,22,3,2,5,4,1,1,0,1
"May 6, 2019 7:00 PM",53,16,37,,,,,,,,,,7,7,0,8,,,,24,24,0,11,9,9,6,3,11,3,2,3,2,1,2,0,2
"May 6, 2019 8:00 PM",39,7,32,,,,,,,,,,5,3,2,6,,,,22,20,2,10,11,7,5,2,11,0,0,4,0,4,2,2,0
"May 6, 2019 9:00 PM",38,5,33,,,,,,,,,,4,3,1,0,,,,13,13,0,5,1,4,3,1,5,2,0,4,2,2,1,0,1
"May 6, 2019 10:00 PM",29,6,23,,,,,,,,,,3,2,1,3,,,,12,12,0,5,5,1,1,0,8,0,0,0,0,0,0,0,0
"May 6, 2019 11:00 PM",16,3,13,,,,,,,,,,1,1,0,0,,,,9,7,2,4,4,1,0,1,6,0,0,1,1,0,0,0,0
"May 7, 2019 12:00 AM",3,0,3,,,,,,,,,,1,0,1,2,,,,4,4,0,0,0,1,0,1,1,0,1,1,0,1,1,1,0
"May 7, 2019 1:00 AM",2,1,1,,,,,,,,,,0,0,0,0,,,,3,3,0,1,1,0,0,0,1,0,0,0,0,0,0,0,0
"May 7, 2019 2:00 AM",0,0,0,,,,,,,,,,0,0,0,0,,,,0,0,0,0,0,0,0,0,0,0,0,1,1,0,1,0,1
"May 7, 2019 3:00 AM",0,0,0,,,,,,,,,,0,0,0,0,,,,1,1,0,0,0,0,0,0,0,0,0,0,0,0,0,0,0
"May 7, 2019 4:00 AM",4,1,3,,,,,,,,,,1,0,1,0,,,,0,0,0,1,0,0,0,0,1,0,0,0,0,0,0,0,0
"May 7, 2019 5:00 AM",8,7,1,,,,,,,,,,0,0,0,1,,,,1,1,0,7,6,2,2,0,14,2,0,0,0,0,0,0,0
"May 7, 2019 6:00 AM",57,43,14,,,,,,,,,,6,0,6,4,,,,6,4,2,24,16,13,10,3,55,0,1,3,2,1,2,0,2
"May 7, 2019 7:00 AM",229,175,54,,,,,,,,,,16,6,10,16,,,,40,28,12,146,41,44,36,8,196,4,1,3,1,2,1,0,1
"May 7, 2019 8:00 AM",422,350,72,,,,,,,,,,24,6,18,32,,,,55,36,19,312,74,111,88,23,353,9,7,14,11,3,3,0,3
"May 7, 2019 9:00 AM",190,153,37,,,,,,,,,,18,4,14,13,,,,30,18,12,113,30,49,35,14,119,1,1,6,5,1,0,0,0
"May 7, 2019 10:00 AM",80,60,20,,,,,,,,,,8,5,3,6,,,,13,11,2,42,14,18,5,13,39,2,2,4,2,2,0,0,0
"May 7, 2019 11:00 AM",52,39,13,,,,,,,,,,13,6,7,6,,,,13,10,3,19,13,21,8,13,20,3,4,3,3,0,0,0,0
"May 7, 2019 12:00 PM",50,29,21,,,,,,,,,,11,6,5,8,,,,11,10,1,20,21,14,6,8,35,4,3,3,1,2,0,0,0
"May 7, 2019 1:00 PM",73,38,35,,,,,,,,,,14,12,2,9,,,,24,23,1,21,21,23,10,13,20,2,2,0,0,0,2,2,0
"May 7, 2019 2:00 PM",84,40,44,,,,,,,,,,12,8,4,9,,,,26,20,6,29,24,11,1,10,26,2,1,1,0,1,1,1,0
"May 7, 2019 3:00 PM",73,25,48,,,,,,,,,,11,8,3,13,,,,42,40,2,18,32,20,2,18,21,5,1,8,4,4,2,2,0
"May 7, 2019 4:00 PM",149,40,109,,,,,,,,,,13,10,3,14,,,,76,73,3,32,79,48,14,34,37,4,1,6,4,2,3,3,0
"May 7, 2019 5:00 PM",352,84,268,,,,,,,,,,18,13,5,31,,,,178,175,3,39,208,88,16,72,108,10,2,10,6,4,0,0,0
"May 7, 2019 6:00 PM",348,60,288,,,,,,,,,,26,18,8,24,,,,182,180,2,43,185,101,17,84,55,3,4,5,2,3,1,1,0
"May 7, 2019 7:00 PM",181,35,146,,,,,,,,,,13,9,4,31,,,,96,92,4,25,95,49,6,43,36,7,4,5,3,2,1,1,0
"May 7, 2019 8:00 PM",139,27,112,,,,,,,,,,17,13,4,4,,,,52,48,4,18,34,18,4,14,32,2,3,2,2,0,0,0,0
"May 7, 2019 9:00 PM",62,8,54,,,,,,,,,,3,2,1,1,,,,36,35,1,10,18,9,1,8,18,5,0,2,1,1,1,0,1
"May 7, 2019 10:00 PM",69,8,61,,,,,,,,,,4,3,1,5,,,,28,25,3,6,16,5,3,2,10,2,0,1,0,1,1,1,0
"May 7, 2019 11:00 PM",29,7,22,,,,,,,,,,0,0,0,0,,,,18,17,1,0,7,2,1,1,1,1,0,0,0,0,0,0,0
"May 8, 2019 12:00 AM",5,1,4,,,,,,,,,,1,1,0,0,,,,8,8,0,0,2,1,0,1,1,2,0,0,0,0,0,0,0
"May 8, 2019 1:00 AM",2,0,2,,,,,,,,,,1,1,0,0,,,,3,2,1,1,0,0,0,0,0,0,1,0,0,0,0,0,0
"May 8, 2019 2:00 AM",2,1,1,,,,,,,,,,0,0,0,0,,,,0,0,0,0,0,1,0,1,0,0,0,0,0,0,0,0,0
"May 8, 2019 3:00 AM",2,2,0,,,,,,,,,,0,0,0,0,,,,1,1,0,0,0,0,0,0,0,0,0,0,0,0,0,0,0
"May 8, 2019 4:00 AM",2,1,1,,,,,,,,,,1,0,1,0,,,,0,0,0,1,1,0,0,0,1,0,0,0,0,0,0,0,0
"May 8, 2019 5:00 AM",6,5,1,,,,,,,,,,0,0,0,1,,,,3,2,1,10,7,2,1,1,7,2,0,0,0,0,0,0,0
"May 8, 2019 6:00 AM",56,40,16,,,,,,,,,,3,1,2,6,,,,5,4,1,21,10,5,4,1,33,0,1,3,2,1,1,0,1
"May 8, 2019 7:00 AM",165,130,35,,,,,,,,,,5,1,4,9,,,,21,15,6,98,27,23,19,4,124,1,1,2,1,1,0,0,0
"May 8, 2019 8:00 AM",324,283,41,,,,,,,,,,15,5,10,20,,,,33,19,14,194,45,51,40,11,235,7,3,15,15,0,4,1,3
"May 8, 2019 9:00 AM",151,131,20,,,,,,,,,,10,5,5,7,,,,20,8,12,70,11,20,15,5,57,1,1,2,1,1,0,0,0
"May 8, 2019 10:00 AM",50,39,11,,,,,,,,,,1,1,0,3,,,,6,3,3,19,5,8,5,3,12,2,3,1,1,0,0,0,0
"May 8, 2019 11:00 AM",49,26,23,,,,,,,,,,3,1,2,1,,,,14,11,3,14,6,3,0,3,11,0,2,0,0,0,0,0,0
"May 8, 2019 12:00 PM",41,17,24,,,,,,,,,,7,5,2,5,,,,6,4,2,21,7,2,1,1,10,1,0,0,0,0,0,0,0
"May 8, 2019 1:00 PM",47,20,27,,,,,,,,,,8,6,2,6,,,,11,8,3,11,14,2,1,1,13,3,0,1,0,1,0,0,0
"May 8, 2019 2:00 PM",55,26,29,,,,,,,,,,6,5,1,5,,,,22,19,3,8,15,4,2,2,12,3,4,4,2,2,1,1,0
"May 8, 2019 3:00 PM",62,27,35,,,,,,,,,,6,5,1,5,,,,27,22,5,12,26,10,1,9,12,0,1,3,2,1,1,0,1
"May 8, 2019 4:00 PM",119,32,87,,,,,,,,,,4,2,2,5,,,,46,43,3,9,43,16,3,13,18,3,1,1,1,0,2,2,0
"May 8, 2019 5:00 PM",264,66,198,,,,,,,,,,5,0,5,23,,,,107,105,2,27,124,37,5,32,58,4,1,3,2,1,0,0,0
"May 8, 2019 6:00 PM",247,41,206,,,,,,,,,,15,14,1,23,,,,139,137,2,30,109,53,6,47,39,7,1,1,0,1,0,0,0
"May 8, 2019 7:00 PM",147,32,115,,,,,,,,,,8,3,5,4,,,,59,58,1,13,47,15,0,15,11,4,2,0,0,0,0,0,0
"May 8, 2019 8:00 PM",88,17,71,,,,,,,,,,2,2,0,4,,,,34,29,5,4,29,10,2,8,13,1,2,2,1,1,0,0,0
"May 8, 2019 9:00 PM",62,9,53,,,,,,,,,,2,2,0,2,,,,21,21,0,7,17,2,0,2,8,3,1,1,1,0,0,0,0
"May 8, 2019 10:00 PM",48,7,41,,,,,,,,,,2,2,0,2,,,,16,16,0,2,7,2,0,2,5,2,0,1,1,0,0,0,0
"May 8, 2019 11:00 PM",30,9,21,,,,,,,,,,0,0,0,1,,,,15,14,1,0,5,1,0,1,6,0,0,0,0,0,0,0,0
"May 9, 2019 12:00 AM",8,1,7,,,,,,,,,,1,1,0,0,,,,3,3,0,2,3,0,0,0,3,1,1,0,0,0,0,0,0
"May 9, 2019 1:00 AM",4,0,4,,,,,,,,,,1,1,0,0,,,,2,2,0,0,2,0,0,0,0,1,0,0,0,0,0,0,0
"May 9, 2019 2:00 AM",2,1,1,,,,,,,,,,0,0,0,0,,,,1,1,0,0,1,0,0,0,0,0,0,0,0,0,0,0,0
"May 9, 2019 3:00 AM",0,0,0,,,,,,,,,,0,0,0,0,,,,1,1,0,0,0,0,0,0,0,1,0,0,0,0,0,0,0
"May 9, 2019 4:00 AM",1,0,1,,,,,,,,,,1,0,1,0,,,,1,1,0,1,0,0,0,0,0,0,0,0,0,0,0,0,0
"May 9, 2019 5:00 AM",9,7,2,,,,,,,,,,0,0,0,2,,,,1,1,0,8,6,4,3,1,9,2,0,0,0,0,0,0,0
"May 9, 2019 6:00 AM",51,37,14,,,,,,,,,,2,0,2,8,,,,7,5,2,29,14,7,4,3,39,1,1,2,1,1,0,0,0
"May 9, 2019 7:00 AM",169,142,27,,,,,,,,,,10,4,6,12,,,,25,22,3,113,31,23,20,3,144,3,3,5,3,2,2,0,2
"May 9, 2019 8:00 AM",363,301,62,,,,,,,,,,24,4,20,28,,,,41,25,16,249,53,66,48,18,289,12,3,14,12,2,4,1,3
"May 9, 2019 9:00 AM",168,135,33,,,,,,,,,,9,2,7,6,,,,31,13,18,75,23,34,26,8,89,1,2,1,0,1,1,0,1
"May 9, 2019 10:00 AM",66,46,20,,,,,,,,,,7,7,0,4,,,,24,18,6,30,8,4,1,3,19,0,1,0,0,0,0,0,0
"May 9, 2019 11:00 AM",74,42,32,,,,,,,,,,9,3,6,5,,,,9,5,4,18,11,9,6,3,13,2,1,0,0,0,0,0,0
"May 9, 2019 12:00 PM",38,17,21,,,,,,,,,,2,2,0,7,,,,15,15,0,16,6,3,0,3,12,1,0,1,1,0,0,0,0
"May 9, 2019 1:00 PM",44,18,26,,,,,,,,,,9,4,5,5,,,,13,11,2,19,23,14,6,8,14,0,0,0,0,0,0,0,0
"May 9, 2019 2:00 PM",74,30,44,,,,,,,,,,11,9,2,5,,,,19,17,2,13,20,13,4,9,16,3,4,3,0,3,0,0,0
"May 9, 2019 3:00 PM",48,13,35,,,,,,,,,,7,4,3,6,,,,28,27,1,18,21,6,3,3,15,2,0,4,0,4,4,4,0
"May 9, 2019 4:00 PM",104,27,77,,,,,,,,,,7,4,3,9,,,,39,37,2,13,36,19,0,19,24,3,1,5,2,3,2,2,0
"May 9, 2019 5:00 PM",285,56,229,,,,,,,,,,11,8,3,23,,,,127,125,2,22,131,65,7,58,50,6,2,5,2,3,2,2,0
"May 9, 2019 6:00 PM",243,48,195,,,,,,,,,,15,11,4,19,,,,158,153,5,41,143,55,9,46,58,7,2,3,1,2,1,1,0
"May 9, 2019 7:00 PM",97,21,76,,,,,,,,,,12,8,4,9,,,,64,61,3,14,60,23,3,20,26,2,2,1,0,1,0,0,0
"May 9, 2019 8:00 PM",64,23,41,,,,,,,,,,10,8,2,10,,,,37,35,2,15,26,22,3,19,11,3,0,3,3,0,0,0,0
"May 9, 2019 9:00 PM",68,15,53,,,,,,,,,,6,5,1,7,,,,24,24,0,10,14,10,4,6,11,0,1,4,0,4,0,0,0
"May 9, 2019 10:00 PM",45,5,40,,,,,,,,,,5,5,0,2,,,,28,27,1,2,7,0,0,0,4,0,0,1,1,0,1,0,1
"May 9, 2019 11:00 PM",30,8,22,,,,,,,,,,2,2,0,0,,,,18,17,1,4,8,1,1,0,5,0,1,0,0,0,0,0,0
"May 10, 2019 12:00 AM",12,1,11,,,,,,,,,,1,1,0,0,,,,8,8,0,2,3,1,0,1,3,1,1,1,0,1,1,1,0
"May 10, 2019 1:00 AM",2,1,1,,,,,,,,,,0,0,0,0,,,,5,5,0,1,0,1,0,1,1,0,0,0,0,0,0,0,0
"May 10, 2019 2:00 AM",5,2,3,,,,,,,,,,0,0,0,0,,,,1,1,0,0,3,0,0,0,0,0,0,1,1,0,1,0,1
"May 10, 2019 3:00 AM",1,0,1,,,,,,,,,,0,0,0,0,,,,0,0,0,0,0,0,0,0,1,1,0,0,0,0,0,0,0
"May 10, 2019 4:00 AM",2,1,1,,,,,,,,,,1,0,1,0,,,,1,1,0,0,0,0,0,0,0,0,0,0,0,0,0,0,0
"May 10, 2019 5:00 AM",9,6,3,,,,,,,,,,0,0,0,2,,,,3,3,0,6,6,2,1,1,12,1,0,0,0,0,0,0,0
"May 10, 2019 6:00 AM",62,47,15,,,,,,,,,,4,2,2,6,,,,6,4,2,30,19,8,5,3,40,1,2,4,3,1,1,0,1
"May 10, 2019 7:00 AM",175,135,40,,,,,,,,,,4,0,4,11,,,,23,17,6,109,31,26,22,4,158,3,1,3,2,1,0,0,0
"May 10, 2019 8:00 AM",350,290,60,,,,,,,,,,27,7,20,22,,,,46,24,22,229,61,79,60,19,245,8,10,13,12,1,1,1,0
"May 10, 2019 9:00 AM",183,149,34,,,,,,,,,,19,4,15,11,,,,25,19,6,82,28,37,24,13,91,3,4,7,4,3,0,0,0
"May 10, 2019 10:00 AM",69,46,23,,,,,,,,,,9,6,3,5,,,,17,12,5,33,22,14,7,7,28,1,2,2,1,1,1,0,1
"May 10, 2019 11:00 AM",83,63,20,,,,,,,,,,12,7,5,6,,,,17,14,3,32,16,10,4,6,35,2,4,1,1,0,1,0,1
"May 10, 2019 12:00 PM",66,35,31,,,,,,,,,,13,11,2,7,,,,18,18,0,25,18,9,3,6,32,2,1,0,0,0,0,0,0
"May 10, 2019 1:00 PM",83,32,51,,,,,,,,,,18,8,10,6,,,,22,19,3,25,30,24,5,19,28,2,3,2,1,1,0,0,0
"May 10, 2019 2:00 PM",102,49,53,,,,,,,,,,19,14,5,4,,,,36,33,3,30,34,28,11,17,31,3,1,0,0,0,4,2,2
"May 10, 2019 3:00 PM",78,24,54,,,,,,,,,,12,5,7,8,,,,33,30,3,15,37,22,11,11,23,3,3,8,2,6,1,1,0
"May 10, 2019 4:00 PM",165,45,120,,,,,,,,,,20,14,6,12,,,,71,66,5,29,64,40,10,30,39,0,0,5,2,3,2,2,0
"May 10, 2019 5:00 PM",272,57,215,,,,,,,,,,18,14,4,23,,,,155,154,1,32,153,62,4,58,51,7,1,4,2,2,2,0,2
"May 10, 2019 6:00 PM",224,45,179,,,,,,,,,,14,7,7,19,,,,117,116,1,30,122,57,6,51,34,5,7,8,4,4,3,2,1
"May 10, 2019 7:00 PM",94,26,68,,,,,,,,,,1,0,1,10,,,,54,52,2,14,49,19,4,15,20,4,0,1,1,0,1,0,1
"May 10, 2019 8:00 PM",99,20,79,,,,,,,,,,10,7,3,16,,,,31,31,0,10,25,20,8,12,11,1,1,2,0,2,1,1,0
"May 10, 2019 9:00 PM",73,20,53,,,,,,,,,,15,7,8,6,,,,23,22,1,5,17,12,2,10,15,0,0,3,0,3,1,1,0
"May 10, 2019 10:00 PM",42,8,34,,,,,,,,,,7,6,1,5,,,,10,10,0,4,8,2,0,2,13,0,0,3,3,0,1,0,1
"May 10, 2019 11:00 PM",28,5,23,,,,,,,,,,0,0,0,1,,,,12,10,2,2,8,0,0,0,6,0,0,2,1,1,0,0,0
"May 11, 2019 12:00 AM",19,4,15,,,,,,,,,,1,0,1,1,,,,5,4,1,5,10,2,0,2,3,0,1,0,0,0,0,0,0
"May 11, 2019 1:00 AM",8,0,8,,,,,,,,,,3,0,3,2,,,,10,10,0,3,5,3,2,1,2,0,1,0,0,0,0,0,0
"May 11, 2019 2:00 AM",4,3,1,,,,,,,,,,0,0,0,0,,,,3,3,0,2,5,0,0,0,0,0,0,1,0,1,1,1,0
"May 11, 2019 3:00 AM",3,2,1,,,,,,,,,,0,0,0,0,,,,1,1,0,0,1,3,3,0,4,2,1,0,0,0,0,0,0
"May 11, 2019 4:00 AM",4,2,2,,,,,,,,,,1,0,1,0,,,,1,1,0,0,1,0,0,0,1,0,0,0,0,0,0,0,0
"May 11, 2019 5:00 AM",2,2,0,,,,,,,,,,0,0,0,1,,,,0,0,0,0,4,5,0,5,1,0,0,0,0,0,0,0,0
"May 11, 2019 6:00 AM",9,5,4,,,,,,,,,,1,1,0,1,,,,4,4,0,3,13,6,2,4,11,1,0,0,0,0,0,0,0
"May 11, 2019 7:00 AM",38,27,11,,,,,,,,,,3,1,2,3,,,,7,6,1,15,11,6,2,4,18,2,1,1,1,0,0,0,0
"May 11, 2019 8:00 AM",66,59,7,,,,,,,,,,10,4,6,6,,,,28,25,3,24,18,12,3,9,35,5,15,2,2,0,0,0,0
"May 11, 2019 9:00 AM",66,47,19,,,,,,,,,,20,10,10,7,,,,20,14,6,18,20,22,12,10,36,1,9,1,0,1,2,0,2
"May 11, 2019 10:00 AM",60,33,27,,,,,,,,,,17,6,11,7,,,,23,18,5,20,19,23,8,15,24,4,4,4,1,3,4,2,2
"May 11, 2019 11:00 AM",75,48,27,,,,,,,,,,35,16,19,16,,,,23,16,7,30,36,26,9,17,36,6,1,3,2,1,2,0,2
"May 11, 2019 12:00 PM",72,36,36,,,,,,,,,,23,4,19,11,,,,17,17,0,17,36,39,18,21,34,2,2,4,3,1,2,1,1
"May 11, 2019 1:00 PM",62,31,31,,,,,,,,,,15,8,7,18,,,,27,24,3,13,25,39,13,26,34,7,2,5,3,2,1,0,1
"May 11, 2019 2:00 PM",82,50,32,,,,,,,,,,16,10,6,39,,,,22,20,2,27,33,30,11,19,33,4,1,2,1,1,0,0,0
"May 11, 2019 3:00 PM",57,25,32,,,,,,,,,,40,12,28,13,,,,22,22,0,20,37,43,17,26,30,4,0,4,3,1,1,0,1
"May 11, 2019 4:00 PM",83,26,57,,,,,,,,,,40,23,17,33,,,,26,20,6,17,46,59,20,39,34,6,6,4,2,2,0,0,0
"May 11, 2019 5:00 PM",80,28,52,,,,,,,,,,43,20,23,8,,,,22,22,0,10,39,28,11,17,29,3,1,2,1,1,2,1,1
"May 11, 2019 6:00 PM",49,16,33,,,,,,,,,,15,12,3,19,,,,11,11,0,16,19,26,9,17,27,3,1,3,2,1,0,0,0
"May 11, 2019 7:00 PM",46,21,25,,,,,,,,,,36,27,9,9,,,,16,13,3,17,18,51,36,15,62,1,2,4,2,2,9,5,4
"May 11, 2019 8:00 PM",38,14,24,,,,,,,,,,10,8,2,6,,,,5,4,1,11,11,14,7,7,35,1,0,8,5,3,1,1,0
"May 11, 2019 9:00 PM",37,8,29,,,,,,,,,,2,2,0,4,,,,14,14,0,11,5,12,8,4,13,0,1,11,6,5,0,0,0
"May 11, 2019 10:00 PM",37,7,30,,,,,,,,,,2,1,1,2,,,,10,8,2,2,7,4,2,2,7,0,0,0,0,0,0,0,0
"May 11, 2019 11:00 PM",28,5,23,,,,,,,,,,2,1,1,1,,,,11,10,1,4,3,5,2,3,16,0,0,0,0,0,0,0,0
"May 12, 2019 12:00 AM",14,8,6,,,,,,,,,,2,0,2,1,,,,6,6,0,5,5,3,3,0,3,0,0,0,0,0,0,0,0
"May 12, 2019 1:00 AM",6,1,5,,,,,,,,,,0,0,0,0,,,,2,2,0,1,1,0,0,0,3,0,1,0,0,0,0,0,0
"May 12, 2019 2:00 AM",3,0,3,,,,,,,,,,1,1,0,0,,,,2,2,0,0,2,1,0,1,4,1,0,0,0,0,0,0,0
"May 12, 2019 3:00 AM",0,0,0,,,,,,,,,,0,0,0,0,,,,1,1,0,2,2,0,0,0,0,0,2,0,0,0,0,0,0
"May 12, 2019 4:00 AM",1,0,1,,,,,,,,,,1,0,1,0,,,,1,1,0,0,0,0,0,0,2,0,0,0,0,0,0,0,0
"May 12, 2019 5:00 AM",5,1,4,,,,,,,,,,0,0,0,1,,,,1,1,0,0,2,1,0,1,1,0,0,0,0,0,0,0,0
"May 12, 2019 6:00 AM",10,3,7,,,,,,,,,,0,0,0,2,,,,3,3,0,6,8,0,0,0,9,1,0,0,0,0,0,0,0
"May 12, 2019 7:00 AM",17,9,8,,,,,,,,,,2,1,1,1,,,,4,4,0,11,14,4,2,2,10,0,3,0,0,0,1,0,1
"May 12, 2019 8:00 AM",34,21,13,,,,,,,,,,6,2,4,9,,,,6,5,1,19,33,15,3,12,18,1,16,0,0,0,0,0,0
"May 12, 2019 9:00 AM",55,39,16,,,,,,,,,,17,6,11,21,,,,21,14,7,21,26,19,8,11,27,6,11,0,0,0,2,0,2
"May 12, 2019 10:00 AM",65,43,22,,,,,,,,,,17,8,9,6,,,,16,14,2,27,24,45,14,31,63,5,7,0,0,0,1,0,1
"May 12, 2019 11:00 AM",50,29,21,,,,,,,,,,41,15,26,13,,,,16,10,6,15,27,16,8,8,40,8,1,2,2,0,2,2,0
"May 12, 2019 12:00 PM",65,45,20,,,,,,,,,,54,20,34,73,,,,16,10,6,21,40,47,20,27,27,15,6,16,13,3,3,1,2
"May 12, 2019 1:00 PM",68,41,27,,,,,,,,,,26,19,7,15,,,,19,17,2,22,40,41,11,30,33,21,6,8,6,2,3,1,2
"May 12, 2019 2:00 PM",57,32,25,,,,,,,,,,40,33,7,17,,,,12,11,1,14,52,38,9,29,32,10,2,2,2,0,1,0,1
"May 12, 2019 3:00 PM",60,33,27,,,,,,,,,,45,22,23,18,,,,16,15,1,12,60,68,15,53,24,6,4,4,2,2,0,0,0
"May 12, 2019 4:00 PM",43,11,32,,,,,,,,,,38,17,21,16,,,,19,18,1,17,43,47,15,32,32,7,2,3,2,1,0,0,0
"May 12, 2019 5:00 PM",57,23,34,,,,,,,,,,67,19,48,24,,,,20,16,4,19,52,53,18,35,40,5,2,3,1,2,2,1,1
"May 12, 2019 6:00 PM",47,18,29,,,,,,,,,,38,25,13,14,,,,17,14,3,15,18,40,22,18,55,1,1,3,2,1,4,4,0
"May 12, 2019 7:00 PM",49,23,26,,,,,,,,,,44,30,14,9,,,,13,13,0,14,13,34,24,10,87,2,1,6,1,5,0,0,0
"May 12, 2019 8:00 PM",54,23,31,,,,,,,,,,19,15,4,8,,,,20,20,0,20,14,27,20,7,58,0,2,4,4,0,1,0,1
"May 12, 2019 9:00 PM",38,7,31,,,,,,,,,,13,9,4,4,,,,8,8,0,8,7,17,16,1,31,0,2,3,2,1,0,0,0
"May 12, 2019 10:00 PM",37,8,29,,,,,,,,,,4,4,0,0,,,,15,14,1,6,8,3,3,0,11,0,1,0,0,0,1,1,0
"May 12, 2019 11:00 PM",28,6,22,,,,,,,,,,1,0,1,1,,,,10,8,2,2,3,4,4,0,9,0,0,1,1,0,1,1,0
"May 13, 2019 12:00 AM",5,1,4,,,,,,,,,,2,2,0,1,,,,2,2,0,2,5,2,1,1,3,0,2,0,0,0,0,0,0
"May 13, 2019 1:00 AM",2,1,1,,,,,,,,,,2,1,1,0,,,,2,2,0,0,0,0,0,0,1,0,0,1,0,1,0,0,0
"May 13, 2019 2:00 AM",1,1,0,,,,,,,,,,0,0,0,0,,,,0,0,0,0,1,0,0,0,0,0,0,0,0,0,0,0,0
"May 13, 2019 3:00 AM",0,0,0,,,,,,,,,,0,0,0,0,,,,0,0,0,0,0,0,0,0,0,1,0,0,0,0,0,0,0
"May 13, 2019 4:00 AM",3,1,2,,,,,,,,,,1,0,1,0,,,,0,0,0,1,1,0,0,0,1,0,0,0,0,0,0,0,0
"May 13, 2019 5:00 AM",10,7,3,,,,,,,,,,0,0,0,2,,,,0,0,0,5,4,1,1,0,15,2,0,0,0,0,0,0,0
"May 13, 2019 6:00 AM",70,53,17,,,,,,,,,,0,0,0,4,,,,6,5,1,39,17,16,12,4,50,1,0,2,2,0,0,0,0
"May 13, 2019 7:00 AM",230,173,57,,,,,,,,,,15,6,9,17,,,,36,25,11,131,46,69,51,18,199,5,4,4,4,0,0,0,0
"May 13, 2019 8:00 AM",426,349,77,,,,,,,,,,30,5,25,29,,,,60,41,19,343,78,132,107,25,367,8,7,12,11,1,1,0,1
"May 13, 2019 9:00 AM",202,165,37,,,,,,,,,,19,6,13,17,,,,37,27,10,103,33,48,26,22,128,1,3,6,5,1,1,0,1
"May 13, 2019 10:00 AM",66,56,10,,,,,,,,,,17,5,12,4,,,,14,11,3,40,25,25,14,11,45,1,1,3,2,1,0,0,0
"May 13, 2019 11:00 AM",69,51,18,,,,,,,,,,16,5,11,5,,,,13,11,2,27,21,16,4,12,31,1,3,4,4,0,2,0,2
"May 13, 2019 12:00 PM",57,29,28,,,,,,,,,,22,10,12,7,,,,22,18,4,21,19,14,1,13,22,3,3,2,1,1,1,1,0
"May 13, 2019 1:00 PM",84,33,51,,,,,,,,,,22,14,8,9,,,,19,17,2,19,29,28,11,17,30,2,3,3,1,2,0,0,0
"May 13, 2019 2:00 PM",109,53,56,,,,,,,,,,13,8,5,12,,,,33,29,4,29,34,28,13,15,28,6,3,2,2,0,1,0,1
"May 13, 2019 3:00 PM",69,24,45,,,,,,,,,,11,9,2,10,,,,33,28,5,21,39,30,9,21,32,2,4,5,0,5,3,3,0
"May 13, 2019 4:00 PM",149,43,106,,,,,,,,,,15,9,6,12,,,,100,96,4,26,104,53,13,40,47,3,5,4,2,2,2,2,0
"May 13, 2019 5:00 PM",388,79,309,,,,,,,,,,35,26,9,32,,,,200,192,8,47,241,110,31,79,93,9,3,5,3,2,0,0,0
"May 13, 2019 6:00 PM",332,55,277,,,,,,,,,,31,26,5,37,,,,183,179,4,55,209,125,16,109,75,9,7,16,9,7,4,2,2
"May 13, 2019 7:00 PM",196,51,145,,,,,,,,,,20,11,9,33,,,,93,92,1,28,105,66,19,47,44,7,2,10,3,7,9,7,2
"May 13, 2019 8:00 PM",132,42,90,,,,,,,,,,14,10,4,12,,,,70,68,2,15,50,38,8,30,46,8,3,4,2,2,2,2,0
"May 13, 2019 9:00 PM",82,17,65,,,,,,,,,,12,6,6,7,,,,37,33,4,16,16,18,9,9,33,2,0,0,0,0,0,0,0
"May 13, 2019 10:00 PM",50,8,42,,,,,,,,,,6,3,3,4,,,,24,24,0,12,15,6,3,3,14,2,0,0,0,0,2,1,1
"May 13, 2019 11:00 PM",28,8,20,,,,,,,,,,1,0,1,0,,,,10,10,0,1,7,1,0,1,5,0,1,1,0,1,1,1,0
"May 14, 2019 12:00 AM",3,0,3,,,,,,,,,,0,0,0,4,,,,7,7,0,0,2,2,1,1,2,0,0,1,1,0,1,0,1
"May 14, 2019 1:00 AM",4,1,3,,,,,,,,,,0,0,0,0,,,,1,1,0,1,1,1,0,1,0,0,1,1,0,1,0,0,0
"May 14, 2019 2:00 AM",4,1,3,,,,,,,,,,0,0,0,0,,,,2,2,0,0,0,0,0,0,0,0,0,0,0,0,0,0,0
"May 14, 2019 3:00 AM",2,1,1,,,,,,,,,,0,0,0,0,,,,0,0,0,0,2,0,0,0,1,1,0,0,0,0,0,0,0
"May 14, 2019 4:00 AM",3,1,2,,,,,,,,,,1,1,0,0,,,,0,0,0,1,0,1,0,1,1,0,0,0,0,0,0,0,0
"May 14, 2019 5:00 AM",9,6,3,,,,,,,,,,1,0,1,1,,,,1,1,0,7,5,2,1,1,9,2,1,0,0,0,0,0,0
"May 14, 2019 6:00 AM",80,55,25,,,,,,,,,,9,4,5,7,,,,7,5,2,32,27,20,13,7,59,2,4,2,0,2,1,0,1
"May 14, 2019 7:00 AM",271,208,63,,,,,,,,,,19,7,12,16,,,,40,34,6,167,68,69,53,16,239,4,2,2,2,0,1,0,1
"May 14, 2019 8:00 AM",458,369,89,,,,,,,,,,36,10,26,42,,,,57,44,13,319,69,132,98,34,408,11,7,17,12,5,3,1,2
"May 14, 2019 9:00 AM",221,176,45,,,,,,,,,,21,6,15,8,,,,23,12,11,122,34,44,28,16,131,6,4,7,5,2,0,0,0
"May 14, 2019 10:00 AM",97,68,29,,,,,,,,,,9,4,5,7,,,,20,12,8,32,12,32,18,14,44,1,3,8,3,5,0,0,0
"May 14, 2019 11:00 AM",56,37,19,,,,,,,,,,17,6,11,15,,,,11,7,4,24,10,14,6,8,28,5,3,2,2,0,0,0,0
"May 14, 2019 12:00 PM",58,24,34,,,,,,,,,,22,14,8,7,,,,25,18,7,30,16,21,11,10,24,2,5,5,3,2,1,1,0
"May 14, 2019 1:00 PM",70,28,42,,,,,,,,,,24,17,7,13,,,,26,23,3,30,25,31,8,23,37,3,1,2,1,1,1,1,0
"May 14, 2019 2:00 PM",91,44,47,,,,,,,,,,17,8,9,13,,,,27,22,5,12,30,33,13,20,34,6,0,5,5,0,1,1,0
"May 14, 2019 3:00 PM",71,23,48,,,,,,,,,,24,14,10,11,,,,30,27,3,19,38,34,7,27,23,2,2,5,3,2,2,2,0
"May 14, 2019 4:00 PM",190,48,142,,,,,,,,,,25,17,8,21,,,,78,73,5,41,106,61,14,47,36,6,3,3,3,0,2,1,1
"May 14, 2019 5:00 PM",390,77,313,,,,,,,,,,26,19,7,33,,,,186,181,5,51,242,114,20,94,101,11,6,12,6,6,4,2,2
"May 14, 2019 6:00 PM",356,78,278,,,,,,,,,,25,18,7,39,,,,209,200,9,52,223,134,21,113,77,7,8,5,3,2,2,1,1
"May 14, 2019 7:00 PM",198,44,154,,,,,,,,,,11,5,6,26,,,,94,91,3,28,105,62,16,46,55,5,3,7,4,3,1,1,0
"May 14, 2019 8:00 PM",137,37,100,,,,,,,,,,19,11,8,22,,,,63,60,3,23,55,50,21,29,41,1,3,2,1,1,2,2,0
"May 14, 2019 9:00 PM",72,17,55,,,,,,,,,,9,3,6,6,,,,31,29,2,14,32,15,3,12,31,3,2,3,1,2,0,0,0
"May 14, 2019 10:00 PM",65,7,58,,,,,,,,,,12,8,4,4,,,,27,25,2,7,12,13,8,5,18,0,0,1,0,1,1,0,1
"May 14, 2019 11:00 PM",33,5,28,,,,,,,,,,3,1,2,1,,,,10,10,0,1,7,2,2,0,5,0,0,1,1,0,1,1,0
"May 15, 2019 12:00 AM",11,1,10,,,,,,,,,,0,0,0,0,,,,5,5,0,2,3,1,1,0,2,2,0,0,0,0,0,0,0
"May 15, 2019 1:00 AM",3,0,3,,,,,,,,,,0,0,0,0,,,,1,1,0,1,1,0,0,0,1,0,1,0,0,0,0,0,0
"May 15, 2019 2:00 AM",5,3,2,,,,,,,,,,0,0,0,0,,,,2,2,0,0,2,0,0,0,0,0,0,0,0,0,0,0,0
"May 15, 2019 3:00 AM",1,1,0,,,,,,,,,,0,0,0,0,,,,0,0,0,0,1,0,0,0,0,0,0,0,0,0,0,0,0
"May 15, 2019 4:00 AM",3,2,1,,,,,,,,,,0,0,0,0,,,,0,0,0,1,0,1,0,1,1,1,0,0,0,0,0,0,0
"May 15, 2019 5:00 AM",9,7,2,,,,,,,,,,1,1,0,5,,,,0,0,0,9,5,3,2,1,16,2,0,0,0,0,0,0,0
"May 15, 2019 6:00 AM",76,58,18,,,,,,,,,,5,2,3,9,,,,4,4,0,40,27,16,10,6,59,1,1,4,3,1,0,0,0
"May 15, 2019 7:00 AM",256,199,57,,,,,,,,,,13,6,7,14,,,,33,26,7,170,53,57,44,13,215,3,5,5,2,3,3,0,3
"May 15, 2019 8:00 AM",454,365,89,,,,,,,,,,36,5,31,36,,,,83,59,24,291,56,126,97,29,369,9,12,9,7,2,3,1,2
"May 15, 2019 9:00 AM",199,169,30,,,,,,,,,,15,4,11,15,,,,27,17,10,111,31,48,28,20,129,4,6,8,4,4,1,0,1
"May 15, 2019 10:00 AM",62,37,25,,,,,,,,,,17,6,11,2,,,,19,11,8,53,14,20,11,9,43,5,0,4,3,1,2,0,2
"May 15, 2019 11:00 AM",70,44,26,,,,,,,,,,7,2,5,6,,,,19,15,4,26,18,19,9,10,25,2,1,1,0,1,0,0,0
"May 15, 2019 12:00 PM",48,27,21,,,,,,,,,,21,10,11,8,,,,14,11,3,23,24,18,2,16,33,3,1,3,2,1,0,0,0
"May 15, 2019 1:00 PM",87,32,55,,,,,,,,,,17,11,6,19,,,,33,26,7,16,29,12,4,8,29,3,2,3,0,3,4,4,0
"May 15, 2019 2:00 PM",87,44,43,,,,,,,,,,22,14,8,7,,,,30,29,1,27,30,26,9,17,27,3,6,3,1,2,0,0,0
"May 15, 2019 3:00 PM",75,28,47,,,,,,,,,,21,17,4,16,,,,31,29,2,19,40,28,6,22,28,5,4,7,4,3,2,2,0
"May 15, 2019 4:00 PM",172,53,119,,,,,,,,,,26,12,14,11,,,,62,58,4,29,92,43,8,35,48,6,1,1,1,0,3,2,1
"May 15, 2019 5:00 PM",381,96,285,,,,,,,,,,19,12,7,37,,,,187,181,6,57,234,108,16,92,112,11,4,8,4,4,2,1,1
"May 15, 2019 6:00 PM",325,64,261,,,,,,,,,,17,12,5,29,,,,203,195,8,47,182,132,18,114,60,6,5,8,4,4,2,2,0
"May 15, 2019 7:00 PM",168,41,127,,,,,,,,,,25,14,11,21,,,,87,83,4,22,93,76,16,60,41,3,5,8,2,6,6,3,3
"May 15, 2019 8:00 PM",143,33,110,,,,,,,,,,8,3,5,12,,,,50,47,3,24,46,57,19,38,34,5,1,1,1,0,1,0,1
"May 15, 2019 9:00 PM",72,17,55,,,,,,,,,,6,6,0,7,,,,43,42,1,18,35,25,13,12,20,6,1,2,1,1,0,0,0
"May 15, 2019 10:00 PM",59,14,45,,,,,,,,,,8,7,1,7,,,,24,24,0,4,16,5,2,3,22,1,0,2,2,0,2,2,0
"May 15, 2019 11:00 PM",19,7,12,,,,,,,,,,3,2,1,2,,,,16,16,0,1,3,2,2,0,5,0,2,0,0,0,0,0,0
"May 16, 2019 12:00 AM",9,2,7,,,,,,,,,,2,2,0,0,,,,7,6,1,2,3,2,1,1,4,0,0,0,0,0,0,0,0
"May 16, 2019 1:00 AM",4,0,4,,,,,,,,,,0,0,0,1,,,,3,3,0,1,0,0,0,0,0,0,0,0,0,0,0,0,0
"May 16, 2019 2:00 AM",4,2,2,,,,,,,,,,0,0,0,0,,,,2,2,0,1,3,0,0,0,0,0,1,0,0,0,0,0,0
"May 16, 2019 3:00 AM",1,0,1,,,,,,,,,,0,0,0,0,,,,1,1,0,1,1,0,0,0,1,1,0,0,0,0,0,0,0
"May 16, 2019 4:00 AM",2,1,1,,,,,,,,,,1,0,1,0,,,,1,1,0,1,1,0,0,0,0,0,0,0,0,0,0,0,0
"May 16, 2019 5:00 AM",12,7,5,,,,,,,,,,1,1,0,2,,,,2,2,0,3,8,4,1,3,10,2,1,0,0,0,0,0,0
"May 16, 2019 6:00 AM",59,46,13,,,,,,,,,,6,1,5,7,,,,8,8,0,37,24,13,9,4,57,0,2,2,0,2,0,0,0
"May 16, 2019 7:00 AM",242,182,60,,,,,,,,,,17,5,12,22,,,,33,27,6,142,40,54,40,14,199,5,4,5,5,0,0,0,0
"May 16, 2019 8:00 AM",425,343,82,,,,,,,,,,26,9,17,39,,,,58,45,13,299,91,116,96,20,342,9,10,8,6,2,0,0,0
"May 16, 2019 9:00 AM",217,181,36,,,,,,,,,,19,8,11,10,,,,28,15,13,107,25,51,35,16,111,2,9,5,4,1,0,0,0
"May 16, 2019 10:00 AM",83,60,23,,,,,,,,,,6,2,4,3,,,,13,8,5,39,21,12,3,9,38,5,5,1,1,0,0,0,0
"May 16, 2019 11:00 AM",67,39,28,,,,,,,,,,11,4,7,4,,,,16,14,2,27,17,16,3,13,40,1,2,1,0,1,0,0,0
"May 16, 2019 12:00 PM",72,31,41,,,,,,,,,,8,7,1,11,,,,23,20,3,22,14,24,8,16,29,2,4,0,0,0,0,0,0
"May 16, 2019 1:00 PM",91,38,53,,,,,,,,,,13,4,9,4,,,,20,18,2,19,25,24,8,16,29,6,5,1,0,1,2,1,1
"May 16, 2019 2:00 PM",87,44,43,,,,,,,,,,21,14,7,9,,,,29,27,2,30,27,18,5,13,34,3,3,4,1,3,3,2,1
"May 16, 2019 3:00 PM",70,25,45,,,,,,,,,,17,15,2,13,,,,43,39,4,27,33,31,8,23,29,3,1,3,3,0,2,1,1
"May 16, 2019 4:00 PM",171,55,116,,,,,,,,,,22,10,12,21,,,,86,82,4,39,83,39,9,30,30,3,1,4,2,2,1,1,0
"May 16, 2019 5:00 PM",377,86,291,,,,,,,,,,32,23,9,40,,,,176,170,6,47,197,111,25,86,76,7,3,9,4,5,0,0,0
"May 16, 2019 6:00 PM",316,56,260,,,,,,,,,,25,18,7,24,,,,172,164,8,45,200,100,17,83,66,3,5,6,1,5,2,1,1
"May 16, 2019 7:00 PM",158,35,123,,,,,,,,,,18,11,7,18,,,,74,72,2,29,89,51,10,41,30,5,3,5,2,3,3,2,1
"May 16, 2019 8:00 PM",121,31,90,,,,,,,,,,13,13,0,8,,,,52,50,2,11,46,19,3,16,28,7,2,6,4,2,4,4,0
"May 16, 2019 9:00 PM",71,20,51,,,,,,,,,,8,5,3,9,,,,30,29,1,7,31,19,9,10,26,1,1,9,3,6,0,0,0
"May 16, 2019 10:00 PM",74,12,62,,,,,,,,,,4,3,1,1,,,,24,23,1,2,15,13,7,6,13,3,0,0,0,0,0,0,0
"May 16, 2019 11:00 PM",31,6,25,,,,,,,,,,5,5,0,1,,,,11,10,1,4,12,4,2,2,5,0,0,0,0,0,0,0,0
"May 17, 2019 12:00 AM",16,5,11,,,,,,,,,,0,0,0,2,,,,7,7,0,7,11,1,0,1,3,0,0,0,0,0,0,0,0
"May 17, 2019 1:00 AM",9,2,7,,,,,,,,,,0,0,0,0,,,,5,5,0,3,3,1,1,0,3,0,0,0,0,0,0,0,0
"May 17, 2019 2:00 AM",2,1,1,,,,,,,,,,0,0,0,0,,,,2,2,0,0,2,0,0,0,0,0,0,0,0,0,0,0,0
"May 17, 2019 3:00 AM",2,0,2,,,,,,,,,,0,0,0,0,,,,1,1,0,0,0,0,0,0,1,0,0,0,0,0,0,0,0
"May 17, 2019 4:00 AM",1,0,1,,,,,,,,,,0,0,0,0,,,,0,0,0,1,0,0,0,0,1,1,0,0,0,0,0,0,0
"May 17, 2019 5:00 AM",12,9,3,,,,,,,,,,0,0,0,1,,,,0,0,0,9,9,0,0,0,11,1,0,0,0,0,0,0,0
"May 17, 2019 6:00 AM",53,38,15,,,,,,,,,,5,0,5,4,,,,4,3,1,26,19,9,7,2,44,2,1,2,1,1,1,0,1
"May 17, 2019 7:00 AM",184,137,47,,,,,,,,,,9,3,6,22,,,,23,22,1,94,42,37,27,10,155,6,4,4,3,1,0,0,0
"May 17, 2019 8:00 AM",346,275,71,,,,,,,,,,25,6,19,22,,,,44,27,17,232,69,82,68,14,255,9,8,13,13,0,1,0,1
"May 17, 2019 9:00 AM",180,145,35,,,,,,,,,,20,7,13,5,,,,31,20,11,88,35,40,24,16,90,7,5,3,2,1,4,1,3
"May 17, 2019 10:00 AM",60,39,21,,,,,,,,,,7,2,5,3,,,,18,11,7,33,13,8,3,5,27,4,2,4,3,1,2,1,1
"May 17, 2019 11:00 AM",66,37,29,,,,,,,,,,7,5,2,2,,,,21,15,6,19,13,7,1,6,22,1,1,4,2,2,1,1,0
"May 17, 2019 12:00 PM",61,29,32,,,,,,,,,,4,2,2,6,,,,14,14,0,18,21,6,3,3,13,0,0,0,0,0,2,1,1
"May 17, 2019 1:00 PM",82,27,55,,,,,,,,,,8,6,2,9,,,,10,9,1,21,27,8,3,5,25,2,1,1,0,1,1,1,0
"May 17, 2019 2:00 PM",88,41,47,,,,,,,,,,19,16,3,2,,,,27,24,3,17,24,4,1,3,10,4,1,2,1,1,2,1,1
"May 17, 2019 3:00 PM",104,35,69,,,,,,,,,,3,3,0,7,,,,18,17,1,27,33,18,2,16,27,3,1,8,5,3,4,4,0
"May 17, 2019 4:00 PM",137,36,101,,,,,,,,,,11,9,2,13,,,,74,69,5,23,87,35,5,30,36,3,2,2,1,1,1,1,0
"May 17, 2019 5:00 PM",291,78,213,,,,,,,,,,17,12,5,26,,,,155,150,5,36,146,66,8,58,60,6,2,4,2,2,0,0,0
"May 17, 2019 6:00 PM",219,60,159,,,,,,,,,,16,13,3,15,,,,98,94,4,33,121,66,13,53,34,7,5,5,2,3,2,1,1
"May 17, 2019 7:00 PM",122,38,84,,,,,,,,,,10,7,3,20,,,,61,60,1,19,53,14,3,11,23,6,3,5,3,2,1,0,1
"May 17, 2019 8:00 PM",74,24,50,,,,,,,,,,4,2,2,25,,,,35,33,2,14,27,11,2,9,16,3,0,3,0,3,3,1,2
"May 17, 2019 9:00 PM",57,16,41,,,,,,,,,,0,0,0,14,,,,17,15,2,6,18,8,4,4,12,0,1,1,0,1,1,1,0
"May 17, 2019 10:00 PM",40,10,30,,,,,,,,,,3,2,1,8,,,,8,8,0,3,6,4,2,2,11,0,0,2,2,0,0,0,0
"May 17, 2019 11:00 PM",33,7,26,,,,,,,,,,5,5,0,1,,,,17,16,1,4,3,9,5,4,8,0,0,1,0,1,0,0,0
"May 18, 2019 12:00 AM",17,4,13,,,,,,,,,,4,2,2,0,,,,8,8,0,4,7,2,2,0,6,0,0,0,0,0,0,0,0
"May 18, 2019 1:00 AM",13,6,7,,,,,,,,,,0,0,0,0,,,,9,9,0,2,2,1,0,1,2,0,0,1,1,0,0,0,0
"May 18, 2019 2:00 AM",4,2,2,,,,,,,,,,0,0,0,0,,,,4,4,0,1,2,2,1,1,0,0,1,0,0,0,1,0,1
"May 18, 2019 3:00 AM",3,0,3,,,,,,,,,,0,0,0,0,,,,2,2,0,0,2,0,0,0,3,0,2,0,0,0,0,0,0
"May 18, 2019 4:00 AM",3,1,2,,,,,,,,,,1,0,1,0,,,,2,2,0,0,0,0,0,0,2,0,0,3,1,2,1,0,1
"May 18, 2019 5:00 AM",2,0,2,,,,,,,,,,0,0,0,2,,,,2,2,0,1,3,1,0,1,1,0,0,0,0,0,0,0,0
"May 18, 2019 6:00 AM",9,3,6,,,,,,,,,,2,2,0,3,,,,1,1,0,5,8,6,4,2,7,1,0,1,0,1,0,0,0
"May 18, 2019 7:00 AM",35,22,13,,,,,,,,,,4,1,3,3,,,,8,6,2,7,15,5,3,2,17,2,3,0,0,0,0,0,0
"May 18, 2019 8:00 AM",54,38,16,,,,,,,,,,12,2,10,5,,,,16,12,4,27,20,11,6,5,24,5,1,2,1,1,1,1,0
"May 18, 2019 9:00 AM",53,35,18,,,,,,,,,,7,2,5,8,,,,22,19,3,17,22,15,4,11,27,2,4,2,1,1,1,1,0
"May 18, 2019 10:00 AM",45,26,19,,,,,,,,,,15,8,7,10,,,,15,10,5,25,24,22,11,11,24,7,8,7,3,4,0,0,0
"May 18, 2019 11:00 AM",76,44,32,,,,,,,,,,28,9,19,10,,,,18,14,4,23,32,16,4,12,40,7,7,3,2,1,1,0,1
"May 18, 2019 12:00 PM",72,41,31,,,,,,,,,,25,15,10,16,,,,21,18,3,17,17,30,18,12,36,7,8,4,2,2,1,1,0
"May 18, 2019 1:00 PM",77,49,28,,,,,,,,,,20,10,10,8,,,,21,17,4,28,24,36,12,24,30,9,1,1,1,0,1,1,0
"May 18, 2019 2:00 PM",73,34,39,,,,,,,,,,14,12,2,8,,,,17,17,0,19,13,28,12,16,35,3,0,2,2,0,0,0,0
"May 18, 2019 3:00 PM",44,22,22,,,,,,,,,,12,9,3,8,,,,11,10,1,20,17,27,12,15,19,4,4,6,2,4,3,2,1
"May 18, 2019 4:00 PM",59,22,37,,,,,,,,,,11,4,7,7,,,,29,25,4,13,22,23,9,14,14,3,3,4,4,0,1,1,0
"May 18, 2019 5:00 PM",67,19,48,,,,,,,,,,16,12,4,5,,,,23,22,1,9,15,10,5,5,16,0,2,4,3,1,0,0,0
"May 18, 2019 6:00 PM",47,13,34,,,,,,,,,,13,11,2,12,,,,10,9,1,10,18,12,5,7,11,2,1,5,1,4,3,2,1
"May 18, 2019 7:00 PM",30,17,13,,,,,,,,,,7,3,4,8,,,,9,6,3,6,13,4,3,1,10,1,0,11,6,5,2,2,0
"May 18, 2019 8:00 PM",22,7,15,,,,,,,,,,10,7,3,10,,,,8,7,1,7,9,6,3,3,9,0,1,5,2,3,0,0,0
"May 18, 2019 9:00 PM",16,6,10,,,,,,,,,,1,1,0,6,,,,6,6,0,6,6,7,3,4,7,2,0,5,2,3,0,0,0
"May 18, 2019 10:00 PM",17,8,9,,,,,,,,,,2,2,0,6,,,,4,4,0,2,8,0,0,0,11,0,2,0,0,0,0,0,0
"May 18, 2019 11:00 PM",19,7,12,,,,,,,,,,1,1,0,1,,,,8,8,0,8,3,1,1,0,6,2,0,0,0,0,0,0,0
"May 19, 2019 12:00 AM",8,4,4,,,,,,,,,,1,1,0,4,,,,4,4,0,3,4,0,0,0,6,0,0,0,0,0,0,0,0
"May 19, 2019 1:00 AM",5,2,3,,,,,,,,,,1,1,0,1,,,,2,2,0,3,2,2,1,1,4,0,1,0,0,0,0,0,0
"May 19, 2019 2:00 AM",6,4,2,,,,,,,,,,0,0,0,0,,,,3,2,1,1,0,1,1,0,2,0,0,0,0,0,0,0,0
"May 19, 2019 3:00 AM",7,2,5,,,,,,,,,,0,0,0,2,,,,4,1,3,0,0,0,0,0,0,0,2,0,0,0,0,0,0
"May 19, 2019 4:00 AM",4,0,4,,,,,,,,,,1,0,1,0,,,,2,2,0,3,0,2,0,2,3,0,0,0,0,0,0,0,0
"May 19, 2019 5:00 AM",2,0,2,,,,,,,,,,0,0,0,0,,,,2,2,0,0,4,1,0,1,0,0,0,0,0,0,0,0,0
"May 19, 2019 6:00 AM",8,1,7,,,,,,,,,,0,0,0,0,,,,5,5,0,4,7,1,1,0,8,1,1,0,0,0,0,0,0
"May 19, 2019 7:00 AM",14,8,6,,,,,,,,,,1,1,0,1,,,,7,4,3,7,11,4,3,1,16,4,4,0,0,0,0,0,0
"May 19, 2019 8:00 AM",7,6,1,,,,,,,,,,10,2,8,8,,,,9,8,1,9,25,6,2,4,19,0,16,1,0,1,0,0,0
"May 19, 2019 9:00 AM",40,21,19,,,,,,,,,,3,1,2,3,,,,13,10,3,15,24,19,8,11,33,4,15,3,3,0,0,0,0
"May 19, 2019 10:00 AM",53,23,30,,,,,,,,,,15,6,9,12,,,,13,11,2,24,23,23,7,16,71,5,7,5,2,3,4,1,3
"May 19, 2019 11:00 AM",46,20,26,,,,,,,,,,28,6,22,14,,,,13,8,5,18,22,28,5,23,46,8,5,3,2,1,2,2,0
"May 19, 2019 12:00 PM",63,37,26,,,,,,,,,,28,12,16,19,,,,23,23,0,17,37,24,5,19,29,11,1,6,4,2,2,1,1
"May 19, 2019 1:00 PM",64,36,28,,,,,,,,,,31,15,16,18,,,,17,13,4,22,23,35,17,18,39,12,1,6,2,4,3,3,0
"May 19, 2019 2:00 PM",40,25,15,,,,,,,,,,40,27,13,18,,,,10,9,1,17,22,33,10,23,27,4,5,4,3,1,0,0,0
"May 19, 2019 3:00 PM",40,16,24,,,,,,,,,,22,12,10,10,,,,36,35,1,18,19,27,12,15,27,5,4,6,2,4,0,0,0
"May 19, 2019 4:00 PM",41,21,20,,,,,,,,,,24,16,8,12,,,,9,8,1,13,15,11,4,7,23,2,2,3,1,2,3,1,2
"May 19, 2019 5:00 PM",37,16,21,,,,,,,,,,13,10,3,12,,,,11,9,2,9,9,33,13,20,17,1,3,7,3,4,1,0,1
"May 19, 2019 6:00 PM",38,18,20,,,,,,,,,,15,13,2,14,,,,10,10,0,14,15,13,9,4,25,3,2,4,2,2,4,4,0
"May 19, 2019 7:00 PM",37,17,20,,,,,,,,,,2,2,0,6,,,,15,15,0,7,12,9,5,4,11,1,1,2,2,0,1,1,0
"May 19, 2019 8:00 PM",26,10,16,,,,,,,,,,3,0,3,16,,,,15,15,0,12,8,8,7,1,14,2,1,4,2,2,2,2,0
"May 19, 2019 9:00 PM",26,12,14,,,,,,,,,,4,4,0,8,,,,6,6,0,8,7,5,2,3,7,1,0,1,1,0,0,0,0
"May 19, 2019 10:00 PM",16,6,10,,,,,,,,,,6,4,2,4,,,,4,4,0,4,2,1,1,0,6,0,2,2,1,1,0,0,0
"May 19, 2019 11:00 PM",12,5,7,,,,,,,,,,0,0,0,1,,,,7,6,1,1,0,1,1,0,4,0,1,0,0,0,0,0,0
"May 20, 2019 12:00 AM",6,1,5,,,,,,,,,,2,2,0,0,,,,1,1,0,2,3,0,0,0,2,0,0,1,0,1,0,0,0
"May 20, 2019 1:00 AM",5,2,3,,,,,,,,,,2,1,1,0,,,,1,1,0,0,0,0,0,0,1,0,0,0,0,0,0,0,0
"May 20, 2019 2:00 AM",4,2,2,,,,,,,,,,2,1,1,0,,,,2,1,1,0,5,1,1,0,0,0,0,0,0,0,0,0,0
"May 20, 2019 3:00 AM",1,0,1,,,,,,,,,,1,1,0,0,,,,1,1,0,1,1,0,0,0,1,0,0,0,0,0,0,0,0
"May 20, 2019 4:00 AM",5,2,3,,,,,,,,,,1,0,1,0,,,,3,3,0,1,1,0,0,0,0,0,0,0,0,0,0,0,0
"May 20, 2019 5:00 AM",15,9,6,,,,,,,,,,1,1,0,1,,,,1,1,0,7,5,4,3,1,18,2,0,0,0,0,0,0,0
"May 20, 2019 6:00 AM",70,51,19,,,,,,,,,,5,2,3,3,,,,4,3,1,35,22,17,12,5,52,1,1,3,0,3,0,0,0
"May 20, 2019 7:00 AM",199,156,43,,,,,,,,,,4,1,3,11,,,,30,25,5,152,45,56,40,16,216,3,4,4,3,1,0,0,0
"May 20, 2019 8:00 AM",411,336,75,,,,,,,,,,35,6,29,37,,,,67,46,21,282,81,115,88,27,399,12,7,14,11,3,2,1,1
"May 20, 2019 9:00 AM",215,173,42,,,,,,,,,,19,7,12,15,,,,22,10,12,107,29,52,33,19,135,5,6,3,3,0,1,0,1
"May 20, 2019 10:00 AM",66,41,25,,,,,,,,,,18,7,11,6,,,,17,13,4,44,11,18,13,5,41,4,8,6,4,2,1,0,1
"May 20, 2019 11:00 AM",42,26,16,,,,,,,,,,14,7,7,9,,,,7,6,1,34,11,15,10,5,26,1,3,1,0,1,0,0,0
"May 20, 2019 12:00 PM",65,27,38,,,,,,,,,,25,16,9,11,,,,21,15,6,12,19,14,4,10,29,2,2,2,2,0,0,0,0
"May 20, 2019 1:00 PM",67,36,31,,,,,,,,,,14,7,7,11,,,,25,23,2,19,26,32,8,24,29,0,1,1,0,1,0,0,0
"May 20, 2019 2:00 PM",74,29,45,,,,,,,,,,15,10,5,17,,,,21,18,3,16,23,20,6,14,17,4,4,5,3,2,0,0,0
"May 20, 2019 3:00 PM",74,20,54,,,,,,,,,,19,16,3,5,,,,29,25,4,19,47,17,7,10,23,7,5,3,2,1,0,0,0
"May 20, 2019 4:00 PM",171,53,118,,,,,,,,,,9,7,2,11,,,,80,74,6,24,86,53,7,46,38,4,2,11,5,6,7,6,1
"May 20, 2019 5:00 PM",301,59,242,,,,,,,,,,25,17,8,16,,,,170,164,6,39,216,97,17,80,100,11,4,5,4,1,0,0,0
"May 20, 2019 6:00 PM",331,64,267,,,,,,,,,,16,14,2,31,,,,201,194,7,43,204,95,7,88,51,6,8,11,7,4,6,2,4
"May 20, 2019 7:00 PM",150,32,118,,,,,,,,,,16,11,5,14,,,,82,81,1,21,78,45,9,36,24,3,5,4,2,2,2,2,0
"May 20, 2019 8:00 PM",95,30,65,,,,,,,,,,13,9,4,13,,,,44,42,2,14,41,20,2,18,22,3,1,3,1,2,6,5,1
"May 20, 2019 9:00 PM",54,11,43,,,,,,,,,,6,4,2,7,,,,19,19,0,17,19,12,4,8,19,5,0,6,3,3,2,1,1
"May 20, 2019 10:00 PM",43,11,32,,,,,,,,,,6,3,3,0,,,,11,11,0,4,13,3,1,2,14,0,1,2,2,0,0,0,0
"May 20, 2019 11:00 PM",16,4,12,,,,,,,,,,1,1,0,0,,,,4,4,0,3,8,2,1,1,5,0,0,0,0,0,0,0,0
"May 21, 2019 12:00 AM",7,1,6,,,,,,,,,,0,0,0,0,,,,6,6,0,1,2,1,0,1,3,0,0,0,0,0,0,0,0
"May 21, 2019 1:00 AM",2,0,2,,,,,,,,,,0,0,0,1,,,,2,2,0,0,1,1,0,1,0,0,0,1,0,1,0,0,0
"May 21, 2019 2:00 AM",1,0,1,,,,,,,,,,0,0,0,0,,,,3,3,0,0,0,0,0,0,0,0,1,0,0,0,0,0,0
"May 21, 2019 3:00 AM",3,1,2,,,,,,,,,,0,0,0,0,,,,1,1,0,0,1,0,0,0,1,0,0,0,0,0,0,0,0
"May 21, 2019 4:00 AM",6,4,2,,,,,,,,,,1,1,0,0,,,,1,1,0,1,0,0,0,0,0,0,0,0,0,0,0,0,0
"May 21, 2019 5:00 AM",7,4,3,,,,,,,,,,1,1,0,2,,,,1,1,0,7,6,2,1,1,18,2,0,0,0,0,0,0,0
"May 21, 2019 6:00 AM",61,46,15,,,,,,,,,,6,0,6,7,,,,8,6,2,29,32,15,10,5,61,1,5,2,1,1,2,0,2
"May 21, 2019 7:00 AM",225,167,58,,,,,,,,,,17,6,11,18,,,,38,34,4,183,62,60,42,18,232,5,3,4,3,1,0,0,0
"May 21, 2019 8:00 AM",455,360,95,,,,,,,,,,41,14,27,32,,,,55,45,10,299,81,114,93,21,373,9,9,10,8,2,0,0,0
"May 21, 2019 9:00 AM",210,177,33,,,,,,,,,,18,3,15,11,,,,31,19,12,107,40,45,32,13,130,6,11,6,4,2,0,0,0
"May 21, 2019 10:00 AM",60,34,26,,,,,,,,,,10,4,6,11,,,,11,8,3,33,19,22,7,15,36,4,4,4,1,3,2,1,1
"May 21, 2019 11:00 AM",42,27,15,,,,,,,,,,16,8,8,8,,,,12,10,2,20,17,27,10,17,25,2,3,1,1,0,0,0,0
"May 21, 2019 12:00 PM",69,33,36,,,,,,,,,,15,9,6,10,,,,16,15,1,25,20,26,12,14,27,3,1,5,4,1,4,1,3
"May 21, 2019 1:00 PM",64,37,27,,,,,,,,,,11,8,3,7,,,,22,19,3,23,26,36,15,21,25,4,2,1,0,1,0,0,0
"May 21, 2019 2:00 PM",71,33,38,,,,,,,,,,10,7,3,16,,,,23,19,4,14,27,28,14,14,21,4,2,2,1,1,1,0,1
"May 21, 2019 3:00 PM",71,29,42,,,,,,,,,,27,13,14,11,,,,24,22,2,19,40,25,5,20,25,8,2,3,2,1,1,1,0
"May 21, 2019 4:00 PM",188,60,128,,,,,,,,,,15,12,3,18,,,,69,67,2,35,92,58,10,48,46,2,3,5,3,2,5,3,2
"May 21, 2019 5:00 PM",377,90,287,,,,,,,,,,17,12,5,36,,,,163,160,3,46,236,88,17,71,96,11,1,15,3,12,4,4,0
"May 21, 2019 6:00 PM",346,69,277,,,,,,,,,,27,17,10,38,,,,221,218,3,51,224,113,14,99,69,3,3,4,3,1,2,1,1
"May 21, 2019 7:00 PM",169,41,128,,,,,,,,,,14,9,5,20,,,,77,73,4,31,84,58,13,45,42,1,3,1,0,1,1,1,0
"May 21, 2019 8:00 PM",117,31,86,,,,,,,,,,17,14,3,15,,,,52,51,1,22,55,28,5,23,34,4,5,7,3,4,3,1,2
"May 21, 2019 9:00 PM",70,17,53,,,,,,,,,,13,5,8,2,,,,30,29,1,12,28,10,2,8,34,3,1,1,1,0,2,2,0
"May 21, 2019 10:00 PM",52,14,38,,,,,,,,,,5,5,0,2,,,,23,21,2,6,10,7,3,4,15,0,1,1,0,1,2,1,1
"May 21, 2019 11:00 PM",24,6,18,,,,,,,,,,1,1,0,1,,,,13,13,0,1,10,8,3,5,3,1,0,1,1,0,2,1,1
"May 22, 2019 12:00 AM",10,0,10,,,,,,,,,,0,0,0,0,,,,6,6,0,3,6,3,0,3,4,2,0,0,0,0,0,0,0
"May 22, 2019 1:00 AM",8,0,8,,,,,,,,,,0,0,0,5,,,,1,1,0,0,1,2,2,0,3,0,0,0,0,0,0,0,0
"May 22, 2019 2:00 AM",3,1,2,,,,,,,,,,0,0,0,0,,,,2,2,0,0,0,0,0,0,0,0,0,0,0,0,0,0,0
"May 22, 2019 3:00 AM",2,2,0,,,,,,,,,,0,0,0,1,,,,1,1,0,0,0,0,0,0,1,0,0,0,0,0,0,0,0
"May 22, 2019 4:00 AM",1,0,1,,,,,,,,,,0,0,0,0,,,,3,3,0,1,1,0,0,0,1,0,0,0,0,0,0,0,0
"May 22, 2019 5:00 AM",9,6,3,,,,,,,,,,0,0,0,2,,,,1,1,0,9,4,3,1,2,16,2,0,0,0,0,0,0,0
"May 22, 2019 6:00 AM",65,44,21,,,,,,,,,,3,2,1,4,,,,7,6,1,31,24,11,7,4,58,0,2,4,3,1,1,0,1
"May 22, 2019 7:00 AM",254,186,68,,,,,,,,,,15,5,10,15,,,,44,36,8,163,46,47,32,15,191,3,2,4,4,0,0,0,0
"May 22, 2019 8:00 AM",423,355,68,,,,,,,,,,32,7,25,29,,,,55,43,12,271,87,113,81,32,362,9,7,8,8,0,1,0,1
"May 22, 2019 9:00 AM",196,159,37,,,,,,,,,,15,5,10,9,,,,27,18,9,106,29,50,35,15,126,7,5,9,7,2,5,0,5
"May 22, 2019 10:00 AM",53,34,19,,,,,,,,,,8,2,6,10,,,,13,10,3,35,17,18,10,8,28,4,4,3,2,1,0,0,0
"May 22, 2019 11:00 AM",49,39,10,,,,,,,,,,15,8,7,6,,,,16,13,3,26,14,14,7,7,33,3,4,3,0,3,2,1,1
"May 22, 2019 12:00 PM",62,29,33,,,,,,,,,,24,19,5,10,,,,19,17,2,24,20,12,6,6,32,2,2,2,1,1,3,2,1
"May 22, 2019 1:00 PM",80,41,39,,,,,,,,,,15,8,7,12,,,,28,24,4,18,35,26,9,17,31,5,3,5,0,5,4,3,1
"May 22, 2019 2:00 PM",80,31,49,,,,,,,,,,16,13,3,15,,,,26,23,3,20,27,28,14,14,15,2,0,5,0,5,4,3,1
"May 22, 2019 3:00 PM",67,31,36,,,,,,,,,,14,9,5,18,,,,39,36,3,23,42,25,7,18,24,3,6,4,3,1,1,0,1
"May 22, 2019 4:00 PM",153,48,105,,,,,,,,,,15,8,7,12,,,,51,49,2,29,80,44,9,35,36,5,4,1,0,1,3,3,0
"May 22, 2019 5:00 PM",357,96,261,,,,,,,,,,17,10,7,30,,,,167,162,5,44,203,88,18,70,94,13,2,10,7,3,1,1,0
"May 22, 2019 6:00 PM",330,54,276,,,,,,,,,,26,20,6,30,,,,195,195,0,42,185,101,11,90,65,7,9,8,5,3,4,2,2
"May 22, 2019 7:00 PM",128,51,77,,,,,,,,,,16,11,5,16,,,,84,82,2,38,78,46,8,38,41,6,4,6,4,2,2,1,1
"May 22, 2019 8:00 PM",113,31,82,,,,,,,,,,9,5,4,12,,,,35,34,1,16,33,34,10,24,25,0,0,0,0,0,0,0,0
"May 22, 2019 9:00 PM",72,16,56,,,,,,,,,,7,4,3,10,,,,30,30,0,14,27,16,5,11,22,1,0,4,4,0,2,2,0
"May 22, 2019 10:00 PM",51,15,36,,,,,,,,,,6,3,3,5,,,,21,21,0,3,18,5,1,4,15,2,2,1,0,1,0,0,0
"May 22, 2019 11:00 PM",20,6,14,,,,,,,,,,2,2,0,0,,,,13,13,0,4,5,6,4,2,3,0,0,0,0,0,0,0,0
"May 23, 2019 12:00 AM",10,1,9,,,,,,,,,,2,2,0,0,,,,6,6,0,2,4,3,1,2,6,0,1,0,0,0,0,0,0
"May 23, 2019 1:00 AM",5,1,4,,,,,,,,,,2,2,0,0,,,,4,4,0,0,1,1,0,1,4,0,0,0,0,0,0,0,0
"May 23, 2019 2:00 AM",9,4,5,,,,,,,,,,0,0,0,0,,,,0,0,0,0,2,1,0,1,0,0,0,0,0,0,0,0,0
"May 23, 2019 3:00 AM",0,0,0,,,,,,,,,,0,0,0,0,,,,0,0,0,0,2,0,0,0,2,0,0,0,0,0,0,0,0
"May 23, 2019 4:00 AM",3,1,2,,,,,,,,,,0,0,0,0,,,,3,3,0,1,0,0,0,0,0,0,0,0,0,0,0,0,0
"May 23, 2019 5:00 AM",10,7,3,,,,,,,,,,0,0,0,0,,,,1,1,0,6,4,3,1,2,13,2,0,0,0,0,0,0,0
"May 23, 2019 6:00 AM",59,42,17,,,,,,,,,,2,0,2,0,,,,10,9,1,24,25,8,4,4,49,1,1,2,1,1,1,0,1
"May 23, 2019 7:00 AM",199,144,55,,,,,,,,,,10,6,4,0,,,,33,26,7,120,43,41,32,9,194,3,6,1,1,0,0,0,0
"May 23, 2019 8:00 AM",423,344,79,,,,,,,,,,32,14,18,0,,,,38,28,10,235,73,104,71,33,291,12,12,11,10,1,2,0,2
"May 23, 2019 9:00 AM",201,165,36,,,,,,,,,,20,8,12,0,,,,23,14,9,78,37,43,26,17,117,3,5,6,4,2,0,0,0
"May 23, 2019 10:00 AM",70,47,23,,,,,,,,,,11,5,6,0,,,,12,6,6,39,9,12,9,3,30,1,5,2,1,1,0,0,0
"May 23, 2019 11:00 AM",41,22,19,,,,,,,,,,11,6,5,0,,,,8,6,2,30,18,8,3,5,26,2,2,2,2,0,2,1,1
"May 23, 2019 12:00 PM",47,24,23,,,,,,,,,,12,7,5,0,,,,22,20,2,11,21,10,6,4,14,1,3,2,1,1,0,0,0
"May 23, 2019 1:00 PM",74,28,46,,,,,,,,,,7,2,5,0,,,,16,16,0,14,24,16,4,12,25,0,1,2,0,2,1,1,0
"May 23, 2019 2:00 PM",59,30,29,,,,,,,,,,12,10,2,0,,,,20,18,2,15,12,20,3,17,15,2,1,3,1,2,0,0,0
"May 23, 2019 3:00 PM",65,24,41,,,,,,,,,,10,2,8,0,,,,31,25,6,21,33,23,8,15,18,2,2,4,1,3,1,1,0
"May 23, 2019 4:00 PM",146,43,103,,,,,,,,,,8,7,1,0,,,,65,61,4,26,74,33,6,27,45,6,2,7,5,2,3,2,1
"May 23, 2019 5:00 PM",331,75,256,,,,,,,,,,22,16,6,0,,,,148,148,0,41,174,97,22,75,71,7,4,9,6,3,5,2,3
"May 23, 2019 6:00 PM",276,54,222,,,,,,,,,,22,21,1,0,,,,151,146,5,46,150,80,15,65,59,8,7,12,5,7,0,0,0
"May 23, 2019 7:00 PM",137,33,104,,,,,,,,,,20,18,2,0,,,,59,56,3,27,71,42,7,35,31,1,1,6,3,3,3,3,0
"May 23, 2019 8:00 PM",88,22,66,,,,,,,,,,11,6,5,0,,,,50,50,0,22,33,16,4,12,21,4,3,10,5,5,0,0,0
"May 23, 2019 9:00 PM",59,17,42,,,,,,,,,,10,6,4,0,,,,26,25,1,9,26,11,3,8,13,2,0,6,3,3,1,1,0
"May 23, 2019 10:00 PM",42,6,36,,,,,,,,,,3,3,0,0,,,,22,22,0,7,10,11,6,5,13,1,0,3,2,1,0,0,0
"May 23, 2019 11:00 PM",26,5,21,,,,,,,,,,2,2,0,0,,,,12,12,0,7,4,8,4,4,9,1,0,1,1,0,0,0,0
"May 24, 2019 12:00 AM",10,1,9,,,,,,,,,,1,0,1,0,,,,4,4,0,2,8,3,0,3,9,0,2,1,1,0,0,0,0
"May 24, 2019 1:00 AM",6,0,6,,,,,,,,,,2,2,0,0,,,,5,5,0,0,2,0,0,0,3,0,0,2,1,1,0,0,0
"May 24, 2019 2:00 AM",6,1,5,,,,,,,,,,2,0,2,0,,,,1,1,0,1,3,0,0,0,1,0,0,0,0,0,0,0,0
"May 24, 2019 3:00 AM",3,1,2,,,,,,,,,,0,0,0,0,,,,3,3,0,0,0,2,2,0,0,0,0,2,1,1,0,0,0
"May 24, 2019 4:00 AM",5,3,2,,,,,,,,,,1,0,1,0,,,,3,3,0,0,0,0,0,0,1,1,0,0,0,0,0,0,0
"May 24, 2019 5:00 AM",10,6,4,,,,,,,,,,1,1,0,0,,,,2,2,0,8,7,3,1,2,13,1,0,0,0,0,0,0,0
"May 24, 2019 6:00 AM",52,38,14,,,,,,,,,,3,0,3,0,,,,8,7,1,21,22,8,5,3,37,1,2,3,2,1,0,0,0
"May 24, 2019 7:00 AM",172,125,47,,,,,,,,,,11,2,9,0,,,,23,19,4,93,31,31,21,10,129,4,1,5,4,1,3,0,3
"May 24, 2019 8:00 AM",288,225,63,,,,,,,,,,16,7,9,0,,,,40,27,13,218,57,79,57,22,238,10,9,7,6,1,1,0,1
"May 24, 2019 9:00 AM",185,141,44,,,,,,,,,,22,9,13,0,,,,18,7,11,83,30,36,24,12,87,4,5,8,5,3,1,0,1
"May 24, 2019 10:00 AM",65,38,27,,,,,,,,,,15,7,8,0,,,,11,7,4,28,11,12,7,5,39,4,5,6,4,2,2,0,2
"May 24, 2019 11:00 AM",54,33,21,,,,,,,,,,8,5,3,0,,,,12,11,1,15,11,25,9,16,19,2,3,3,3,0,2,2,0
"May 24, 2019 12:00 PM",57,23,34,,,,,,,,,,14,9,5,0,,,,28,26,2,15,15,25,7,18,33,4,1,1,0,1,4,2,2
"May 24, 2019 1:00 PM",81,32,49,,,,,,,,,,14,7,7,0,,,,22,18,4,25,33,26,6,20,30,5,1,4,1,3,0,0,0
"May 24, 2019 2:00 PM",88,43,45,,,,,,,,,,22,12,10,0,,,,22,20,2,20,25,25,12,13,35,2,4,2,1,1,1,1,0
"May 24, 2019 3:00 PM",99,39,60,,,,,,,,,,13,8,5,0,,,,27,24,3,29,37,27,7,20,29,5,3,10,7,3,7,5,2
"May 24, 2019 4:00 PM",149,52,97,,,,,,,,,,18,13,5,0,,,,81,76,5,25,83,36,10,26,42,7,6,3,0,3,3,3,0
"May 24, 2019 5:00 PM",268,53,215,,,,,,,,,,19,13,6,0,,,,127,127,0,33,160,65,14,51,59,7,2,5,4,1,2,1,1
"May 24, 2019 6:00 PM",189,52,137,,,,,,,,,,14,11,3,0,,,,131,127,4,18,111,72,10,62,44,6,8,10,4,6,2,1,1
"May 24, 2019 7:00 PM",111,25,86,,,,,,,,,,11,10,1,0,,,,42,41,1,14,46,33,6,27,22,4,2,4,2,2,0,0,0
"May 24, 2019 8:00 PM",63,22,41,,,,,,,,,,2,1,1,0,,,,31,27,4,12,24,23,3,20,12,1,1,5,3,2,5,2,3
"May 24, 2019 9:00 PM",50,15,35,,,,,,,,,,5,0,5,0,,,,18,14,4,7,19,5,1,4,19,1,2,5,2,3,1,1,0
"May 24, 2019 10:00 PM",33,11,22,,,,,,,,,,4,3,1,0,,,,5,3,2,2,11,6,3,3,10,0,0,4,3,1,5,3,2
"May 24, 2019 11:00 PM",20,5,15,,,,,,,,,,1,1,0,0,,,,10,9,1,5,11,2,0,2,9,0,0,0,0,0,0,0,0
"May 25, 2019 12:00 AM",15,8,7,,,,,,,,,,1,0,1,0,,,,7,7,0,5,8,2,2,0,5,0,0,2,2,0,1,0,1
"May 25, 2019 1:00 AM",4,0,4,,,,,,,,,,0,0,0,0,,,,4,4,0,1,5,3,1,2,3,0,1,0,0,0,0,0,0
"May 25, 2019 2:00 AM",5,1,4,,,,,,,,,,1,1,0,0,,,,2,2,0,1,4,4,2,2,2,0,1,1,1,0,1,0,1
"May 25, 2019 3:00 AM",3,2,1,,,,,,,,,,1,1,0,0,,,,1,1,0,0,2,0,0,0,3,0,1,0,0,0,0,0,0
"May 25, 2019 4:00 AM",5,1,4,,,,,,,,,,1,0,1,0,,,,1,1,0,1,2,1,0,1,1,0,0,0,0,0,0,0,0
"May 25, 2019 5:00 AM",7,2,5,,,,,,,,,,0,0,0,0,,,,1,1,0,0,2,0,0,0,2,0,0,0,0,0,0,0,0
"May 25, 2019 6:00 AM",11,7,4,,,,,,,,,,2,1,1,0,,,,4,3,1,5,8,2,1,1,9,1,2,1,1,0,0,0,0
"May 25, 2019 7:00 AM",32,13,19,,,,,,,,,,0,0,0,0,,,,3,2,1,13,12,3,1,2,17,1,2,0,0,0,0,0,0
"May 25, 2019 8:00 AM",35,20,15,,,,,,,,,,15,8,7,0,,,,15,14,1,19,16,8,2,6,16,3,7,6,3,3,1,1,0
"May 25, 2019 9:00 AM",37,19,18,,,,,,,,,,14,3,11,0,,,,14,13,1,24,17,14,7,7,29,0,8,0,0,0,1,0,1
"May 25, 2019 10:00 AM",37,17,20,,,,,,,,,,20,5,15,0,,,,15,12,3,16,22,16,8,8,27,4,2,6,3,3,0,0,0
"May 25, 2019 11:00 AM",52,29,23,,,,,,,,,,23,6,17,0,,,,14,11,3,28,23,18,6,12,29,3,2,2,1,1,0,0,0
"May 25, 2019 12:00 PM",51,28,23,,,,,,,,,,19,13,6,0,,,,21,15,6,27,22,23,8,15,22,7,6,5,4,1,0,0,0
"May 25, 2019 1:00 PM",51,22,29,,,,,,,,,,22,8,14,0,,,,29,28,1,17,23,26,8,18,25,3,3,3,2,1,4,3,1
"May 25, 2019 2:00 PM",55,33,22,,,,,,,,,,12,6,6,0,,,,19,18,1,13,28,20,12,8,20,2,3,6,3,3,3,1,2
"May 25, 2019 3:00 PM",33,16,17,,,,,,,,,,26,15,11,0,,,,10,6,4,22,29,27,13,14,20,1,0,6,6,0,0,0,0
"May 25, 2019 4:00 PM",57,26,31,,,,,,,,,,23,10,13,0,,,,18,17,1,12,29,28,14,14,30,5,5,4,2,2,2,2,0
"May 25, 2019 5:00 PM",41,22,19,,,,,,,,,,19,11,8,0,,,,17,16,1,14,19,43,18,25,39,3,4,3,2,1,8,5,3
"May 25, 2019 6:00 PM",39,11,28,,,,,,,,,,11,7,4,0,,,,15,15,0,11,17,21,11,10,25,4,4,2,1,1,1,0,1
"May 25, 2019 7:00 PM",44,23,21,,,,,,,,,,11,5,6,0,,,,7,6,1,8,8,25,11,14,11,1,1,1,0,1,1,1,0
"May 25, 2019 8:00 PM",33,10,23,,,,,,,,,,13,5,8,0,,,,5,5,0,7,17,17,7,10,7,4,1,3,2,1,2,1,1
"May 25, 2019 9:00 PM",33,17,16,,,,,,,,,,8,4,4,0,,,,3,3,0,9,1,4,4,0,19,1,0,4,3,1,1,1,0
"May 25, 2019 10:00 PM",19,6,13,,,,,,,,,,0,0,0,0,,,,9,7,2,4,5,2,1,1,8,0,0,5,2,3,0,0,0
"May 25, 2019 11:00 PM",14,4,10,,,,,,,,,,0,0,0,0,,,,7,5,2,6,4,3,2,1,3,0,0,0,0,0,0,0,0
"May 26, 2019 12:00 AM",14,2,12,,,,,,,,,,3,3,0,0,,,,5,4,1,2,7,4,3,1,3,0,1,0,0,0,1,1,0
"May 26, 2019 1:00 AM",8,3,5,,,,,,,,,,1,1,0,0,,,,3,3,0,2,2,0,0,0,2,0,2,0,0,0,0,0,0
"May 26, 2019 2:00 AM",6,3,3,,,,,,,,,,1,0,1,0,,,,1,1,0,3,2,1,1,0,1,0,0,0,0,0,0,0,0
"May 26, 2019 3:00 AM",5,1,4,,,,,,,,,,0,0,0,0,,,,1,1,0,0,1,1,0,1,3,0,2,0,0,0,0,0,0
"May 26, 2019 4:00 AM",4,0,4,,,,,,,,,,1,0,1,0,,,,3,3,0,0,0,0,0,0,1,1,0,0,0,0,0,0,0
"May 26, 2019 5:00 AM",2,2,0,,,,,,,,,,2,2,0,0,,,,2,2,0,2,3,0,0,0,0,0,0,0,0,0,0,0,0
"May 26, 2019 6:00 AM",5,1,4,,,,,,,,,,1,1,0,0,,,,3,3,0,3,4,3,0,3,10,0,1,0,0,0,0,0,0
"May 26, 2019 7:00 AM",12,8,4,,,,,,,,,,4,3,1,0,,,,5,4,1,6,23,6,2,4,23,0,1,0,0,0,0,0,0
"May 26, 2019 8:00 AM",18,11,7,,,,,,,,,,10,2,8,0,,,,2,1,1,3,32,24,12,12,16,1,11,0,0,0,1,1,0
"May 26, 2019 9:00 AM",26,16,10,,,,,,,,,,12,8,4,0,,,,10,8,2,16,17,11,10,1,24,5,19,1,0,1,0,0,0
"May 26, 2019 10:00 AM",31,14,17,,,,,,,,,,20,8,12,0,,,,9,8,1,18,25,22,9,13,34,2,4,3,1,2,3,2,1
"May 26, 2019 11:00 AM",35,19,16,,,,,,,,,,20,7,13,0,,,,13,12,1,20,24,19,9,10,28,10,6,4,4,0,1,1,0
"May 26, 2019 12:00 PM",40,21,19,,,,,,,,,,15,8,7,0,,,,9,8,1,21,17,20,10,10,28,4,4,4,2,2,1,1,0
"May 26, 2019 1:00 PM",42,20,22,,,,,,,,,,31,24,7,0,,,,13,13,0,21,20,19,3,16,32,10,1,1,1,0,0,0,0
"May 26, 2019 2:00 PM",37,20,17,,,,,,,,,,32,22,10,0,,,,19,19,0,13,18,16,7,9,29,7,1,3,3,0,3,3,0
"May 26, 2019 3:00 PM",48,22,26,,,,,,,,,,46,28,18,0,,,,16,16,0,12,19,23,3,20,33,11,4,2,2,0,0,0,0
"May 26, 2019 4:00 PM",57,23,34,,,,,,,,,,38,17,21,0,,,,7,7,0,13,19,49,12,37,34,5,3,4,3,1,0,0,0
"May 26, 2019 5:00 PM",48,22,26,,,,,,,,,,23,7,16,0,,,,18,14,4,17,29,30,11,19,28,5,1,3,1,2,0,0,0
"May 26, 2019 6:00 PM",44,23,21,,,,,,,,,,14,7,7,0,,,,13,13,0,10,18,39,27,12,40,0,0,2,0,2,1,1,0
"May 26, 2019 7:00 PM",48,21,27,,,,,,,,,,8,3,5,0,,,,7,7,0,15,17,29,18,11,15,2,3,7,5,2,0,0,0
"May 26, 2019 8:00 PM",33,14,19,,,,,,,,,,7,6,1,0,,,,7,7,0,9,8,8,6,2,17,0,1,0,0,0,0,0,0
"May 26, 2019 9:00 PM",34,10,24,,,,,,,,,,8,5,3,0,,,,9,8,1,3,8,4,1,3,13,0,0,3,2,1,0,0,0
"May 26, 2019 10:00 PM",12,3,9,,,,,,,,,,8,5,3,0,,,,7,7,0,1,1,2,2,0,10,1,0,2,0,2,0,0,0
"May 26, 2019 11:00 PM",8,4,4,,,,,,,,,,1,1,0,0,,,,8,8,0,2,3,1,1,0,8,0,1,0,0,0,0,0,0
"May 27, 2019 12:00 AM",8,2,6,,,,,,,,,,2,0,2,0,,,,3,2,1,3,4,0,0,0,0,0,1,0,0,0,0,0,0
"May 27, 2019 1:00 AM",2,0,2,,,,,,,,,,0,0,0,0,,,,2,1,1,0,1,1,1,0,0,0,0,0,0,0,0,0,0
"May 27, 2019 2:00 AM",2,2,0,,,,,,,,,,0,0,0,0,,,,1,1,0,0,1,1,0,1,0,0,0,0,0,0,0,0,0
"May 27, 2019 3:00 AM",0,0,0,,,,,,,,,,1,1,0,0,,,,0,0,0,1,0,0,0,0,2,0,0,0,0,0,0,0,0
"May 27, 2019 4:00 AM",2,0,2,,,,,,,,,,1,1,0,0,,,,0,0,0,2,0,0,0,0,0,0,0,0,0,0,0,0,0
"May 27, 2019 5:00 AM",15,9,6,,,,,,,,,,1,0,1,0,,,,1,1,0,8,6,5,1,4,19,2,0,0,0,0,0,0,0
"May 27, 2019 6:00 AM",47,34,13,,,,,,,,,,1,0,1,0,,,,8,6,2,26,19,16,8,8,40,1,1,2,1,1,0,0,0
"May 27, 2019 7:00 AM",202,147,55,,,,,,,,,,15,3,12,0,,,,25,17,8,139,46,55,38,17,183,1,3,4,2,2,0,0,0
"May 27, 2019 8:00 AM",400,330,70,,,,,,,,,,36,12,24,0,,,,62,48,14,280,73,104,83,21,304,4,8,6,2,4,0,0,0
"May 27, 2019 9:00 AM",191,157,34,,,,,,,,,,25,8,17,0,,,,33,21,12,121,35,49,32,17,128,6,4,14,12,2,0,0,0
"May 27, 2019 10:00 AM",60,42,18,,,,,,,,,,9,2,7,0,,,,9,8,1,37,11,13,7,6,43,1,5,5,3,2,0,0,0
"May 27, 2019 11:00 AM",36,27,9,,,,,,,,,,12,4,8,0,,,,13,12,1,13,11,16,9,7,19,5,0,3,1,2,0,0,0
"May 27, 2019 12:00 PM",42,20,22,,,,,,,,,,19,12,7,0,,,,19,16,3,18,14,15,7,8,20,4,2,2,0,2,0,0,0
"May 27, 2019 1:00 PM",56,20,36,,,,,,,,,,13,11,2,0,,,,21,20,1,15,31,14,7,7,22,2,3,1,0,1,1,0,1
"May 27, 2019 2:00 PM",51,20,31,,,,,,,,,,9,7,2,0,,,,15,15,0,12,10,14,4,10,11,2,1,1,0,1,2,2,0
"May 27, 2019 3:00 PM",57,28,29,,,,,,,,,,9,8,1,0,,,,33,30,3,13,24,18,7,11,17,2,0,3,2,1,1,1,0
"May 27, 2019 4:00 PM",110,29,81,,,,,,,,,,11,8,3,0,,,,63,59,4,27,83,30,4,26,28,2,3,4,3,1,5,4,1
"May 27, 2019 5:00 PM",254,53,201,,,,,,,,,,15,9,6,0,,,,137,134,3,32,138,54,7,47,59,4,2,2,2,0,1,1,0
"May 27, 2019 6:00 PM",282,43,239,,,,,,,,,,18,13,5,0,,,,153,149,4,28,143,57,2,55,61,6,2,3,2,1,0,0,0
"May 27, 2019 7:00 PM",139,29,110,,,,,,,,,,7,5,2,0,,,,76,73,3,22,68,35,1,34,20,4,4,4,2,2,0,0,0
"May 27, 2019 8:00 PM",74,14,60,,,,,,,,,,4,2,2,0,,,,25,25,0,7,34,22,2,20,13,1,0,0,0,0,0,0,0
"May 27, 2019 9:00 PM",51,9,42,,,,,,,,,,2,2,0,0,,,,23,20,3,4,9,4,1,3,17,3,1,1,1,0,0,0,0
"May 27, 2019 10:00 PM",30,8,22,,,,,,,,,,3,2,1,0,,,,8,8,0,5,17,1,0,1,12,0,0,0,0,0,0,0,0
"May 27, 2019 11:00 PM",18,6,12,,,,,,,,,,1,1,0,0,,,,5,5,0,0,7,3,2,1,4,0,0,1,0,1,0,0,0
"May 28, 2019 12:00 AM",4,0,4,,,,,,,,,,0,0,0,0,,,,1,1,0,0,3,1,0,1,4,0,0,0,0,0,0,0,0
"May 28, 2019 1:00 AM",3,1,2,,,,,,,,,,0,0,0,0,,,,0,0,0,0,0,0,0,0,0,0,0,0,0,0,0,0,0
"May 28, 2019 2:00 AM",1,0,1,,,,,,,,,,0,0,0,0,,,,2,2,0,0,1,0,0,0,2,0,1,0,0,0,0,0,0
"May 28, 2019 3:00 AM",2,1,1,,,,,,,,,,0,0,0,0,,,,1,1,0,0,0,1,0,1,0,0,0,0,0,0,0,0,0
"May 28, 2019 4:00 AM",2,0,2,,,,,,,,,,1,0,1,0,,,,0,0,0,2,0,0,0,0,0,1,0,0,0,0,0,0,0
"May 28, 2019 5:00 AM",10,8,2,,,,,,,,,,0,0,0,0,,,,1,1,0,7,6,2,1,1,9,3,0,0,0,0,0,0,0
"May 28, 2019 6:00 AM",50,36,14,,,,,,,,,,1,0,1,0,,,,13,13,0,25,21,14,8,6,62,0,6,3,2,1,0,0,0
"May 28, 2019 7:00 AM",213,166,47,,,,,,,,,,15,4,11,0,,,,37,29,8,148,44,51,35,16,194,2,3,8,5,3,0,0,0
"May 28, 2019 8:00 AM",408,324,84,,,,,,,,,,32,7,25,0,,,,55,37,18,265,78,106,77,29,351,6,10,7,4,3,0,0,0
"May 28, 2019 9:00 AM",200,159,41,,,,,,,,,,17,6,11,0,,,,31,25,6,100,31,53,37,16,113,7,6,11,8,3,0,0,0
"May 28, 2019 10:00 AM",58,39,19,,,,,,,,,,11,5,6,0,,,,9,6,3,28,10,17,6,11,39,3,2,2,2,0,0,0,0
"May 28, 2019 11:00 AM",42,27,15,,,,,,,,,,9,7,2,0,,,,10,9,1,16,13,8,2,6,26,2,0,2,1,1,0,0,0
"May 28, 2019 12:00 PM",46,22,24,,,,,,,,,,17,6,11,0,,,,13,11,2,12,14,17,6,11,21,4,4,4,3,1,0,0,0
"May 28, 2019 1:00 PM",64,33,31,,,,,,,,,,22,18,4,0,,,,17,15,2,22,19,18,4,14,23,5,1,5,1,4,0,0,0
"May 28, 2019 2:00 PM",62,24,38,,,,,,,,,,17,10,7,0,,,,21,15,6,18,19,27,5,22,19,4,0,4,2,2,0,0,0
"May 28, 2019 3:00 PM",63,21,42,,,,,,,,,,12,9,3,0,,,,35,28,7,18,30,24,10,14,16,0,2,2,2,0,0,0,0
"May 28, 2019 4:00 PM",156,53,103,,,,,,,,,,14,10,4,0,,,,58,55,3,32,86,39,3,36,37,3,4,2,1,1,1,1,0
"May 28, 2019 5:00 PM",325,66,259,,,,,,,,,,22,11,11,0,,,,164,161,3,64,214,88,24,64,79,15,5,13,6,7,2,1,1
"May 28, 2019 6:00 PM",343,85,258,,,,,,,,,,23,16,7,0,,,,190,185,5,46,179,141,19,122,76,6,3,7,3,4,2,1,1
"May 28, 2019 7:00 PM",164,45,119,,,,,,,,,,12,5,7,0,,,,93,92,1,26,99,58,11,47,40,6,6,6,3,3,4,3,1
"May 28, 2019 8:00 PM",115,32,83,,,,,,,,,,5,3,2,0,,,,51,48,3,16,45,33,14,19,25,3,7,4,3,1,0,0,0
"May 28, 2019 9:00 PM",87,24,63,,,,,,,,,,6,4,2,0,,,,15,15,0,7,23,17,3,14,25,1,4,2,0,2,0,0,0
"May 28, 2019 10:00 PM",47,10,37,,,,,,,,,,9,9,0,0,,,,20,18,2,2,16,9,2,7,10,1,0,1,1,0,0,0,0
"May 28, 2019 11:00 PM",24,11,13,,,,,,,,,,4,2,2,0,,,,11,10,1,2,8,5,0,5,6,0,0,0,0,0,0,0,0
"May 29, 2019 12:00 AM",9,1,8,,,,,,,,,,0,0,0,0,,,,6,5,1,0,6,0,0,0,6,0,0,0,0,0,0,0,0
"May 29, 2019 1:00 AM",9,1,8,,,,,,,,,,0,0,0,0,,,,2,2,0,0,0,0,0,0,4,0,1,0,0,0,0,0,0
"May 29, 2019 2:00 AM",0,0,0,,,,,,,,,,0,0,0,0,,,,0,0,0,0,2,0,0,0,1,0,1,0,0,0,0,0,0
"May 29, 2019 3:00 AM",2,1,1,,,,,,,,,,0,0,0,0,,,,0,0,0,0,0,0,0,0,0,1,0,0,0,0,0,0,0
"May 29, 2019 4:00 AM",3,0,3,,,,,,,,,,1,0,1,0,,,,2,1,1,2,1,0,0,0,2,0,0,0,0,0,0,0,0
"May 29, 2019 5:00 AM",9,6,3,,,,,,,,,,0,0,0,0,,,,0,0,0,3,3,2,0,2,11,2,0,0,0,0,0,0,0
"May 29, 2019 6:00 AM",39,31,8,,,,,,,,,,0,0,0,0,,,,4,3,1,25,20,8,7,1,35,0,0,2,1,1,0,0,0
"May 29, 2019 7:00 AM",170,127,43,,,,,,,,,,6,3,3,0,,,,16,14,2,100,39,28,20,8,123,1,1,1,0,1,0,0,0
"May 29, 2019 8:00 AM",340,284,56,,,,,,,,,,12,1,11,0,,,,44,32,12,215,39,67,56,11,258,2,9,6,5,1,0,0,0
"May 29, 2019 9:00 AM",167,137,30,,,,,,,,,,19,10,9,0,,,,25,17,8,84,18,34,20,14,96,5,3,7,6,1,0,0,0
"May 29, 2019 10:00 AM",68,44,24,,,,,,,,,,4,0,4,0,,,,6,6,0,27,13,21,10,11,29,2,2,2,2,0,0,0,0
"May 29, 2019 11:00 AM",50,34,16,,,,,,,,,,6,3,3,0,,,,10,9,1,22,14,9,0,9,22,1,1,1,0,1,0,0,0
"May 29, 2019 12:00 PM",38,20,18,,,,,,,,,,8,3,5,0,,,,14,13,1,22,14,15,5,10,27,3,2,5,2,3,0,0,0
"May 29, 2019 1:00 PM",61,27,34,,,,,,,,,,10,4,6,0,,,,16,12,4,22,21,13,3,10,18,4,5,0,0,0,0,0,0
"May 29, 2019 2:00 PM",48,20,28,,,,,,,,,,6,2,4,0,,,,14,11,3,19,15,14,5,9,18,2,0,7,5,2,0,0,0
"May 29, 2019 3:00 PM",57,17,40,,,,,,,,,,7,4,3,0,,,,26,24,2,12,20,15,5,10,14,2,3,7,3,4,0,0,0
"May 29, 2019 4:00 PM",116,37,79,,,,,,,,,,15,8,7,0,,,,44,41,3,29,44,23,5,18,28,4,4,3,2,1,0,0,0
"May 29, 2019 5:00 PM",263,55,208,,,,,,,,,,11,6,5,0,,,,105,102,3,38,134,56,12,44,66,5,2,3,3,0,0,0,0
"May 29, 2019 6:00 PM",284,52,232,,,,,,,,,,20,13,7,0,,,,136,135,1,33,138,65,4,61,56,6,5,11,6,5,0,0,0
"May 29, 2019 7:00 PM",139,34,105,,,,,,,,,,9,4,5,0,,,,83,82,1,18,72,33,6,27,32,2,2,5,2,3,0,0,0
"May 29, 2019 8:00 PM",89,16,73,,,,,,,,,,9,7,2,0,,,,39,38,1,10,32,20,6,14,19,4,1,8,2,6,0,0,0
"May 29, 2019 9:00 PM",54,16,38,,,,,,,,,,3,2,1,0,,,,35,33,2,12,13,11,2,9,19,1,2,1,1,0,0,0,0
"May 29, 2019 10:00 PM",35,6,29,,,,,,,,,,3,3,0,0,,,,18,16,2,2,16,3,2,1,14,0,0,1,0,1,0,0,0
"May 29, 2019 11:00 PM",19,6,13,,,,,,,,,,2,2,0,0,,,,16,14,2,2,10,0,0,0,3,1,0,0,0,0,0,0,0
"May 30, 2019 12:00 AM",8,1,7,,,,,,,,,,3,0,3,0,,,,5,5,0,2,2,1,0,1,3,0,1,0,0,0,0,0,0
"May 30, 2019 1:00 AM",5,3,2,,,,,,,,,,0,0,0,0,,,,2,2,0,3,2,0,0,0,1,1,1,1,0,1,0,0,0
"May 30, 2019 2:00 AM",0,0,0,,,,,,,,,,0,0,0,0,,,,1,1,0,0,2,0,0,0,4,0,0,0,0,0,0,0,0
"May 30, 2019 3:00 AM",3,3,0,,,,,,,,,,0,0,0,0,,,,2,2,0,0,0,0,0,0,1,0,0,0,0,0,0,0,0
"May 30, 2019 4:00 AM",6,2,4,,,,,,,,,,2,0,2,0,,,,1,1,0,1,0,0,0,0,1,0,0,0,0,0,0,0,0
"May 30, 2019 5:00 AM",8,5,3,,,,,,,,,,0,0,0,0,,,,0,0,0,8,6,2,0,2,10,2,0,0,0,0,,,
"May 30, 2019 6:00 AM",60,49,11,,,,,,,,,,1,0,1,0,,,,5,5,0,35,19,8,6,2,53,0,0,2,1,1,,,
"May 30, 2019 7:00 AM",178,136,42,,,,,,,,,,13,2,11,0,,,,30,28,2,114,36,33,26,7,138,1,5,5,3,2,0,0,0
"May 30, 2019 8:00 AM",352,281,71,,,,,,,,,,20,2,18,0,,,,48,37,11,257,69,100,73,27,298,6,9,9,7,2,1,0,1
"May 30, 2019 9:00 AM",184,148,36,,,,,,,,,,12,5,7,0,,,,31,18,13,92,32,40,22,18,107,5,5,7,5,2,1,0,1
"May 30, 2019 10:00 AM",77,61,16,,,,,,,,,,7,2,5,0,,,,11,8,3,39,17,16,11,5,34,1,2,5,3,2,0,0,0
"May 30, 2019 11:00 AM",52,29,23,,,,,,,,,,8,4,4,0,,,,10,9,1,23,12,12,5,7,28,0,2,4,2,2,1,1,0
"May 30, 2019 12:00 PM",48,23,25,,,,,,,,,,22,8,14,0,,,,17,16,1,21,16,21,9,12,16,3,3,1,1,0,0,0,0
"May 30, 2019 1:00 PM",79,33,46,,,,,,,,,,11,5,6,0,,,,30,28,2,16,28,16,8,8,25,5,1,2,2,0,3,1,2
"May 30, 2019 2:00 PM",54,23,31,,,,,,,,,,13,8,5,0,,,,23,20,3,13,27,18,3,15,28,3,1,5,3,2,0,0,0
"May 30, 2019 3:00 PM",63,24,39,,,,,,,,,,12,7,5,0,,,,27,26,1,22,30,19,1,18,24,2,2,4,2,2,4,2,2
"May 30, 2019 4:00 PM",152,42,110,,,,,,,,,,17,10,7,0,,,,66,60,6,25,86,23,5,18,43,2,4,12,6,6,1,0,1
"May 30, 2019 5:00 PM",274,47,227,,,,,,,,,,20,10,10,0,,,,152,148,4,38,153,88,12,76,68,10,1,11,5,6,1,0,1
"May 30, 2019 6:00 PM",283,64,219,,,,,,,,,,18,14,4,0,,,,155,153,2,33,136,70,10,60,38,1,3,3,0,3,3,3,0
"May 30, 2019 7:00 PM",131,39,92,,,,,,,,,,17,15,2,0,,,,68,67,1,22,60,38,7,31,35,3,4,2,0,2,2,2,0
"May 30, 2019 8:00 PM",106,30,76,,,,,,,,,,12,4,8,0,,,,40,40,0,17,32,15,8,7,36,5,2,3,2,1,2,1,1
"May 30, 2019 9:00 PM",78,24,54,,,,,,,,,,7,6,1,0,,,,18,17,1,10,32,20,6,14,23,2,1,3,2,1,0,0,0
"May 30, 2019 10:00 PM",47,7,40,,,,,,,,,,6,3,3,0,,,,13,12,1,7,16,10,7,3,13,0,0,4,1,3,0,0,0
"May 30, 2019 11:00 PM",33,12,21,,,,,,,,,,5,4,1,0,,,,21,20,1,2,9,6,3,3,7,0,1,0,0,0,0,0,0
"May 31, 2019 12:00 AM",7,2,5,,,,,,,,,,0,0,0,0,,,,6,6,0,2,4,0,0,0,4,0,0,1,1,0,0,0,0
"May 31, 2019 1:00 AM",4,1,3,,,,,,,,,,1,1,0,0,,,,6,6,0,0,4,1,1,0,0,0,0,0,0,0,0,0,0
"May 31, 2019 2:00 AM",4,0,4,,,,,,,,,,0,0,0,0,,,,1,1,0,0,2,1,0,1,3,0,0,0,0,0,0,0,0
"May 31, 2019 3:00 AM",2,2,0,,,,,,,,,,1,1,0,0,,,,1,1,0,0,1,0,0,0,3,0,0,0,0,0,0,0,0
"May 31, 2019 4:00 AM",2,1,1,,,,,,,,,,0,0,0,0,,,,1,1,0,1,0,1,0,1,0,0,0,0,0,0,0,0,0
"May 31, 2019 5:00 AM",11,7,4,,,,,,,,,,1,0,1,0,,,,0,0,0,9,6,2,1,1,11,2,0,0,0,0,0,0,0
"May 31, 2019 6:00 AM",50,39,11,,,,,,,,,,4,0,4,0,,,,8,5,3,23,15,11,8,3,39,2,3,0,0,0,0,0,0
"May 31, 2019 7:00 AM",155,113,42,,,,,,,,,,11,4,7,0,,,,20,16,4,91,27,24,20,4,114,2,3,3,2,1,0,0,0
"May 31, 2019 8:00 AM",258,208,50,,,,,,,,,,18,2,16,0,,,,37,29,8,190,63,78,62,16,234,9,6,5,3,2,0,0,0
"May 31, 2019 9:00 AM",121,91,30,,,,,,,,,,9,3,6,0,,,,17,10,7,79,27,25,15,10,91,5,3,8,4,4,0,0,0
"May 31, 2019 10:00 AM",58,37,21,,,,,,,,,,17,4,13,0,,,,17,10,7,17,10,10,8,2,36,2,1,3,2,1,0,0,0
"May 31, 2019 11:00 AM",40,25,15,,,,,,,,,,13,6,7,0,,,,8,6,2,18,13,25,8,17,22,2,2,19,8,11,5,2,3
"May 31, 2019 12:00 PM",57,33,24,,,,,,,,,,28,17,11,0,,,,12,11,1,22,25,9,3,6,31,4,5,4,1,3,1,0,1
"May 31, 2019 1:00 PM",73,28,45,,,,,,,,,,23,13,10,0,,,,26,25,1,22,32,24,10,14,16,3,6,8,5,3,1,0,1
"May 31, 2019 2:00 PM",56,27,29,,,,,,,,,,16,9,7,0,,,,27,25,2,17,33,20,7,13,22,4,5,5,3,2,0,0,0
"May 31, 2019 3:00 PM",71,20,51,,,,,,,,,,18,9,9,0,,,,35,35,0,18,39,38,12,26,28,3,4,2,2,0,0,0,0
"May 31, 2019 4:00 PM",155,35,120,,,,,,,,,,13,9,4,0,,,,69,68,1,23,89,43,10,33,45,3,3,1,0,1,0,0,0
"May 31, 2019 5:00 PM",218,46,172,,,,,,,,,,18,12,6,0,,,,135,133,2,34,127,75,11,64,58,7,5,6,4,2,2,2,0
"May 31, 2019 6:00 PM",179,29,150,,,,,,,,,,24,16,8,0,,,,82,82,0,25,97,58,5,53,36,5,3,8,6,2,3,2,1
"May 31, 2019 7:00 PM",88,19,69,,,,,,,,,,13,10,3,0,,,,47,47,0,13,49,29,8,21,17,4,1,10,2,8,1,0,1
"May 31, 2019 8:00 PM",61,20,41,,,,,,,,,,11,9,2,0,,,,24,23,1,5,19,17,8,9,12,2,2,4,1,3,1,1,0
"May 31, 2019 9:00 PM",32,15,17,,,,,,,,,,13,8,5,0,,,,12,11,1,9,18,13,5,8,18,0,2,2,1,1,3,1,2
"May 31, 2019 10:00 PM",31,9,22,,,,,,,,,,7,5,2,0,,,,8,7,1,4,11,6,0,6,15,1,2,0,0,0,1,1,0
"May 31, 2019 11:00 PM",21,5,16,,,,,,,,,,3,0,3,0,,,,6,6,0,3,5,3,3,0,16,2,0,1,0,1,0,0,0
"Jun 1, 2019 12:00 AM",16,3,13,,,,,,,,,,0,0,0,0,,,,4,4,0,2,3,0,0,0,4,2,0,0,0,0,0,0,0
"Jun 1, 2019 1:00 AM",7,1,6,,,,,,,,,,6,3,3,0,,,,5,5,0,1,8,5,0,5,6,0,1,0,0,0,0,0,0
"Jun 1, 2019 2:00 AM",8,2,6,,,,,,,,,,0,0,0,0,,,,5,5,0,1,2,0,0,0,3,1,0,1,1,0,0,0,0
"Jun 1, 2019 3:00 AM",3,0,3,,,,,,,,,,1,1,0,0,,,,3,3,0,1,1,0,0,0,0,0,1,0,0,0,0,0,0
"Jun 1, 2019 4:00 AM",4,2,2,,,,,,,,,,3,1,2,0,,,,1,1,0,0,2,1,0,1,2,0,0,0,0,0,0,0,0
"Jun 1, 2019 5:00 AM",3,1,2,,,,,,,,,,1,1,0,0,,,,0,0,0,1,3,2,0,2,2,0,1,0,0,0,0,0,0
"Jun 1, 2019 6:00 AM",7,3,4,,,,,,,,,,4,1,3,0,,,,4,4,0,3,9,4,0,4,10,1,1,0,0,0,0,0,0
"Jun 1, 2019 7:00 AM",19,6,13,,,,,,,,,,6,5,1,0,,,,7,6,1,9,14,3,0,3,23,0,1,0,0,0,0,0,0
"Jun 1, 2019 8:00 AM",32,20,12,,,,,,,,,,4,1,3,0,,,,8,7,1,15,25,12,5,7,14,3,3,0,0,0,1,0,1
"Jun 1, 2019 9:00 AM",48,24,24,,,,,,,,,,8,2,6,0,,,,13,11,2,9,27,22,11,11,23,2,6,1,0,1,1,1,0
"Jun 1, 2019 10:00 AM",38,26,12,,,,,,,,,,15,9,6,0,,,,9,6,3,20,24,19,7,12,30,1,4,6,1,5,1,0,1
"Jun 1, 2019 11:00 AM",43,22,21,,,,,,,,,,21,10,11,0,,,,10,10,0,13,24,23,10,13,19,1,2,3,3,0,2,0,2
"Jun 1, 2019 12:00 PM",35,22,13,,,,,,,,,,16,11,5,0,,,,13,13,0,10,22,27,11,16,26,1,2,2,2,0,0,0,0
"Jun 1, 2019 1:00 PM",50,24,26,,,,,,,,,,14,9,5,0,,,,17,16,1,16,24,15,7,8,28,6,4,1,0,1,0,0,0
"Jun 1, 2019 2:00 PM",42,23,19,,,,,,,,,,17,8,9,0,,,,9,8,1,22,23,29,11,18,23,1,0,5,3,2,3,0,3
"Jun 1, 2019 3:00 PM",48,23,25,,,,,,,,,,14,8,6,0,,,,15,13,2,19,22,14,2,12,23,2,6,7,5,2,1,1,0
"Jun 1, 2019 4:00 PM",58,32,26,,,,,,,,,,34,21,13,0,,,,20,18,2,17,15,29,12,17,21,6,4,2,1,1,7,4,3
"Jun 1, 2019 5:00 PM",46,15,31,,,,,,,,,,17,12,5,0,,,,13,13,0,4,16,19,9,10,25,2,3,1,1,0,0,0,0
"Jun 1, 2019 6:00 PM",56,19,37,,,,,,,,,,17,13,4,0,,,,19,18,1,5,12,31,15,16,24,0,2,5,2,3,1,1,0
"Jun 1, 2019 7:00 PM",35,15,20,,,,,,,,,,15,10,5,0,,,,8,8,0,13,15,13,9,4,14,2,0,5,3,2,0,0,0
"Jun 1, 2019 8:00 PM",30,10,20,,,,,,,,,,11,6,5,0,,,,9,9,0,6,8,12,7,5,10,0,0,3,1,2,0,0,0
"Jun 1, 2019 9:00 PM",13,8,5,,,,,,,,,,7,3,4,0,,,,8,6,2,3,3,2,2,0,5,1,0,0,0,0,0,0,0
"Jun 1, 2019 10:00 PM",22,7,15,,,,,,,,,,8,5,3,0,,,,6,6,0,6,6,2,1,1,8,0,1,0,0,0,0,0,0
"Jun 1, 2019 11:00 PM",24,10,14,,,,,,,,,,5,3,2,0,,,,4,3,1,3,3,3,0,3,3,0,1,0,0,0,0,0,0
"Jun 2, 2019 12:00 AM",8,6,2,,,,,,,,,,2,2,0,0,,,,0,0,0,1,2,1,0,1,3,0,1,0,0,0,0,0,0
"Jun 2, 2019 1:00 AM",6,2,4,,,,,,,,,,3,2,1,0,,,,1,1,0,5,1,3,0,3,3,0,0,1,1,0,0,0,0
"Jun 2, 2019 2:00 AM",6,1,5,,,,,,,,,,2,2,0,0,,,,2,2,0,3,3,1,0,1,1,0,0,1,1,0,0,0,0
"Jun 2, 2019 3:00 AM",1,0,1,,,,,,,,,,0,0,0,0,,,,3,3,0,0,0,0,0,0,1,0,1,0,0,0,0,0,0
"Jun 2, 2019 4:00 AM",5,0,5,,,,,,,,,,1,0,1,0,,,,3,3,0,0,0,0,0,0,1,0,0,0,0,0,0,0,0
"Jun 2, 2019 5:00 AM",5,3,2,,,,,,,,,,1,1,0,0,,,,3,3,0,0,3,0,0,0,4,0,0,0,0,0,0,0,0
"Jun 2, 2019 6:00 AM",9,3,6,,,,,,,,,,0,0,0,0,,,,4,4,0,2,3,0,0,0,7,2,0,0,0,0,0,0,0
"Jun 2, 2019 7:00 AM",15,6,9,,,,,,,,,,0,0,0,0,,,,8,6,2,6,8,8,0,8,10,0,4,1,1,0,0,0,0
"Jun 2, 2019 8:00 AM",28,18,10,,,,,,,,,,1,1,0,0,,,,11,8,3,6,12,13,4,9,13,2,4,1,1,0,0,0,0
"Jun 2, 2019 9:00 AM",27,15,12,,,,,,,,,,11,3,8,0,,,,12,10,2,10,19,28,14,14,30,1,21,0,0,0,0,0,0
"Jun 2, 2019 10:00 AM",40,19,21,,,,,,,,,,10,6,4,0,,,,11,8,3,13,21,32,16,16,28,1,10,0,0,0,0,0,0
"Jun 2, 2019 11:00 AM",30,12,18,,,,,,,,,,27,11,16,0,,,,11,8,3,26,13,36,11,25,25,9,8,7,4,3,0,0,0
"Jun 2, 2019 12:00 PM",65,40,25,,,,,,,,,,33,20,13,0,,,,14,13,1,29,28,49,22,27,19,4,3,7,4,3,3,1,2
"Jun 2, 2019 1:00 PM",48,31,17,,,,,,,,,,36,19,17,0,,,,13,11,2,16,36,41,20,21,53,8,0,3,0,3,0,0,0
"Jun 2, 2019 2:00 PM",53,28,25,,,,,,,,,,36,23,13,0,,,,8,5,3,10,28,42,16,26,45,5,6,4,3,1,3,0,3
"Jun 2, 2019 3:00 PM",45,22,23,,,,,,,,,,37,25,12,0,,,,8,1,7,7,35,52,18,34,19,5,0,3,2,1,0,0,0
"Jun 2, 2019 4:00 PM",56,24,32,,,,,,,,,,21,13,8,0,,,,11,8,3,18,32,35,20,15,27,5,2,3,2,1,2,2,0
"Jun 2, 2019 5:00 PM",49,20,29,,,,,,,,,,24,12,12,0,,,,14,13,1,10,18,21,11,10,36,4,3,5,4,1,2,2,0
"Jun 2, 2019 6:00 PM",44,8,36,,,,,,,,,,13,8,5,0,,,,21,20,1,12,13,28,13,15,23,3,1,2,2,0,0,0,0
"Jun 2, 2019 7:00 PM",25,14,11,,,,,,,,,,17,9,8,0,,,,10,10,0,11,14,13,6,7,19,0,0,4,1,3,1,1,0
"Jun 2, 2019 8:00 PM",17,4,13,,,,,,,,,,16,7,9,0,,,,6,6,0,6,6,14,7,7,9,1,0,4,0,4,0,0,0
"Jun 2, 2019 9:00 PM",27,16,11,,,,,,,,,,0,0,0,0,,,,2,2,0,8,4,9,5,4,8,1,2,0,0,0,0,0,0
"Jun 2, 2019 10:00 PM",17,11,6,,,,,,,,,,1,1,0,0,,,,4,3,1,6,2,2,1,1,14,2,0,3,1,2,0,0,0
"Jun 2, 2019 11:00 PM",15,6,9,,,,,,,,,,4,3,1,0,,,,5,5,0,5,3,5,3,2,2,0,1,2,1,1,0,0,0
"Jun 3, 2019 12:00 AM",9,3,6,,,,,,,,,,6,4,2,0,,,,6,5,1,1,3,0,0,0,2,0,2,0,0,0,0,0,0
"Jun 3, 2019 1:00 AM",2,0,2,,,,,,,,,,0,0,0,0,,,,3,2,1,0,1,0,0,0,1,0,1,1,0,1,0,0,0
"Jun 3, 2019 2:00 AM",4,0,4,,,,,,,,,,0,0,0,0,,,,0,0,0,0,3,2,2,0,3,0,0,0,0,0,0,0,0
"Jun 3, 2019 3:00 AM",5,1,4,,,,,,,,,,0,0,0,0,,,,5,5,0,1,1,1,0,1,1,0,0,0,0,0,0,0,0
"Jun 3, 2019 4:00 AM",6,0,6,,,,,,,,,,1,1,0,0,,,,1,1,0,0,0,0,0,0,0,0,0,0,0,0,0,0,0
"Jun 3, 2019 5:00 AM",1,1,0,,,,,,,,,,0,0,0,0,,,,2,2,0,1,2,1,0,1,3,0,1,0,0,0,0,0,0
"Jun 3, 2019 6:00 AM",11,4,7,,,,,,,,,,2,2,0,0,,,,3,3,0,4,4,2,1,1,16,0,1,0,0,0,0,0,0
"Jun 3, 2019 7:00 AM",29,15,14,,,,,,,,,,6,1,5,0,,,,7,5,2,10,13,6,1,5,26,2,5,1,0,1,0,0,0
"Jun 3, 2019 8:00 AM",29,13,16,,,,,,,,,,2,1,1,0,,,,13,12,1,16,10,16,6,10,21,0,5,2,0,2,0,0,0
"Jun 3, 2019 9:00 AM",33,20,13,,,,,,,,,,14,5,9,0,,,,8,7,1,19,21,36,12,24,23,3,9,1,1,0,0,0,0
"Jun 3, 2019 10:00 AM",29,15,14,,,,,,,,,,29,10,19,0,,,,11,9,2,14,21,34,15,19,29,2,5,1,1,0,1,0,1
"Jun 3, 2019 11:00 AM",43,24,19,,,,,,,,,,35,18,17,0,,,,16,13,3,25,28,32,18,14,24,3,6,2,0,2,2,2,0
"Jun 3, 2019 12:00 PM",41,23,18,,,,,,,,,,35,10,25,0,,,,5,4,1,15,23,24,8,16,28,8,3,9,7,2,3,3,0
"Jun 3, 2019 1:00 PM",39,25,14,,,,,,,,,,38,19,19,0,,,,12,10,2,20,35,33,20,13,46,0,1,8,5,3,7,3,4
"Jun 3, 2019 2:00 PM",46,28,18,,,,,,,,,,27,18,9,0,,,,12,10,2,19,27,46,19,27,19,2,4,6,3,3,0,0,0
"Jun 3, 2019 3:00 PM",42,22,20,,,,,,,,,,22,15,7,0,,,,11,9,2,16,27,22,8,14,37,3,3,4,2,2,1,1,0
"Jun 3, 2019 4:00 PM",62,29,33,,,,,,,,,,60,30,30,0,,,,21,19,2,12,37,50,22,28,28,4,3,3,3,0,4,3,1
"Jun 3, 2019 5:00 PM",55,21,34,,,,,,,,,,28,13,15,0,,,,17,16,1,20,34,37,19,18,40,2,2,3,1,2,2,2,0
"Jun 3, 2019 6:00 PM",50,15,35,,,,,,,,,,14,10,4,0,,,,19,15,4,15,19,26,18,8,26,1,4,3,3,0,3,2,1
"Jun 3, 2019 7:00 PM",31,13,18,,,,,,,,,,4,0,4,0,,,,14,13,1,10,11,22,14,8,21,2,0,3,2,1,1,1,0
"Jun 3, 2019 8:00 PM",25,13,12,,,,,,,,,,9,6,3,0,,,,9,8,1,6,9,4,1,3,9,2,2,2,1,1,0,0,0
"Jun 3, 2019 9:00 PM",15,5,10,,,,,,,,,,3,3,0,0,,,,5,5,0,5,6,2,0,2,5,0,0,1,1,0,0,0,0
"Jun 3, 2019 10:00 PM",12,6,6,,,,,,,,,,2,1,1,0,,,,2,2,0,4,4,0,0,0,7,0,0,1,1,0,0,0,0
"Jun 3, 2019 11:00 PM",8,6,2,,,,,,,,,,2,0,2,0,,,,2,2,0,2,5,0,0,0,5,0,0,2,0,2,2,2,0
"Jun 4, 2019 12:00 AM",6,0,6,,,,,,,,,,3,3,0,0,,,,5,5,0,0,4,2,1,1,3,0,0,1,1,0,1,0,1
"Jun 4, 2019 1:00 AM",3,0,3,,,,,,,,,,1,0,1,0,,,,1,1,0,0,2,0,0,0,0,0,0,0,0,0,0,0,0
"Jun 4, 2019 2:00 AM",3,1,2,,,,,,,,,,0,0,0,0,,,,0,0,0,0,3,0,0,0,0,0,0,0,0,0,0,0,0
"Jun 4, 2019 3:00 AM",3,1,2,,,,,,,,,,0,0,0,0,,,,0,0,0,0,1,0,0,0,0,0,0,0,0,0,0,0,0
"Jun 4, 2019 4:00 AM",3,0,3,,,,,,,,,,2,2,0,0,,,,0,0,0,1,0,0,0,0,0,1,0,0,0,0,0,0,0
"Jun 4, 2019 5:00 AM",7,7,0,,,,,,,,,,1,1,0,0,,,,1,1,0,6,3,0,0,0,14,2,0,0,0,0,0,0,0
"Jun 4, 2019 6:00 AM",37,28,9,,,,,,,,,,1,1,0,0,,,,5,3,2,24,12,7,6,1,39,2,1,3,2,1,2,0,2
"Jun 4, 2019 7:00 AM",131,105,26,,,,,,,,,,5,2,3,0,,,,22,21,1,79,25,18,15,3,100,1,0,2,2,0,0,0,0
"Jun 4, 2019 8:00 AM",238,199,39,,,,,,,,,,8,7,1,0,,,,27,14,13,167,26,49,42,7,182,0,6,1,0,1,1,0,1
"Jun 4, 2019 9:00 AM",119,94,25,,,,,,,,,,6,3,3,0,,,,10,6,4,49,16,11,7,4,63,0,0,0,0,0,0,0,0
"Jun 4, 2019 10:00 AM",32,24,8,,,,,,,,,,0,0,0,0,,,,4,2,2,10,5,2,2,0,6,0,1,1,0,1,0,0,0
"Jun 4, 2019 11:00 AM",14,8,6,,,,,,,,,,1,1,0,0,,,,6,3,3,8,8,3,1,2,10,0,1,2,1,1,0,0,0
"Jun 4, 2019 12:00 PM",24,12,12,,,,,,,,,,3,1,2,0,,,,2,2,0,9,1,1,1,0,13,0,0,0,0,0,0,0,0
"Jun 4, 2019 1:00 PM",27,17,10,,,,,,,,,,3,2,1,0,,,,5,5,0,10,11,5,1,4,10,2,1,1,0,1,0,0,0
"Jun 4, 2019 2:00 PM",24,7,17,,,,,,,,,,5,3,2,0,,,,9,6,3,6,7,6,2,4,8,2,0,2,1,1,0,0,0
"Jun 4, 2019 3:00 PM",25,6,19,,,,,,,,,,3,2,1,0,,,,13,11,2,7,10,6,1,5,8,2,0,3,1,2,0,0,0
"Jun 4, 2019 4:00 PM",96,14,82,,,,,,,,,,7,3,4,0,,,,40,38,2,11,42,13,2,11,17,0,2,0,0,0,0,0,0
"Jun 4, 2019 5:00 PM",167,26,141,,,,,,,,,,7,4,3,0,,,,82,79,3,24,69,44,11,33,44,5,1,2,1,1,1,1,0
"Jun 4, 2019 6:00 PM",225,31,194,,,,,,,,,,10,7,3,0,,,,126,126,0,20,112,41,1,40,30,1,3,5,3,2,0,0,0
"Jun 4, 2019 7:00 PM",97,22,75,,,,,,,,,,3,2,1,0,,,,39,37,2,14,43,18,1,17,18,2,1,2,1,1,1,1,0
"Jun 4, 2019 8:00 PM",44,8,36,,,,,,,,,,5,3,2,0,,,,23,23,0,9,9,6,0,6,11,1,2,3,2,1,0,0,0
"Jun 4, 2019 9:00 PM",28,6,22,,,,,,,,,,2,2,0,0,,,,14,14,0,4,9,6,2,4,5,1,1,2,1,1,0,0,0
"Jun 4, 2019 10:00 PM",22,5,17,,,,,,,,,,1,1,0,0,,,,8,8,0,3,7,1,0,1,7,0,0,0,0,0,0,0,0
"Jun 4, 2019 11:00 PM",6,2,4,,,,,,,,,,0,0,0,0,,,,3,3,0,0,2,1,0,1,1,0,0,1,0,1,1,1,0
"Jun 5, 2019 12:00 AM",1,0,1,,,,,,,,,,1,0,1,0,,,,3,3,0,1,2,0,0,0,0,0,0,0,0,0,0,0,0
"Jun 5, 2019 1:00 AM",5,0,5,,,,,,,,,,0,0,0,0,,,,1,1,0,1,1,0,0,0,0,0,0,0,0,0,0,0,0
"Jun 5, 2019 2:00 AM",1,0,1,,,,,,,,,,0,0,0,0,,,,0,0,0,0,1,1,0,1,1,0,0,0,0,0,0,0,0
"Jun 5, 2019 3:00 AM",2,1,1,,,,,,,,,,0,0,0,0,,,,0,0,0,0,0,0,0,0,0,1,0,0,0,0,0,0,0
"Jun 5, 2019 4:00 AM",4,1,3,,,,,,,,,,2,1,1,0,,,,0,0,0,1,0,0,0,0,1,1,0,0,0,0,0,0,0
"Jun 5, 2019 5:00 AM",6,4,2,,,,,,,,,,0,0,0,0,,,,0,0,0,6,5,0,0,0,13,1,0,0,0,0,0,0,0
"Jun 5, 2019 6:00 AM",55,44,11,,,,,,,,,,2,1,1,0,,,,7,5,2,20,15,8,5,3,39,1,3,2,0,2,0,0,0
"Jun 5, 2019 7:00 AM",160,126,34,,,,,,,,,,8,2,6,0,,,,30,27,3,122,31,27,20,7,161,3,5,7,6,1,2,0,2
"Jun 5, 2019 8:00 AM",331,270,61,,,,,,,,,,22,3,19,0,,,,41,31,10,215,62,75,55,20,284,3,9,5,2,3,1,1,0
"Jun 5, 2019 9:00 AM",150,118,32,,,,,,,,,,13,6,7,0,,,,17,9,8,102,14,32,27,5,112,2,5,0,0,0,1,0,1
"Jun 5, 2019 10:00 AM",37,29,8,,,,,,,,,,7,1,6,0,,,,7,5,2,27,7,9,7,2,30,3,0,2,1,1,0,0,0
"Jun 5, 2019 11:00 AM",36,22,14,,,,,,,,,,9,4,5,0,,,,12,9,3,11,12,4,2,2,19,0,4,3,2,1,2,1,1
"Jun 5, 2019 12:00 PM",36,20,16,,,,,,,,,,11,6,5,0,,,,19,16,3,15,15,12,4,8,11,3,4,2,2,0,1,0,1
"Jun 5, 2019 1:00 PM",50,33,17,,,,,,,,,,7,5,2,0,,,,17,15,2,16,20,17,6,11,21,5,2,3,3,0,1,1,0
"Jun 5, 2019 2:00 PM",42,19,23,,,,,,,,,,15,11,4,0,,,,15,13,2,10,15,12,1,11,25,4,1,2,1,1,0,0,0
"Jun 5, 2019 3:00 PM",53,17,36,,,,,,,,,,13,7,6,0,,,,31,27,4,13,19,11,3,8,19,3,1,3,1,2,2,2,0
"Jun 5, 2019 4:00 PM",124,24,100,,,,,,,,,,16,11,5,0,,,,50,49,1,24,61,25,1,24,34,3,0,7,5,2,3,3,0
"Jun 5, 2019 5:00 PM",237,39,198,,,,,,,,,,22,12,10,0,,,,125,123,2,39,150,74,20,54,73,3,3,7,6,1,2,0,2
"Jun 5, 2019 6:00 PM",249,44,205,,,,,,,,,,20,13,7,0,,,,165,161,4,30,129,83,9,74,45,9,2,7,7,0,2,1,1
"Jun 5, 2019 7:00 PM",126,29,97,,,,,,,,,,10,6,4,0,,,,69,66,3,22,72,34,3,31,33,2,9,2,1,1,2,1,1
"Jun 5, 2019 8:00 PM",77,19,58,,,,,,,,,,7,5,2,0,,,,43,41,2,20,37,21,4,17,23,0,1,5,1,4,2,2,0
"Jun 5, 2019 9:00 PM",58,9,49,,,,,,,,,,6,3,3,0,,,,25,25,0,7,18,15,6,9,23,2,2,2,2,0,0,0,0
"Jun 5, 2019 10:00 PM",33,8,25,,,,,,,,,,4,3,1,0,,,,24,24,0,5,11,0,0,0,14,1,1,0,0,0,0,0,0
"Jun 5, 2019 11:00 PM",14,3,11,,,,,,,,,,0,0,0,0,,,,7,7,0,4,8,4,2,2,9,1,1,1,0,1,1,0,1
"Jun 6, 2019 12:00 AM",7,1,6,,,,,,,,,,3,3,0,0,,,,2,2,0,1,4,0,0,0,2,1,0,3,2,1,0,0,0
"Jun 6, 2019 1:00 AM",5,1,4,,,,,,,,,,0,0,0,0,,,,3,3,0,1,2,0,0,0,0,0,1,0,0,0,0,0,0
"Jun 6, 2019 2:00 AM",1,0,1,,,,,,,,,,0,0,0,0,,,,2,2,0,0,1,0,0,0,0,0,0,0,0,0,0,0,0
"Jun 6, 2019 3:00 AM",1,1,0,,,,,,,,,,0,0,0,0,,,,1,1,0,0,0,0,0,0,2,2,0,0,0,0,0,0,0
"Jun 6, 2019 4:00 AM",4,0,4,,,,,,,,,,1,0,1,0,,,,1,1,0,1,0,0,0,0,0,0,0,0,0,0,0,0,0
"Jun 6, 2019 5:00 AM",9,7,2,,,,,,,,,,0,0,0,0,,,,1,1,0,6,1,2,1,1,14,1,0,0,0,0,0,0,0
"Jun 6, 2019 6:00 AM",47,35,12,,,,,,,,,,5,0,5,0,,,,5,4,1,24,26,12,10,2,48,1,3,5,3,2,2,0,2
"Jun 6, 2019 7:00 AM",199,148,51,,,,,,,,,,10,6,4,0,,,,30,25,5,121,40,46,34,12,176,4,3,3,2,1,0,0,0
"Jun 6, 2019 8:00 AM",360,306,54,,,,,,,,,,28,3,25,0,,,,54,37,17,249,55,98,69,29,308,5,9,5,3,2,3,0,3
"Jun 6, 2019 9:00 AM",151,125,26,,,,,,,,,,18,4,14,0,,,,26,16,10,95,34,28,18,10,95,4,6,3,1,2,3,3,0
"Jun 6, 2019 10:00 AM",42,32,10,,,,,,,,,,14,4,10,0,,,,11,6,5,35,11,16,8,8,41,1,1,2,0,2,1,1,0
"Jun 6, 2019 11:00 AM",38,22,16,,,,,,,,,,18,12,6,0,,,,15,11,4,17,15,22,5,17,34,4,3,4,3,1,0,0,0
"Jun 6, 2019 12:00 PM",51,32,19,,,,,,,,,,12,5,7,0,,,,13,13,0,24,26,15,7,8,27,1,1,2,2,0,1,0,1
"Jun 6, 2019 1:00 PM",83,43,40,,,,,,,,,,17,9,8,0,,,,22,20,2,16,24,23,8,15,26,2,1,3,1,2,2,1,1
"Jun 6, 2019 2:00 PM",59,24,35,,,,,,,,,,15,9,6,0,,,,19,18,1,16,25,30,14,16,20,2,3,1,0,1,1,0,1
"Jun 6, 2019 3:00 PM",69,25,44,,,,,,,,,,17,12,5,0,,,,18,18,0,17,40,27,7,20,27,2,2,2,2,0,1,1,0
"Jun 6, 2019 4:00 PM",140,36,104,,,,,,,,,,23,12,11,0,,,,60,53,7,28,80,42,10,32,41,6,3,6,5,1,3,2,1
"Jun 6, 2019 5:00 PM",244,53,191,,,,,,,,,,34,21,13,0,,,,141,135,6,41,158,74,15,59,85,8,4,6,5,1,3,1,2
"Jun 6, 2019 6:00 PM",273,52,221,,,,,,,,,,20,15,5,0,,,,154,152,2,34,146,87,14,73,53,4,9,6,6,0,4,2,2
"Jun 6, 2019 7:00 PM",128,29,99,,,,,,,,,,9,6,3,0,,,,82,80,2,20,63,46,9,37,26,4,3,4,2,2,3,2,1
"Jun 6, 2019 8:00 PM",94,23,71,,,,,,,,,,17,13,4,0,,,,49,49,0,10,23,25,8,17,23,2,3,3,2,1,2,2,0
"Jun 6, 2019 9:00 PM",64,12,52,,,,,,,,,,7,5,2,0,,,,24,23,1,8,20,17,7,10,12,0,0,2,1,1,0,0,0
"Jun 6, 2019 10:00 PM",48,11,37,,,,,,,,,,9,6,3,0,,,,17,16,1,4,10,6,3,3,13,2,0,2,0,2,0,0,0
"Jun 6, 2019 11:00 PM",17,4,13,,,,,,,,,,2,2,0,0,,,,11,11,0,2,15,5,2,3,6,0,0,0,0,0,0,0,0
"Jun 7, 2019 12:00 AM",8,2,6,,,,,,,,,,1,1,0,0,,,,3,3,0,5,5,3,0,3,3,0,0,1,0,1,0,0,0
"Jun 7, 2019 1:00 AM",2,1,1,,,,,,,,,,0,0,0,0,,,,9,9,0,1,3,0,0,0,2,0,0,0,0,0,0,0,0
"Jun 7, 2019 2:00 AM",3,0,3,,,,,,,,,,0,0,0,0,,,,2,2,0,1,2,0,0,0,0,0,1,1,0,1,0,0,0
"Jun 7, 2019 3:00 AM",2,1,1,,,,,,,,,,0,0,0,0,,,,2,1,1,1,1,0,0,0,0,0,0,0,0,0,0,0,0
"Jun 7, 2019 4:00 AM",2,1,1,,,,,,,,,,0,0,0,0,,,,1,1,0,2,0,0,0,0,1,2,0,0,0,0,0,0,0
"Jun 7, 2019 5:00 AM",11,7,4,,,,,,,,,,2,0,2,0,,,,1,1,0,9,3,0,0,0,12,1,1,0,0,0,0,0,0
"Jun 7, 2019 6:00 AM",38,31,7,,,,,,,,,,6,0,6,0,,,,9,8,1,16,20,9,7,2,37,1,2,1,0,1,1,0,1
"Jun 7, 2019 7:00 AM",150,117,33,,,,,,,,,,10,4,6,0,,,,31,28,3,95,31,41,30,11,124,3,2,2,1,1,0,0,0
"Jun 7, 2019 8:00 AM",306,248,58,,,,,,,,,,21,2,19,0,,,,42,29,13,182,58,89,65,24,226,6,11,5,3,2,6,1,5
"Jun 7, 2019 9:00 AM",158,127,31,,,,,,,,,,18,4,14,0,,,,23,12,11,79,33,50,26,24,112,2,6,3,1,2,0,0,0
"Jun 7, 2019 10:00 AM",50,32,18,,,,,,,,,,15,4,11,0,,,,15,12,3,34,15,17,8,9,38,2,6,2,0,2,1,1,0
"Jun 7, 2019 11:00 AM",45,31,14,,,,,,,,,,14,7,7,0,,,,2,2,0,22,10,10,3,7,28,2,3,6,3,3,3,0,3
"Jun 7, 2019 12:00 PM",58,31,27,,,,,,,,,,9,5,4,0,,,,16,15,1,21,24,10,4,6,23,1,2,1,0,1,0,0,0
"Jun 7, 2019 1:00 PM",72,24,48,,,,,,,,,,9,6,3,0,,,,19,18,1,11,28,28,8,20,20,1,2,1,1,0,2,1,1
"Jun 7, 2019 2:00 PM",62,22,40,,,,,,,,,,8,8,0,0,,,,27,24,3,14,28,13,3,10,14,4,1,2,1,1,2,0,2
"Jun 7, 2019 3:00 PM",62,21,41,,,,,,,,,,15,9,6,0,,,,31,30,1,21,26,26,3,23,15,1,1,2,1,1,3,3,0
"Jun 7, 2019 4:00 PM",141,38,103,,,,,,,,,,17,10,7,0,,,,61,58,3,31,69,31,8,23,42,5,2,4,3,1,0,0,0
"Jun 7, 2019 5:00 PM",251,52,199,,,,,,,,,,22,13,9,0,,,,118,114,4,34,131,67,13,54,53,10,3,1,0,1,1,0,1
"Jun 7, 2019 6:00 PM",201,44,157,,,,,,,,,,29,15,14,0,,,,117,117,0,24,108,48,4,44,43,3,1,6,3,3,3,2,1
"Jun 7, 2019 7:00 PM",88,25,63,,,,,,,,,,8,2,6,0,,,,55,55,0,14,52,18,3,15,21,4,2,4,2,2,2,2,0
"Jun 7, 2019 8:00 PM",70,20,50,,,,,,,,,,8,3,5,0,,,,23,22,1,2,16,14,2,12,15,2,1,3,3,0,2,1,1
"Jun 7, 2019 9:00 PM",22,4,18,,,,,,,,,,3,2,1,0,,,,13,13,0,9,9,5,0,5,10,4,2,2,1,1,0,0,0
"Jun 7, 2019 10:00 PM",25,6,19,,,,,,,,,,3,0,3,0,,,,11,11,0,5,9,4,1,3,9,1,0,2,1,1,0,0,0
"Jun 7, 2019 11:00 PM",22,8,14,,,,,,,,,,9,6,3,0,,,,9,8,1,3,8,2,1,1,4,0,0,1,0,1,0,0,0
"Jun 8, 2019 12:00 AM",20,4,16,,,,,,,,,,6,3,3,0,,,,8,8,0,1,5,1,1,0,3,0,0,0,0,0,1,1,0
"Jun 8, 2019 1:00 AM",7,2,5,,,,,,,,,,1,0,1,0,,,,7,7,0,1,4,1,1,0,11,0,0,0,0,0,0,0,0
"Jun 8, 2019 2:00 AM",9,1,8,,,,,,,,,,0,0,0,0,,,,5,5,0,2,3,3,1,2,3,1,0,0,0,0,0,0,0
"Jun 8, 2019 3:00 AM",4,1,3,,,,,,,,,,2,1,1,0,,,,1,1,0,0,1,1,0,1,2,0,1,0,0,0,0,0,0
"Jun 8, 2019 4:00 AM",4,1,3,,,,,,,,,,1,0,1,0,,,,1,1,0,0,0,0,0,0,2,1,0,0,0,0,0,0,0
"Jun 8, 2019 5:00 AM",5,2,3,,,,,,,,,,0,0,0,0,,,,1,1,0,0,4,1,0,1,5,0,2,0,0,0,0,0,0
"Jun 8, 2019 6:00 AM",16,9,7,,,,,,,,,,3,2,1,0,,,,4,4,0,4,1,0,0,0,12,1,0,0,0,0,0,0,0
"Jun 8, 2019 7:00 AM",18,11,7,,,,,,,,,,0,0,0,0,,,,1,1,0,9,11,3,2,1,14,2,0,0,0,0,0,0,0
"Jun 8, 2019 8:00 AM",37,16,21,,,,,,,,,,3,2,1,0,,,,6,3,3,17,8,4,1,3,22,1,8,0,0,0,0,0,0
"Jun 8, 2019 9:00 AM",51,32,19,,,,,,,,,,10,2,8,0,,,,12,11,1,13,24,8,3,5,29,3,5,1,1,0,0,0,0
"Jun 8, 2019 10:00 AM",41,27,14,,,,,,,,,,10,3,7,0,,,,11,10,1,23,29,16,5,11,28,3,3,4,0,4,0,0,0
"Jun 8, 2019 11:00 AM",64,36,28,,,,,,,,,,12,10,2,0,,,,20,15,5,23,22,16,8,8,16,5,5,3,2,1,0,0,0
"Jun 8, 2019 12:00 PM",52,29,23,,,,,,,,,,24,17,7,0,,,,19,18,1,31,36,27,2,25,20,9,5,4,4,0,2,0,2
"Jun 8, 2019 1:00 PM",56,30,26,,,,,,,,,,15,8,7,0,,,,23,20,3,23,14,27,15,12,22,3,6,6,5,1,3,1,2
"Jun 8, 2019 2:00 PM",57,39,18,,,,,,,,,,25,16,9,0,,,,20,15,5,26,26,20,10,10,34,4,6,6,3,3,1,1,0
"Jun 8, 2019 3:00 PM",76,46,30,,,,,,,,,,30,16,14,0,,,,19,17,2,25,15,52,14,38,24,4,3,4,2,2,0,0,0
"Jun 8, 2019 4:00 PM",61,19,42,,,,,,,,,,23,12,11,0,,,,23,16,7,13,19,38,16,22,24,4,1,3,1,2,4,4,0
"Jun 8, 2019 5:00 PM",73,22,51,,,,,,,,,,37,21,16,0,,,,23,20,3,16,24,30,9,21,20,4,5,7,3,4,3,3,0
"Jun 8, 2019 6:00 PM",69,24,45,,,,,,,,,,29,16,13,0,,,,29,25,4,11,18,18,7,11,26,5,1,4,2,2,1,0,1
"Jun 8, 2019 7:00 PM",43,23,20,,,,,,,,,,13,7,6,0,,,,11,11,0,7,13,19,5,14,18,1,1,3,1,2,2,1,1
"Jun 8, 2019 8:00 PM",24,11,13,,,,,,,,,,9,2,7,0,,,,9,9,0,6,10,14,7,7,11,2,3,5,3,2,3,2,1
"Jun 8, 2019 9:00 PM",27,11,16,,,,,,,,,,4,2,2,0,,,,13,13,0,3,3,3,0,3,8,0,0,2,2,0,0,0,0
"Jun 8, 2019 10:00 PM",22,10,12,,,,,,,,,,3,1,2,0,,,,8,7,1,3,3,3,0,3,12,1,1,2,0,2,0,0,0
"Jun 8, 2019 11:00 PM",15,5,10,,,,,,,,,,5,2,3,0,,,,5,5,0,1,8,0,0,0,3,1,0,1,1,0,0,0,0
"Jun 9, 2019 12:00 AM",7,2,5,,,,,,,,,,3,3,0,0,,,,5,5,0,4,2,1,0,1,10,0,0,0,0,0,2,0,2
"Jun 9, 2019 1:00 AM",9,0,9,,,,,,,,,,4,3,1,0,,,,2,2,0,2,1,1,1,0,2,1,0,0,0,0,0,0,0
"Jun 9, 2019 2:00 AM",5,0,5,,,,,,,,,,0,0,0,0,,,,5,4,1,2,5,3,3,0,0,0,1,0,0,0,0,0,0
"Jun 9, 2019 3:00 AM",4,1,3,,,,,,,,,,0,0,0,0,,,,0,0,0,0,0,0,0,0,3,0,1,1,0,1,3,3,0
"Jun 9, 2019 4:00 AM",6,0,6,,,,,,,,,,1,1,0,0,,,,0,0,0,1,1,3,0,3,2,0,0,1,1,0,0,0,0
"Jun 9, 2019 5:00 AM",0,0,0,,,,,,,,,,0,0,0,0,,,,2,1,1,0,4,1,1,0,2,0,0,0,0,0,0,0,0
"Jun 9, 2019 6:00 AM",12,4,8,,,,,,,,,,1,1,0,0,,,,10,9,1,3,15,0,0,0,11,1,5,1,0,1,2,2,0
"Jun 9, 2019 7:00 AM",14,6,8,,,,,,,,,,2,2,0,0,,,,8,7,1,6,18,4,0,4,14,0,9,0,0,0,0,0,0
"Jun 9, 2019 8:00 AM",19,8,11,,,,,,,,,,0,0,0,0,,,,7,4,3,12,19,19,15,4,20,0,11,2,1,1,0,0,0
"Jun 9, 2019 9:00 AM",36,24,12,,,,,,,,,,21,11,10,0,,,,16,12,4,13,23,23,6,17,29,6,8,1,0,1,0,0,0
"Jun 9, 2019 10:00 AM",36,21,15,,,,,,,,,,20,6,14,0,,,,11,10,1,18,28,45,22,23,31,1,11,1,1,0,1,0,1
"Jun 9, 2019 11:00 AM",38,20,18,,,,,,,,,,20,7,13,0,,,,16,14,2,16,33,32,17,15,26,11,2,4,4,0,4,0,4
"Jun 9, 2019 12:00 PM",54,30,24,,,,,,,,,,45,18,27,0,,,,15,10,5,23,31,35,11,24,26,14,6,4,4,0,1,0,1
"Jun 9, 2019 1:00 PM",36,22,14,,,,,,,,,,26,16,10,0,,,,20,16,4,21,16,47,13,34,42,6,3,1,0,1,0,0,0
"Jun 9, 2019 2:00 PM",41,23,18,,,,,,,,,,23,9,14,0,,,,19,17,2,16,26,33,8,25,32,6,2,5,4,1,0,0,0
"Jun 9, 2019 3:00 PM",41,23,18,,,,,,,,,,8,3,5,0,,,,12,8,4,12,17,28,22,6,24,2,2,4,4,0,0,0,0
"Jun 9, 2019 4:00 PM",47,22,25,,,,,,,,,,31,19,12,0,,,,16,13,3,15,18,37,14,23,24,7,2,4,2,2,1,1,0
"Jun 9, 2019 5:00 PM",21,8,13,,,,,,,,,,17,13,4,0,,,,7,7,0,8,14,11,5,6,11,1,1,1,1,0,0,0,0
"Jun 9, 2019 6:00 PM",34,16,18,,,,,,,,,,2,2,0,0,,,,14,12,2,6,18,4,3,1,15,2,0,4,4,0,0,0,0
"Jun 9, 2019 7:00 PM",27,14,13,,,,,,,,,,4,2,2,0,,,,5,5,0,7,7,9,7,2,16,2,0,3,1,2,0,0,0
"Jun 9, 2019 8:00 PM",29,9,20,,,,,,,,,,1,1,0,0,,,,13,11,2,11,11,9,2,7,14,1,1,2,1,1,0,0,0
"Jun 9, 2019 9:00 PM",17,5,12,,,,,,,,,,5,3,2,0,,,,8,8,0,6,2,4,1,3,12,0,0,0,0,0,0,0,0
"Jun 9, 2019 10:00 PM",14,3,11,,,,,,,,,,5,2,3,0,,,,8,8,0,2,4,5,3,2,12,0,0,1,1,0,0,0,0
"Jun 9, 2019 11:00 PM",8,4,4,,,,,,,,,,0,0,0,0,,,,5,4,1,1,5,1,1,0,3,0,0,0,0,0,0,0,0
"Jun 10, 2019 12:00 AM",4,1,3,,,,,,,,,,0,0,0,0,,,,2,2,0,1,2,0,0,0,2,0,0,0,0,0,0,0,0
"Jun 10, 2019 1:00 AM",4,0,4,,,,,,,,,,0,0,0,0,,,,4,4,0,0,2,2,1,1,1,0,0,1,0,1,0,0,0
"Jun 10, 2019 2:00 AM",1,1,0,,,,,,,,,,0,0,0,0,,,,2,2,0,0,1,0,0,0,1,0,0,0,0,0,0,0,0
"Jun 10, 2019 3:00 AM",1,0,1,,,,,,,,,,0,0,0,0,,,,1,1,0,0,1,0,0,0,1,1,0,0,0,0,0,0,0
"Jun 10, 2019 4:00 AM",6,3,3,,,,,,,,,,0,0,0,0,,,,0,0,0,1,0,2,1,1,2,1,0,0,0,0,0,0,0
"Jun 10, 2019 5:00 AM",14,8,6,,,,,,,,,,1,0,1,0,,,,0,0,0,6,3,1,1,0,12,0,0,0,0,0,0,0,0
"Jun 10, 2019 6:00 AM",45,31,14,,,,,,,,,,8,2,6,0,,,,8,6,2,30,22,9,7,2,46,0,2,2,2,0,1,0,1
"Jun 10, 2019 7:00 AM",190,152,38,,,,,,,,,,12,2,10,0,,,,36,32,4,144,44,49,36,13,176,1,2,4,3,1,4,0,4
"Jun 10, 2019 8:00 AM",391,323,68,,,,,,,,,,24,3,21,0,,,,40,28,12,246,68,98,77,21,319,8,9,7,4,3,0,0,0
"Jun 10, 2019 9:00 AM",189,144,45,,,,,,,,,,26,10,16,0,,,,35,26,9,116,35,32,23,9,134,2,6,4,3,1,1,0,1
"Jun 10, 2019 10:00 AM",51,37,14,,,,,,,,,,11,4,7,0,,,,8,3,5,34,7,10,5,5,33,4,3,2,0,2,0,0,0
"Jun 10, 2019 11:00 AM",36,23,13,,,,,,,,,,13,7,6,0,,,,10,9,1,27,12,11,3,8,26,3,2,4,2,2,1,0,1
"Jun 10, 2019 12:00 PM",51,26,25,,,,,,,,,,23,15,8,0,,,,12,11,1,22,18,16,6,10,22,4,4,3,3,0,0,0,0
"Jun 10, 2019 1:00 PM",69,35,34,,,,,,,,,,22,14,8,0,,,,23,22,1,20,33,30,16,14,19,3,2,4,4,0,1,0,1
"Jun 10, 2019 2:00 PM",57,23,34,,,,,,,,,,14,9,5,0,,,,19,19,0,13,18,26,11,15,16,2,2,2,2,0,1,1,0
"Jun 10, 2019 3:00 PM",53,12,41,,,,,,,,,,15,11,4,0,,,,31,30,1,19,34,21,2,19,17,3,3,2,0,2,1,1,0
"Jun 10, 2019 4:00 PM",138,35,103,,,,,,,,,,20,9,11,0,,,,64,62,2,34,71,42,9,33,44,3,0,3,1,2,1,1,0
"Jun 10, 2019 5:00 PM",343,80,263,,,,,,,,,,32,14,18,0,,,,151,144,7,46,197,107,21,86,97,8,4,6,2,4,3,2,1
"Jun 10, 2019 6:00 PM",314,65,249,,,,,,,,,,42,33,9,0,,,,208,205,3,41,192,103,16,87,78,5,8,16,8,8,2,2,0
"Jun 10, 2019 7:00 PM",159,61,98,,,,,,,,,,27,10,17,0,,,,86,79,7,26,87,52,5,47,48,9,2,14,7,7,3,3,0
"Jun 10, 2019 8:00 PM",99,24,75,,,,,,,,,,12,7,5,0,,,,46,44,2,12,30,29,13,16,28,6,1,10,4,6,3,1,2
"Jun 10, 2019 9:00 PM",54,14,40,,,,,,,,,,7,5,2,0,,,,25,24,1,11,23,24,12,12,21,1,1,7,3,4,2,2,0
"Jun 10, 2019 10:00 PM",50,10,40,,,,,,,,,,5,5,0,0,,,,16,15,1,10,15,3,0,3,11,1,1,7,3,4,0,0,0
"Jun 10, 2019 11:00 PM",16,1,15,,,,,,,,,,3,2,1,0,,,,3,3,0,2,8,2,1,1,7,0,0,0,0,0,0,0,0
"Jun 11, 2019 12:00 AM",5,2,3,,,,,,,,,,0,0,0,0,,,,3,3,0,2,3,1,0,1,1,0,0,0,0,0,0,0,0
"Jun 11, 2019 1:00 AM",2,0,2,,,,,,,,,,0,0,0,0,,,,4,3,1,0,2,1,1,0,1,0,0,0,0,0,0,0,0
"Jun 11, 2019 2:00 AM",3,0,3,,,,,,,,,,0,0,0,0,,,,2,2,0,0,1,2,0,2,1,0,0,0,0,0,0,0,0
"Jun 11, 2019 3:00 AM",4,3,1,,,,,,,,,,1,0,1,0,,,,2,2,0,0,1,0,0,0,0,0,0,0,0,0,0,0,0
"Jun 11, 2019 4:00 AM",4,1,3,,,,,,,,,,0,0,0,0,,,,0,0,0,1,0,0,0,0,2,0,0,0,0,0,0,0,0
"Jun 11, 2019 5:00 AM",13,11,2,,,,,,,,,,0,0,0,0,,,,0,0,0,7,2,0,0,0,15,0,0,0,0,0,0,0,0
"Jun 11, 2019 6:00 AM",68,56,12,,,,,,,,,,8,1,7,0,,,,9,9,0,36,22,13,10,3,57,2,2,2,2,0,0,0,0
"Jun 11, 2019 7:00 AM",207,160,47,,,,,,,,,,17,2,15,0,,,,34,30,4,134,47,51,32,19,210,3,8,6,5,1,4,1,3
"Jun 11, 2019 8:00 AM",464,350,114,,,,,,,,,,28,9,19,0,,,,45,33,12,282,81,110,82,28,343,4,9,12,6,6,4,0,4
"Jun 11, 2019 9:00 AM",195,154,41,,,,,,,,,,15,6,9,1,,,,31,18,13,116,32,56,32,24,122,7,5,6,4,2,2,1,1
"Jun 11, 2019 10:00 AM",63,44,19,,,,,,,,,,12,6,6,7,,,,7,4,3,39,15,16,7,9,34,5,2,8,4,4,0,0,0
"Jun 11, 2019 11:00 AM",46,36,10,,,,,,,,,,8,5,3,4,,,,12,10,2,23,14,19,9,10,21,2,0,4,2,2,2,0,2
"Jun 11, 2019 12:00 PM",51,29,22,,,,,,,,,,14,7,7,6,,,,11,10,1,20,9,16,5,11,27,0,1,5,3,2,8,1,7
"Jun 11, 2019 1:00 PM",74,35,39,,,,,,,,,,14,7,7,9,,,,16,15,1,12,18,19,8,11,30,2,2,6,5,1,0,0,0
"Jun 11, 2019 2:00 PM",47,18,29,,,,,,,,,,17,10,7,11,,,,18,16,2,15,22,28,11,17,12,9,8,8,3,5,1,0,1
"Jun 11, 2019 3:00 PM",67,18,49,,,,,,,,,,18,8,10,13,,,,29,29,0,23,27,28,4,24,22,4,1,4,3,1,4,3,1
"Jun 11, 2019 4:00 PM",132,28,104,,,,,,,,,,18,10,8,18,,,,63,61,2,23,84,35,12,23,41,5,4,6,3,3,3,2,1
"Jun 11, 2019 5:00 PM",364,80,284,,,,,,,,,,29,18,11,36,,,,175,169,6,48,196,97,21,76,90,19,2,11,6,5,2,0,2
"Jun 11, 2019 6:00 PM",325,67,258,,,,,,,,,,33,21,12,28,,,,193,192,1,41,198,110,16,94,69,11,3,13,7,6,4,3,1
"Jun 11, 2019 7:00 PM",161,49,112,,,,,,,,,,25,15,10,27,,,,97,94,3,25,92,45,8,37,48,2,1,7,2,5,6,5,1
"Jun 11, 2019 8:00 PM",104,26,78,,,,,,,,,,14,8,6,11,,,,54,51,3,21,50,34,13,21,38,7,1,6,1,5,1,1,0
"Jun 11, 2019 9:00 PM",68,20,48,,,,,,,,,,14,8,6,7,,,,32,32,0,11,15,17,3,14,27,2,1,1,1,0,0,0,0
"Jun 11, 2019 10:00 PM",32,9,23,,,,,,,,,,8,6,2,5,,,,20,18,2,7,19,9,4,5,17,0,0,3,1,2,0,0,0
"Jun 11, 2019 11:00 PM",14,1,13,,,,,,,,,,5,3,2,1,,,,15,13,2,4,8,3,3,0,4,0,1,0,0,0,0,0,0
"Jun 12, 2019 12:00 AM",4,2,2,,,,,,,,,,0,0,0,1,,,,7,7,0,6,1,1,0,1,1,1,0,1,0,1,0,0,0
"Jun 12, 2019 1:00 AM",7,0,7,,,,,,,,,,1,1,0,0,,,,6,6,0,1,2,1,0,1,2,0,0,1,1,0,1,1,0
"Jun 12, 2019 2:00 AM",2,1,1,,,,,,,,,,0,0,0,0,,,,3,3,0,0,1,2,0,2,0,0,0,0,0,0,0,0,0
"Jun 12, 2019 3:00 AM",4,1,3,,,,,,,,,,0,0,0,0,,,,0,0,0,0,0,0,0,0,0,1,0,0,0,0,0,0,0
"Jun 12, 2019 4:00 AM",5,2,3,,,,,,,,,,1,1,0,0,,,,2,2,0,1,0,0,0,0,1,0,0,0,0,0,0,0,0
"Jun 12, 2019 5:00 AM",8,7,1,,,,,,,,,,0,0,0,1,,,,1,1,0,10,4,1,0,1,17,1,0,0,0,0,0,0,0
"Jun 12, 2019 6:00 AM",51,40,11,,,,,,,,,,3,1,2,3,,,,5,3,2,21,13,13,11,2,37,2,1,1,0,1,0,0,0
"Jun 12, 2019 7:00 AM",144,112,32,,,,,,,,,,3,1,2,7,,,,22,18,4,113,39,24,18,6,133,1,5,3,2,1,1,0,1
"Jun 12, 2019 8:00 AM",327,272,55,,,,,,,,,,13,5,8,27,,,,30,21,9,182,31,65,49,16,258,5,5,5,3,2,1,0,1
"Jun 12, 2019 9:00 AM",132,113,19,,,,,,,,,,8,5,3,7,,,,11,5,6,81,21,23,15,8,104,1,4,4,3,1,1,0,1
"Jun 12, 2019 10:00 AM",30,23,7,,,,,,,,,,1,1,0,3,,,,7,5,2,21,5,3,2,1,17,0,3,3,1,2,0,0,0
"Jun 12, 2019 11:00 AM",28,21,7,,,,,,,,,,2,1,1,1,,,,6,3,3,5,8,4,2,2,15,0,1,1,0,1,0,0,0
"Jun 12, 2019 12:00 PM",34,15,19,,,,,,,,,,2,1,1,7,,,,10,10,0,8,11,5,2,3,13,0,1,4,1,3,0,0,0
"Jun 12, 2019 1:00 PM",41,23,18,,,,,,,,,,5,3,2,3,,,,12,9,3,10,12,5,2,3,9,1,1,4,2,2,0,0,0
"Jun 12, 2019 2:00 PM",33,16,17,,,,,,,,,,2,2,0,7,,,,14,12,2,7,12,7,0,7,11,5,0,1,1,0,0,0,0
"Jun 12, 2019 3:00 PM",47,16,31,,,,,,,,,,4,1,3,7,,,,15,14,1,3,18,9,4,5,12,0,3,1,1,0,2,0,2
"Jun 12, 2019 4:00 PM",97,26,71,,,,,,,,,,8,3,5,8,,,,55,50,5,13,39,19,3,16,15,4,1,4,4,0,0,0,0
"Jun 12, 2019 5:00 PM",229,42,187,,,,,,,,,,13,8,5,16,,,,108,106,2,28,93,58,10,48,57,5,2,1,0,1,0,0,0
"Jun 12, 2019 6:00 PM",237,36,201,,,,,,,,,,16,11,5,16,,,,127,125,2,27,126,38,5,33,54,4,3,3,0,3,0,0,0
"Jun 12, 2019 7:00 PM",108,29,79,,,,,,,,,,4,0,4,13,,,,57,56,1,15,45,30,6,24,9,6,2,1,1,0,1,1,0
"Jun 12, 2019 8:00 PM",83,20,63,,,,,,,,,,7,3,4,9,,,,38,34,4,11,29,16,1,15,20,5,1,1,1,0,0,0,0
"Jun 12, 2019 9:00 PM",53,8,45,,,,,,,,,,5,5,0,9,,,,26,25,1,5,14,9,1,8,17,1,0,1,0,1,7,4,3
"Jun 12, 2019 10:00 PM",25,9,16,,,,,,,,,,0,0,0,6,,,,11,11,0,4,11,3,0,3,7,0,0,1,0,1,0,0,0
"Jun 12, 2019 11:00 PM",15,2,13,,,,,,,,,,0,0,0,3,,,,9,7,2,1,5,1,0,1,2,1,0,1,1,0,0,0,0
"Jun 13, 2019 12:00 AM",6,1,5,,,,,,,,,,0,0,0,0,,,,0,0,0,1,1,0,0,0,2,0,0,0,0,0,0,0,0
"Jun 13, 2019 1:00 AM",1,0,1,,,,,,,,,,0,0,0,2,,,,0,0,0,0,3,0,0,0,2,0,0,0,0,0,0,0,0
"Jun 13, 2019 2:00 AM",3,0,3,,,,,,,,,,0,0,0,0,,,,1,1,0,0,1,0,0,0,0,0,0,0,0,0,0,0,0
"Jun 13, 2019 3:00 AM",1,0,1,,,,,,,,,,0,0,0,0,,,,0,0,0,0,0,0,0,0,1,0,0,0,0,0,0,0,0
"Jun 13, 2019 4:00 AM",2,0,2,,,,,,,,,,1,0,1,0,,,,1,1,0,1,0,0,0,0,1,1,0,0,0,0,0,0,0
"Jun 13, 2019 5:00 AM",9,6,3,,,,,,,,,,1,0,1,2,,,,1,1,0,10,3,0,0,0,11,0,0,0,0,0,0,0,0
"Jun 13, 2019 6:00 AM",35,26,9,,,,,,,,,,3,0,3,4,,,,7,6,1,19,10,5,4,1,37,0,3,1,0,1,1,0,1
"Jun 13, 2019 7:00 AM",139,115,24,,,,,,,,,,6,4,2,9,,,,20,16,4,96,23,23,14,9,106,2,1,4,3,1,2,1,1
"Jun 13, 2019 8:00 AM",278,230,48,,,,,,,,,,12,3,9,19,,,,34,22,12,166,39,55,35,20,229,3,8,1,1,0,0,0,0
"Jun 13, 2019 9:00 AM",143,123,20,,,,,,,,,,5,2,3,8,,,,22,15,7,86,26,27,14,13,83,1,1,1,0,1,0,0,0
"Jun 13, 2019 10:00 AM",41,30,11,,,,,,,,,,9,5,4,9,,,,22,17,5,29,8,8,4,4,31,0,5,1,1,0,1,0,1
"Jun 13, 2019 11:00 AM",32,20,12,,,,,,,,,,9,4,5,4,,,,4,2,2,20,5,5,0,5,15,3,0,4,3,1,0,0,0
"Jun 13, 2019 12:00 PM",37,17,20,,,,,,,,,,11,6,5,6,,,,15,15,0,18,12,9,4,5,19,1,4,1,0,1,0,0,0
"Jun 13, 2019 1:00 PM",50,23,27,,,,,,,,,,7,4,3,6,,,,16,14,2,11,11,7,2,5,10,2,1,5,1,4,1,0,1
"Jun 13, 2019 2:00 PM",56,23,33,,,,,,,,,,6,2,4,7,,,,17,14,3,9,20,15,3,12,10,2,1,3,2,1,2,1,1
"Jun 13, 2019 3:00 PM",46,18,28,,,,,,,,,,16,8,8,15,,,,13,12,1,15,19,11,3,8,10,3,2,4,3,1,4,4,0
"Jun 13, 2019 4:00 PM",108,30,78,,,,,,,,,,14,6,8,18,,,,50,49,1,23,59,18,4,14,67,2,1,2,2,0,2,1,1
"Jun 13, 2019 5:00 PM",261,59,202,,,,,,,,,,26,14,12,25,,,,123,118,5,25,124,53,8,45,68,6,5,4,1,3,4,2,2
"Jun 13, 2019 6:00 PM",237,56,181,,,,,,,,,,20,9,11,20,,,,131,128,3,34,114,48,5,43,47,7,1,3,1,2,7,2,5
"Jun 13, 2019 7:00 PM",114,31,83,,,,,,,,,,11,6,5,20,,,,59,58,1,19,55,34,3,31,35,5,4,7,6,1,2,2,0
"Jun 13, 2019 8:00 PM",84,18,66,,,,,,,,,,8,4,4,10,,,,33,31,2,8,32,22,9,13,15,6,2,6,1,5,4,4,0
"Jun 13, 2019 9:00 PM",57,16,41,,,,,,,,,,11,9,2,5,,,,18,18,0,6,17,9,2,7,21,0,1,0,0,0,0,0,0
"Jun 13, 2019 10:00 PM",35,5,30,,,,,,,,,,6,4,2,15,,,,29,27,2,2,11,7,4,3,21,1,0,0,0,0,0,0,0
"Jun 13, 2019 11:00 PM",14,3,11,,,,,,,,,,2,2,0,2,,,,5,5,0,4,13,2,0,2,2,2,0,0,0,0,0,0,0
"Jun 14, 2019 12:00 AM",7,1,6,,,,,,,,,,0,0,0,0,,,,7,7,0,3,9,2,0,2,8,0,1,0,0,0,0,0,0
"Jun 14, 2019 1:00 AM",2,1,1,,,,,,,,,,2,0,2,1,,,,2,2,0,2,2,2,0,2,1,0,0,0,0,0,0,0,0
"Jun 14, 2019 2:00 AM",7,1,6,,,,,,,,,,0,0,0,0,,,,4,4,0,0,2,1,0,1,2,0,0,0,0,0,0,0,0
"Jun 14, 2019 3:00 AM",1,0,1,,,,,,,,,,0,0,0,0,,,,3,2,1,0,0,0,0,0,1,0,0,0,0,0,0,0,0
"Jun 14, 2019 4:00 AM",5,1,4,,,,,,,,,,0,0,0,0,,,,5,5,0,1,0,2,0,2,3,1,0,0,0,0,0,0,0
"Jun 14, 2019 5:00 AM",15,11,4,,,,,,,,,,0,0,0,1,,,,0,0,0,6,4,1,1,0,17,1,0,0,0,0,0,0,0
"Jun 14, 2019 6:00 AM",40,26,14,,,,,,,,,,5,1,4,4,,,,8,8,0,20,12,10,4,6,43,0,2,4,2,2,1,0,1
"Jun 14, 2019 7:00 AM",131,105,26,,,,,,,,,,9,2,7,13,,,,24,20,4,92,27,33,27,6,99,3,3,6,5,1,0,0,0
"Jun 14, 2019 8:00 AM",273,209,64,,,,,,,,,,18,1,17,22,,,,33,24,9,181,51,76,59,17,197,7,10,4,1,3,4,0,4
"Jun 14, 2019 9:00 AM",141,113,28,,,,,,,,,,22,9,13,14,,,,18,14,4,75,17,28,16,12,97,5,5,5,5,0,3,1,2
"Jun 14, 2019 10:00 AM",38,25,13,,,,,,,,,,20,7,13,13,,,,10,8,2,29,9,13,9,4,34,2,3,2,0,2,2,1,1
"Jun 14, 2019 11:00 AM",46,34,12,,,,,,,,,,11,4,7,12,,,,15,12,3,18,13,11,7,4,19,2,2,0,0,0,1,0,1
"Jun 14, 2019 12:00 PM",55,28,27,,,,,,,,,,11,8,3,7,,,,15,14,1,17,14,9,3,6,30,2,2,3,1,2,0,0,0
"Jun 14, 2019 1:00 PM",63,27,36,,,,,,,,,,8,5,3,8,,,,16,16,0,13,20,23,6,17,19,3,0,2,2,0,0,0,0
"Jun 14, 2019 2:00 PM",40,21,19,,,,,,,,,,16,7,9,10,,,,22,20,2,7,18,9,2,7,13,3,2,0,0,0,1,1,0
"Jun 14, 2019 3:00 PM",63,13,50,,,,,,,,,,6,4,2,8,,,,19,18,1,23,27,14,4,10,13,1,0,1,0,1,0,0,0
"Jun 14, 2019 4:00 PM",124,38,86,,,,,,,,,,6,5,1,7,,,,51,50,1,19,55,29,5,24,37,3,1,2,1,1,2,1,1
"Jun 14, 2019 5:00 PM",236,39,197,,,,,,,,,,20,11,9,23,,,,137,135,2,24,123,52,6,46,43,2,2,1,0,1,0,0,0
"Jun 14, 2019 6:00 PM",178,37,141,,,,,,,,,,19,16,3,39,,,,108,108,0,18,83,44,3,41,42,8,0,5,2,3,1,1,0
"Jun 14, 2019 7:00 PM",75,21,54,,,,,,,,,,12,8,4,15,,,,34,33,1,6,45,16,2,14,23,1,3,1,0,1,2,2,0
"Jun 14, 2019 8:00 PM",47,12,35,,,,,,,,,,8,5,3,4,,,,22,22,0,10,20,11,1,10,9,3,2,0,0,0,0,0,0
"Jun 14, 2019 9:00 PM",38,13,25,,,,,,,,,,3,3,0,5,,,,16,15,1,11,12,6,0,6,15,0,0,0,0,0,0,0,0
"Jun 14, 2019 10:00 PM",19,6,13,,,,,,,,,,7,6,1,2,,,,5,4,1,3,14,4,0,4,6,1,0,1,1,0,2,1,1
"Jun 14, 2019 11:00 PM",16,6,10,,,,,,,,,,1,1,0,1,,,,8,8,0,2,8,0,0,0,3,1,0,0,0,0,0,0,0
"Jun 15, 2019 12:00 AM",7,5,2,,,,,,,,,,2,0,2,2,,,,6,6,0,1,7,0,0,0,5,2,0,0,0,0,0,0,0
"Jun 15, 2019 1:00 AM",12,3,9,,,,,,,,,,1,1,0,1,,,,5,5,0,1,1,1,0,1,1,0,0,0,0,0,0,0,0
"Jun 15, 2019 2:00 AM",1,0,1,,,,,,,,,,0,0,0,1,,,,3,3,0,0,2,0,0,0,4,1,2,0,0,0,0,0,0
"Jun 15, 2019 3:00 AM",1,0,1,,,,,,,,,,0,0,0,1,,,,2,2,0,0,0,1,0,1,1,0,0,0,0,0,0,0,0
"Jun 15, 2019 4:00 AM",3,1,2,,,,,,,,,,0,0,0,0,,,,2,2,0,1,1,2,0,2,1,0,0,0,0,0,0,0,0
"Jun 15, 2019 5:00 AM",1,0,1,,,,,,,,,,0,0,0,2,,,,0,0,0,1,0,0,0,0,2,1,0,0,0,0,0,0,0
"Jun 15, 2019 6:00 AM",7,4,3,,,,,,,,,,1,1,0,2,,,,3,3,0,1,1,2,1,1,5,0,1,0,0,0,0,0,0
"Jun 15, 2019 7:00 AM",12,7,5,,,,,,,,,,2,0,2,1,,,,1,0,1,7,9,1,0,1,8,1,0,0,0,0,0,0,0
"Jun 15, 2019 8:00 AM",18,8,10,,,,,,,,,,8,4,4,4,,,,3,3,0,12,12,7,3,4,10,0,1,0,0,0,0,0,0
"Jun 15, 2019 9:00 AM",40,20,20,,,,,,,,,,14,9,5,3,,,,12,7,5,19,19,4,0,4,23,2,10,1,0,1,0,0,0
"Jun 15, 2019 10:00 AM",41,22,19,,,,,,,,,,16,9,7,8,,,,13,10,3,21,20,16,10,6,15,7,4,5,4,1,0,0,0
"Jun 15, 2019 11:00 AM",31,16,15,,,,,,,,,,19,9,10,15,,,,21,14,7,15,19,22,9,13,28,2,3,4,3,1,0,0,0
"Jun 15, 2019 12:00 PM",37,20,17,,,,,,,,,,26,4,22,23,,,,18,17,1,11,27,37,13,24,14,3,2,9,6,3,1,0,1
"Jun 15, 2019 1:00 PM",53,29,24,,,,,,,,,,23,12,11,16,,,,14,13,1,20,12,34,11,23,26,7,8,12,6,6,1,1,0
"Jun 15, 2019 2:00 PM",45,27,18,,,,,,,,,,35,25,10,13,,,,15,11,4,21,25,31,14,17,18,4,2,2,2,0,0,0,0
"Jun 15, 2019 3:00 PM",39,20,19,,,,,,,,,,29,15,14,16,,,,10,10,0,15,27,33,17,16,14,4,6,10,4,6,2,0,2
"Jun 15, 2019 4:00 PM",46,25,21,,,,,,,,,,15,9,6,36,,,,20,19,1,16,18,24,8,16,22,4,0,5,2,3,0,0,0
"Jun 15, 2019 5:00 PM",41,23,18,,,,,,,,,,29,16,13,14,,,,12,11,1,9,20,34,18,16,16,3,1,3,0,3,2,2,0
"Jun 15, 2019 6:00 PM",47,18,29,,,,,,,,,,23,16,7,11,,,,21,19,2,8,17,16,11,5,25,1,1,2,0,2,0,0,0
"Jun 15, 2019 7:00 PM",31,14,17,,,,,,,,,,21,11,10,17,,,,7,6,1,14,11,21,10,11,18,1,3,7,2,5,3,2,1
"Jun 15, 2019 8:00 PM",31,18,13,,,,,,,,,,3,2,1,21,,,,12,10,2,3,5,11,9,2,7,0,2,0,0,0,2,2,0
"Jun 15, 2019 9:00 PM",22,10,12,,,,,,,,,,3,0,3,5,,,,7,7,0,5,2,13,5,8,14,0,0,0,0,0,0,0,0
"Jun 15, 2019 10:00 PM",15,5,10,,,,,,,,,,9,4,5,2,,,,8,8,0,5,5,4,2,2,9,1,0,1,0,1,0,0,0
"Jun 15, 2019 11:00 PM",9,3,6,,,,,,,,,,3,0,3,5,,,,9,9,0,2,3,7,4,3,5,0,0,0,0,0,0,0,0
"Jun 16, 2019 12:00 AM",14,6,8,,,,,,,,,,2,2,0,1,,,,4,3,1,3,2,4,0,4,8,0,1,0,0,0,0,0,0
"Jun 16, 2019 1:00 AM",9,1,8,,,,,,,,,,1,0,1,0,,,,3,3,0,2,2,0,0,0,2,0,0,1,1,0,0,0,0
"Jun 16, 2019 2:00 AM",7,2,5,,,,,,,,,,0,0,0,1,,,,2,2,0,2,3,1,1,0,2,0,0,0,0,0,0,0,0
"Jun 16, 2019 3:00 AM",2,1,1,,,,,,,,,,0,0,0,0,,,,4,3,1,0,2,0,0,0,0,1,1,0,0,0,0,0,0
"Jun 16, 2019 4:00 AM",5,0,5,,,,,,,,,,0,0,0,0,,,,3,3,0,0,1,0,0,0,1,0,0,0,0,0,0,0,0
"Jun 16, 2019 5:00 AM",1,0,1,,,,,,,,,,1,1,0,0,,,,2,1,1,1,1,2,0,2,1,1,0,0,0,0,0,0,0
"Jun 16, 2019 6:00 AM",6,2,4,,,,,,,,,,0,0,0,1,,,,5,5,0,1,5,2,2,0,7,1,2,0,0,0,0,0,0
"Jun 16, 2019 7:00 AM",11,5,6,,,,,,,,,,2,2,0,5,,,,7,6,1,3,12,5,2,3,10,1,0,0,0,0,0,0,0
"Jun 16, 2019 8:00 AM",28,14,14,,,,,,,,,,2,1,1,6,,,,9,8,1,6,17,9,7,2,19,3,9,2,0,2,0,0,0
"Jun 16, 2019 9:00 AM",25,12,13,,,,,,,,,,28,11,17,6,,,,8,6,2,12,19,18,7,11,32,8,10,1,1,0,0,0,0
"Jun 16, 2019 10:00 AM",28,16,12,,,,,,,,,,13,9,4,18,,,,13,9,4,13,16,24,9,15,18,8,8,2,0,2,1,0,1
"Jun 16, 2019 11:00 AM",33,15,18,,,,,,,,,,9,2,7,6,,,,12,11,1,17,36,19,3,16,32,3,4,1,1,0,2,2,0
"Jun 16, 2019 12:00 PM",46,33,13,,,,,,,,,,3,0,3,9,,,,10,8,2,15,33,16,6,10,20,7,3,4,3,1,0,0,0
"Jun 16, 2019 1:00 PM",43,29,14,,,,,,,,,,13,5,8,8,,,,11,11,0,12,16,22,10,12,31,13,0,1,0,1,2,2,0
"Jun 16, 2019 2:00 PM",38,21,17,,,,,,,,,,31,18,13,13,,,,9,8,1,11,21,24,13,11,14,5,3,2,1,1,0,0,0
"Jun 16, 2019 3:00 PM",39,17,22,,,,,,,,,,28,17,11,18,,,,7,7,0,14,14,30,11,19,21,7,2,8,7,1,0,0,0
"Jun 16, 2019 4:00 PM",40,22,18,,,,,,,,,,42,25,17,12,,,,7,7,0,10,13,33,15,18,23,1,2,1,1,0,2,0,2
"Jun 16, 2019 5:00 PM",51,21,30,,,,,,,,,,21,14,7,29,,,,12,10,2,10,12,20,13,7,21,0,3,3,2,1,0,0,0
"Jun 16, 2019 6:00 PM",47,18,29,,,,,,,,,,13,6,7,14,,,,16,16,0,13,22,16,5,11,17,0,1,2,2,0,1,0,1
"Jun 16, 2019 7:00 PM",28,13,15,,,,,,,,,,19,9,10,11,,,,12,10,2,7,17,7,2,5,13,1,0,4,3,1,5,3,2
"Jun 16, 2019 8:00 PM",12,6,6,,,,,,,,,,8,4,4,5,,,,3,3,0,6,2,5,3,2,8,0,1,0,0,0,0,0,0
"Jun 16, 2019 9:00 PM",23,11,12,,,,,,,,,,6,3,3,2,,,,4,4,0,8,2,3,1,2,6,0,1,0,0,0,0,0,0
"Jun 16, 2019 10:00 PM",15,4,11,,,,,,,,,,1,1,0,1,,,,9,9,0,8,2,3,1,2,11,0,1,0,0,0,2,0,2
"Jun 16, 2019 11:00 PM",10,3,7,,,,,,,,,,0,0,0,0,,,,3,3,0,1,3,1,0,1,1,0,3,0,0,0,0,0,0
"Jun 17, 2019 12:00 AM",7,1,6,,,,,,,,,,1,1,0,1,,,,3,3,0,0,0,6,5,1,3,0,0,0,0,0,0,0,0
"Jun 17, 2019 1:00 AM",2,1,1,,,,,,,,,,0,0,0,4,,,,1,1,0,0,2,0,0,0,1,0,0,0,0,0,0,0,0
"Jun 17, 2019 2:00 AM",2,0,2,,,,,,,,,,0,0,0,1,,,,4,4,0,0,1,0,0,0,0,0,0,0,0,0,0,0,0
"Jun 17, 2019 3:00 AM",1,1,0,,,,,,,,,,0,0,0,0,,,,1,1,0,0,0,2,1,1,1,0,0,0,0,0,0,0,0
"Jun 17, 2019 4:00 AM",1,0,1,,,,,,,,,,0,0,0,0,,,,0,0,0,2,1,1,0,1,1,0,0,0,0,0,0,0,0
"Jun 17, 2019 5:00 AM",8,6,2,,,,,,,,,,0,0,0,0,,,,1,1,0,4,5,4,1,3,13,2,0,0,0,0,0,0,0
"Jun 17, 2019 6:00 AM",57,42,15,,,,,,,,,,8,0,8,5,,,,1,1,0,29,18,13,9,4,38,1,1,3,2,1,2,0,2
"Jun 17, 2019 7:00 AM",155,122,33,,,,,,,,,,7,2,5,12,,,,36,28,8,145,35,45,31,14,184,3,3,6,4,2,3,0,3
"Jun 17, 2019 8:00 AM",421,338,83,,,,,,,,,,22,5,17,28,,,,48,33,15,273,66,110,82,28,320,3,13,2,1,1,2,0,2
"Jun 17, 2019 9:00 AM",183,152,31,,,,,,,,,,26,2,24,13,,,,31,25,6,105,23,44,26,18,133,3,6,6,2,4,4,0,4
"Jun 17, 2019 10:00 AM",54,40,14,,,,,,,,,,12,2,10,7,,,,12,9,3,34,13,10,8,2,44,1,3,3,1,2,1,1,0
"Jun 17, 2019 11:00 AM",39,29,10,,,,,,,,,,7,1,6,15,,,,12,9,3,16,13,17,6,11,18,3,5,1,1,0,0,0,0
"Jun 17, 2019 12:00 PM",48,19,29,,,,,,,,,,13,8,5,8,,,,22,21,1,23,17,21,11,10,24,4,1,3,3,0,0,0,0
"Jun 17, 2019 1:00 PM",55,22,33,,,,,,,,,,23,11,12,6,,,,15,14,1,19,25,15,7,8,18,4,1,5,3,2,0,0,0
"Jun 17, 2019 2:00 PM",51,28,23,,,,,,,,,,12,5,7,12,,,,17,16,1,10,18,23,7,16,26,2,5,2,1,1,1,0,1
"Jun 17, 2019 3:00 PM",44,19,25,,,,,,,,,,16,12,4,8,,,,29,29,0,16,28,16,8,8,18,2,7,1,1,0,1,1,0
"Jun 17, 2019 4:00 PM",117,29,88,,,,,,,,,,15,7,8,21,,,,54,54,0,30,80,38,7,31,32,2,4,5,2,3,0,0,0
"Jun 17, 2019 5:00 PM",308,55,253,,,,,,,,,,28,18,10,20,,,,177,173,4,44,191,87,11,76,77,9,3,6,4,2,0,0,0
"Jun 17, 2019 6:00 PM",311,55,256,,,,,,,,,,32,25,7,35,,,,206,198,8,38,192,108,10,98,67,8,0,3,2,1,6,4,2
"Jun 17, 2019 7:00 PM",142,35,107,,,,,,,,,,26,18,8,10,,,,73,73,0,18,67,47,8,39,27,3,5,0,0,0,4,3,1
"Jun 17, 2019 8:00 PM",80,10,70,,,,,,,,,,5,2,3,18,,,,38,34,4,15,33,30,10,20,18,2,3,4,1,3,4,4,0
"Jun 17, 2019 9:00 PM",59,8,51,,,,,,,,,,4,4,0,9,,,,26,22,4,9,19,8,5,3,11,2,0,0,0,0,0,0,0
"Jun 17, 2019 10:00 PM",38,12,26,,,,,,,,,,4,4,0,9,,,,12,12,0,4,13,6,2,4,17,0,0,1,1,0,0,0,0
"Jun 17, 2019 11:00 PM",12,1,11,,,,,,,,,,0,0,0,1,,,,4,3,1,2,3,2,0,2,5,0,0,0,0,0,0,0,0
"Jun 18, 2019 12:00 AM",3,1,2,,,,,,,,,,0,0,0,5,,,,4,3,1,0,4,1,0,1,2,0,0,0,0,0,0,0,0
"Jun 18, 2019 1:00 AM",3,0,3,,,,,,,,,,0,0,0,0,,,,1,1,0,1,0,0,0,0,4,0,0,0,0,0,0,0,0
"Jun 18, 2019 2:00 AM",3,1,2,,,,,,,,,,0,0,0,0,,,,3,3,0,0,1,2,0,2,0,0,0,0,0,0,0,0,0
"Jun 18, 2019 3:00 AM",1,0,1,,,,,,,,,,0,0,0,0,,,,0,0,0,0,0,0,0,0,0,1,0,0,0,0,0,0,0
"Jun 18, 2019 4:00 AM",2,1,1,,,,,,,,,,0,0,0,0,,,,0,0,0,2,3,0,0,0,1,1,0,0,0,0,0,0,0
"Jun 18, 2019 5:00 AM",12,8,4,,,,,,,,,,0,0,0,2,,,,1,1,0,7,4,0,0,0,17,2,0,0,0,0,0,0,0
"Jun 18, 2019 6:00 AM",59,44,15,,,,,,,,,,7,4,3,8,,,,9,8,1,36,22,6,4,2,52,0,3,3,1,2,1,0,1
"Jun 18, 2019 7:00 AM",203,160,43,,,,,,,,,,18,5,13,20,,,,40,31,9,130,40,57,43,14,205,1,5,4,3,1,3,1,2
"Jun 18, 2019 8:00 AM",422,335,87,,,,,,,,,,27,3,24,24,,,,51,37,14,267,75,128,95,33,343,7,8,9,3,6,3,0,3
"Jun 18, 2019 9:00 AM",179,155,24,,,,,,,,,,22,8,14,11,,,,25,15,10,108,26,56,32,24,113,8,5,4,2,2,0,0,0
"Jun 18, 2019 10:00 AM",50,38,12,,,,,,,,,,9,4,5,4,,,,14,8,6,42,21,22,16,6,35,0,3,2,1,1,4,3,1
"Jun 18, 2019 11:00 AM",52,39,13,,,,,,,,,,13,3,10,6,,,,13,11,2,21,16,11,5,6,32,0,2,2,2,0,0,0,0
"Jun 18, 2019 12:00 PM",46,27,19,,,,,,,,,,20,7,13,13,,,,13,11,2,26,12,32,12,20,32,4,2,2,1,1,2,1,1
"Jun 18, 2019 1:00 PM",53,29,24,,,,,,,,,,22,17,5,11,,,,23,21,2,23,25,39,14,25,19,8,5,5,3,2,0,0,0
"Jun 18, 2019 2:00 PM",56,23,33,,,,,,,,,,11,7,4,16,,,,17,16,1,15,27,28,11,17,19,2,5,2,1,1,1,1,0
"Jun 18, 2019 3:00 PM",66,29,37,,,,,,,,,,22,17,5,13,,,,25,24,1,17,30,25,6,19,18,5,8,2,2,0,0,0,0
"Jun 18, 2019 4:00 PM",154,38,116,,,,,,,,,,30,17,13,26,,,,64,61,3,33,78,55,18,37,41,5,1,0,0,0,0,0,0
"Jun 18, 2019 5:00 PM",309,74,235,,,,,,,,,,28,14,14,27,,,,164,161,3,51,214,108,15,93,72,9,6,7,3,4,2,2,0
"Jun 18, 2019 6:00 PM",345,59,286,,,,,,,,,,30,22,8,25,,,,192,189,3,36,185,119,17,102,69,4,4,3,3,0,2,1,1
"Jun 18, 2019 7:00 PM",167,36,131,,,,,,,,,,19,10,9,29,,,,89,87,2,25,80,60,8,52,43,4,8,6,3,3,1,1,0
"Jun 18, 2019 8:00 PM",122,36,86,,,,,,,,,,16,6,10,11,,,,52,48,4,17,47,33,16,17,32,8,2,8,5,3,1,1,0
"Jun 18, 2019 9:00 PM",70,10,60,,,,,,,,,,5,4,1,14,,,,34,33,1,10,30,16,3,13,16,1,0,7,3,4,2,2,0
"Jun 18, 2019 10:00 PM",40,14,26,,,,,,,,,,11,7,4,5,,,,22,21,1,5,13,10,3,7,10,0,1,0,0,0,0,0,0
"Jun 18, 2019 11:00 PM",21,8,13,,,,,,,,,,2,2,0,1,,,,9,9,0,8,13,4,1,3,8,0,0,1,0,1,0,0,0
"Jun 19, 2019 12:00 AM",5,0,5,,,,,,,,,,0,0,0,4,,,,7,7,0,0,5,2,0,2,4,1,0,1,1,0,0,0,0
"Jun 19, 2019 1:00 AM",3,1,2,,,,,,,,,,1,0,1,0,,,,4,3,1,1,0,1,0,1,1,1,0,0,0,0,0,0,0
"Jun 19, 2019 2:00 AM",2,0,2,,,,,,,,,,1,1,0,2,,,,1,1,0,0,1,0,0,0,0,0,0,0,0,0,0,0,0
"Jun 19, 2019 3:00 AM",2,1,1,,,,,,,,,,0,0,0,0,,,,0,0,0,0,1,0,0,0,0,1,0,0,0,0,0,0,0
"Jun 19, 2019 4:00 AM",1,1,0,,,,,,,,,,0,0,0,0,,,,2,2,0,3,0,1,0,1,1,0,0,0,0,0,0,0,0
"Jun 19, 2019 5:00 AM",12,8,4,,,,,,,,,,0,0,0,1,,,,1,1,0,8,8,1,0,1,14,1,1,0,0,0,0,0,0
"Jun 19, 2019 6:00 AM",58,44,14,,,,,,,,,,4,4,0,5,,,,9,7,2,33,21,9,8,1,62,1,2,0,0,0,0,0,0
"Jun 19, 2019 7:00 AM",192,152,40,,,,,,,,,,9,9,0,18,,,,39,30,9,143,46,40,34,6,168,2,3,7,5,2,1,0,1
"Jun 19, 2019 8:00 AM",410,330,80,,,,,,,,,,20,1,19,32,,,,47,36,11,257,71,106,77,29,332,11,9,12,8,4,1,0,1
"Jun 19, 2019 9:00 AM",185,158,27,,,,,,,,,,21,3,18,10,,,,25,14,11,102,40,51,29,22,117,7,11,7,4,3,3,1,2
"Jun 19, 2019 10:00 AM",51,34,17,,,,,,,,,,14,4,10,12,,,,17,13,4,29,11,20,11,9,31,5,5,8,3,5,2,1,1
"Jun 19, 2019 11:00 AM",40,21,19,,,,,,,,,,11,3,8,4,,,,12,8,4,19,12,20,9,11,35,2,3,6,1,5,0,0,0
"Jun 19, 2019 12:00 PM",58,29,29,,,,,,,,,,24,11,13,8,,,,19,13,6,29,17,24,8,16,25,7,3,6,4,2,2,2,0
"Jun 19, 2019 1:00 PM",69,30,39,,,,,,,,,,12,3,9,6,,,,20,18,2,15,29,23,12,11,19,5,2,3,2,1,2,1,1
"Jun 19, 2019 2:00 PM",65,26,39,,,,,,,,,,16,12,4,14,,,,22,20,2,15,19,18,1,17,18,8,3,4,2,2,3,3,0
"Jun 19, 2019 3:00 PM",53,19,34,,,,,,,,,,19,9,10,14,,,,22,17,5,16,24,31,5,26,17,3,0,2,2,0,0,0,0
"Jun 19, 2019 4:00 PM",130,31,99,,,,,,,,,,21,5,16,20,,,,64,61,3,23,67,36,6,30,40,6,4,5,2,3,0,0,0
"Jun 19, 2019 5:00 PM",267,57,210,,,,,,,,,,20,8,12,29,,,,155,152,3,44,195,71,14,57,84,5,3,9,6,3,3,2,1
"Jun 19, 2019 6:00 PM",317,61,256,,,,,,,,,,16,9,7,34,,,,184,180,4,40,175,107,19,88,82,4,9,6,4,2,7,4,3
"Jun 19, 2019 7:00 PM",163,40,123,,,,,,,,,,20,13,7,16,,,,79,78,1,28,58,37,5,32,32,3,3,5,3,2,2,1,1
"Jun 19, 2019 8:00 PM",93,24,69,,,,,,,,,,6,0,6,9,,,,48,46,2,16,40,28,10,18,28,2,2,3,1,2,2,2,0
"Jun 19, 2019 9:00 PM",65,14,51,,,,,,,,,,10,9,1,6,,,,22,22,0,15,21,14,2,12,18,1,2,2,1,1,2,2,0
"Jun 19, 2019 10:00 PM",43,16,27,,,,,,,,,,6,5,1,3,,,,27,26,1,6,8,6,3,3,13,2,1,3,3,0,0,0,0
"Jun 19, 2019 11:00 PM",14,2,12,,,,,,,,,,2,2,0,4,,,,15,14,1,7,5,4,2,2,5,0,1,0,0,0,0,0,0
"Jun 20, 2019 12:00 AM",9,2,7,,,,,,,,,,3,3,0,2,,,,5,5,0,0,8,1,0,1,4,0,0,0,0,0,0,0,0
"Jun 20, 2019 1:00 AM",2,0,2,,,,,,,,,,0,0,0,2,,,,2,2,0,0,1,0,0,0,0,0,0,0,0,0,0,0,0
"Jun 20, 2019 2:00 AM",4,1,3,,,,,,,,,,0,0,0,0,,,,1,1,0,0,1,0,0,0,0,0,0,0,0,0,0,0,0
"Jun 20, 2019 3:00 AM",2,1,1,,,,,,,,,,0,0,0,0,,,,0,0,0,0,0,0,0,0,1,1,0,0,0,0,0,0,0
"Jun 20, 2019 4:00 AM",3,0,3,,,,,,,,,,0,0,0,0,,,,1,1,0,1,0,0,0,0,4,0,0,0,0,0,0,0,0
"Jun 20, 2019 5:00 AM",7,5,2,,,,,,,,,,0,0,0,3,,,,2,2,0,7,3,0,0,0,17,2,0,0,0,0,0,0,0
"Jun 20, 2019 6:00 AM",50,34,16,,,,,,,,,,3,0,3,6,,,,6,5,1,34,20,12,6,6,47,2,2,2,1,1,1,0,1
"Jun 20, 2019 7:00 AM",165,139,26,,,,,,,,,,17,6,11,18,,,,43,40,3,126,32,40,31,9,179,3,2,4,3,1,0,0,0
"Jun 20, 2019 8:00 AM",388,303,85,,,,,,,,,,31,4,27,26,,,,37,29,8,227,80,97,74,23,276,6,11,4,2,2,3,2,1
"Jun 20, 2019 9:00 AM",180,148,32,,,,,,,,,,24,7,17,17,,,,32,19,13,98,27,47,27,20,100,4,12,7,4,3,3,2,1
"Jun 20, 2019 10:00 AM",54,32,22,,,,,,,,,,14,0,14,8,,,,14,8,6,38,15,31,23,8,28,3,2,2,1,1,2,1,1
"Jun 20, 2019 11:00 AM",47,33,14,,,,,,,,,,18,8,10,5,,,,7,5,2,17,20,24,13,11,22,3,3,4,1,3,4,2,2
"Jun 20, 2019 12:00 PM",50,28,22,,,,,,,,,,12,6,6,8,,,,13,13,0,29,23,12,6,6,22,2,2,1,1,0,0,0,0
"Jun 20, 2019 1:00 PM",76,31,45,,,,,,,,,,16,11,5,11,,,,22,20,2,11,28,27,10,17,17,7,1,4,2,2,1,0,1
"Jun 20, 2019 2:00 PM",53,24,29,,,,,,,,,,11,6,5,9,,,,21,21,0,14,21,20,0,20,16,2,1,8,5,3,1,0,1
"Jun 20, 2019 3:00 PM",60,22,38,,,,,,,,,,11,5,6,4,,,,21,19,2,10,35,25,12,13,10,5,4,2,1,1,0,0,0
"Jun 20, 2019 4:00 PM",141,41,100,,,,,,,,,,22,15,7,17,,,,50,50,0,21,77,42,8,34,45,5,1,7,5,2,2,1,1
"Jun 20, 2019 5:00 PM",300,64,236,,,,,,,,,,19,14,5,26,,,,134,132,2,35,182,89,16,73,67,7,3,9,6,3,2,0,2
"Jun 20, 2019 6:00 PM",249,53,196,,,,,,,,,,28,22,6,18,,,,178,176,2,46,143,57,9,48,69,9,6,5,3,2,0,0,0
"Jun 20, 2019 7:00 PM",123,35,88,,,,,,,,,,18,14,4,10,,,,67,64,3,19,64,44,11,33,38,3,6,5,2,3,2,1,1
"Jun 20, 2019 8:00 PM",82,23,59,,,,,,,,,,9,8,1,6,,,,44,42,2,10,28,35,12,23,19,3,2,2,1,1,0,0,0
"Jun 20, 2019 9:00 PM",54,8,46,,,,,,,,,,7,3,4,12,,,,27,24,3,7,26,25,3,22,20,0,2,1,0,1,0,0,0
"Jun 20, 2019 10:00 PM",46,9,37,,,,,,,,,,3,2,1,2,,,,14,13,1,6,11,5,1,4,13,2,2,4,3,1,0,0,0
"Jun 20, 2019 11:00 PM",22,6,16,,,,,,,,,,0,0,0,0,,,,13,12,1,3,8,5,2,3,3,3,0,1,1,0,0,0,0
"Jun 21, 2019 12:00 AM",19,6,13,,,,,,,,,,0,0,0,1,,,,4,3,1,3,5,1,1,0,6,1,2,0,0,0,0,0,0
"Jun 21, 2019 1:00 AM",3,1,2,,,,,,,,,,0,0,0,3,,,,3,3,0,0,4,0,0,0,3,0,0,0,0,0,0,0,0
"Jun 21, 2019 2:00 AM",4,0,4,,,,,,,,,,0,0,0,0,,,,3,3,0,0,1,0,0,0,1,0,0,0,0,0,1,1,0
"Jun 21, 2019 3:00 AM",1,1,0,,,,,,,,,,0,0,0,0,,,,1,1,0,0,0,0,0,0,0,0,0,0,0,0,0,0,0
"Jun 21, 2019 4:00 AM",3,1,2,,,,,,,,,,0,0,0,0,,,,4,4,0,1,3,4,0,4,9,2,0,0,0,0,0,0,0
"Jun 21, 2019 5:00 AM",12,5,7,,,,,,,,,,0,0,0,2,,,,1,1,0,10,5,11,6,5,12,2,0,0,0,0,0,0,0
"Jun 21, 2019 6:00 AM",43,35,8,,,,,,,,,,4,0,4,5,,,,11,8,3,29,21,5,4,1,53,1,1,3,1,2,1,0,1
"Jun 21, 2019 7:00 AM",145,115,30,,,,,,,,,,7,2,5,12,,,,30,26,4,103,33,40,23,17,117,3,2,3,2,1,0,0,0
"Jun 21, 2019 8:00 AM",291,226,65,,,,,,,,,,25,2,23,27,,,,33,26,7,183,63,78,54,24,206,2,8,4,1,3,0,0,0
"Jun 21, 2019 9:00 AM",157,128,29,,,,,,,,,,19,3,16,12,,,,19,11,8,85,26,41,26,15,94,4,9,3,2,1,3,1,2
"Jun 21, 2019 10:00 AM",53,39,14,,,,,,,,,,14,4,10,7,,,,12,8,4,37,12,27,14,13,38,2,5,4,1,3,1,0,1
"Jun 21, 2019 11:00 AM",46,29,17,,,,,,,,,,21,11,10,9,,,,10,9,1,14,19,28,19,9,33,2,7,2,2,0,0,0,0
"Jun 21, 2019 12:00 PM",57,27,30,,,,,,,,,,11,6,5,16,,,,20,19,1,23,26,30,12,18,26,3,5,0,0,0,0,0,0
"Jun 21, 2019 1:00 PM",69,22,47,,,,,,,,,,20,7,13,10,,,,23,22,1,16,29,44,15,29,26,5,2,4,3,1,1,1,0
"Jun 21, 2019 2:00 PM",64,29,35,,,,,,,,,,16,8,8,12,,,,31,28,3,10,24,31,13,18,25,3,3,1,1,0,1,1,0
"Jun 21, 2019 3:00 PM",69,23,46,,,,,,,,,,19,11,8,12,,,,32,32,0,24,36,28,14,14,18,3,1,5,4,1,1,1,0
"Jun 21, 2019 4:00 PM",140,29,111,,,,,,,,,,18,13,5,16,,,,49,45,4,17,76,33,5,28,37,7,4,2,1,1,1,0,1
"Jun 21, 2019 5:00 PM",242,46,196,,,,,,,,,,27,18,9,35,,,,133,130,3,34,147,80,9,71,52,3,1,3,2,1,1,0,1
"Jun 21, 2019 6:00 PM",182,35,147,,,,,,,,,,11,6,5,22,,,,96,95,1,22,93,74,12,62,44,9,8,4,2,2,3,3,0
"Jun 21, 2019 7:00 PM",82,22,60,,,,,,,,,,17,10,7,15,,,,53,51,2,14,43,32,5,27,28,4,6,3,2,1,1,1,0
"Jun 21, 2019 8:00 PM",71,27,44,,,,,,,,,,9,7,2,5,,,,29,27,2,7,24,16,8,8,17,4,3,7,3,4,0,0,0
"Jun 21, 2019 9:00 PM",30,13,17,,,,,,,,,,4,4,0,11,,,,19,18,1,6,18,9,3,6,12,2,0,0,0,0,0,0,0
"Jun 21, 2019 10:00 PM",42,18,24,,,,,,,,,,2,1,1,5,,,,10,10,0,4,14,14,10,4,13,0,1,1,1,0,2,0,2
"Jun 21, 2019 11:00 PM",21,4,17,,,,,,,,,,0,0,0,1,,,,9,9,0,9,8,5,5,0,3,1,1,0,0,0,0,0,0
"Jun 22, 2019 12:00 AM",14,6,8,,,,,,,,,,1,1,0,3,,,,11,11,0,3,5,5,2,3,5,0,0,0,0,0,0,0,0
"Jun 22, 2019 1:00 AM",5,2,3,,,,,,,,,,0,0,0,1,,,,4,3,1,3,1,0,0,0,8,0,0,2,1,1,1,0,1
"Jun 22, 2019 2:00 AM",7,0,7,,,,,,,,,,2,0,2,2,,,,2,2,0,1,3,2,1,1,1,1,1,0,0,0,0,0,0
"Jun 22, 2019 3:00 AM",0,0,0,,,,,,,,,,0,0,0,1,,,,1,1,0,1,1,3,3,0,4,1,1,0,0,0,0,0,0
"Jun 22, 2019 4:00 AM",4,1,3,,,,,,,,,,0,0,0,0,,,,1,1,0,0,0,0,0,0,6,0,0,0,0,0,0,0,0
"Jun 22, 2019 5:00 AM",5,1,4,,,,,,,,,,0,0,0,0,,,,2,2,0,1,0,0,0,0,4,0,0,0,0,0,0,0,0
"Jun 22, 2019 6:00 AM",11,5,6,,,,,,,,,,1,0,1,0,,,,2,2,0,5,2,4,1,3,11,1,0,1,1,0,1,0,1
"Jun 22, 2019 7:00 AM",9,6,3,,,,,,,,,,4,2,2,1,,,,5,4,1,10,17,7,1,6,11,0,0,1,0,1,0,0,0
"Jun 22, 2019 8:00 AM",30,13,17,,,,,,,,,,5,2,3,4,,,,13,12,1,10,16,13,11,2,24,3,5,2,0,2,0,0,0
"Jun 22, 2019 9:00 AM",47,28,19,,,,,,,,,,17,10,7,5,,,,11,11,0,21,23,29,12,17,26,5,16,3,2,1,0,0,0
"Jun 22, 2019 10:00 AM",38,18,20,,,,,,,,,,20,13,7,2,,,,14,12,2,28,28,40,11,29,32,7,8,4,2,2,0,0,0
"Jun 22, 2019 11:00 AM",63,32,31,,,,,,,,,,21,11,10,8,,,,9,7,2,19,36,29,9,20,27,3,11,3,2,1,1,0,1
"Jun 22, 2019 12:00 PM",51,22,29,,,,,,,,,,31,11,20,16,,,,20,18,2,22,28,49,14,35,29,9,1,4,3,1,0,0,0
"Jun 22, 2019 1:00 PM",50,25,25,,,,,,,,,,27,16,11,17,,,,12,9,3,13,28,30,7,23,30,5,6,4,2,2,3,0,3
"Jun 22, 2019 2:00 PM",48,33,15,,,,,,,,,,32,21,11,15,,,,20,18,2,18,38,38,18,20,30,9,3,2,2,0,2,1,1
"Jun 22, 2019 3:00 PM",34,18,16,,,,,,,,,,31,15,16,18,,,,15,12,3,20,45,51,20,31,30,5,4,4,2,2,1,0,1
"Jun 22, 2019 4:00 PM",47,23,24,,,,,,,,,,35,21,14,33,,,,15,13,2,15,38,45,17,28,43,9,7,4,2,2,3,3,0
"Jun 22, 2019 5:00 PM",55,29,26,,,,,,,,,,60,34,26,12,,,,11,10,1,12,22,66,37,29,39,6,3,3,2,1,2,0,2
"Jun 22, 2019 6:00 PM",50,19,31,,,,,,,,,,30,20,10,16,,,,13,11,2,9,26,41,24,17,31,2,4,1,0,1,1,0,1
"Jun 22, 2019 7:00 PM",28,14,14,,,,,,,,,,15,7,8,67,,,,13,10,3,15,16,17,10,7,30,3,4,1,0,1,0,0,0
"Jun 22, 2019 8:00 PM",28,16,12,,,,,,,,,,14,9,5,7,,,,12,10,2,19,9,13,11,2,15,2,3,2,0,2,0,0,0
"Jun 22, 2019 9:00 PM",28,10,18,,,,,,,,,,7,7,0,2,,,,6,5,1,13,4,7,3,4,9,1,1,0,0,0,0,0,0
"Jun 22, 2019 10:00 PM",20,6,14,,,,,,,,,,1,0,1,2,,,,9,9,0,2,7,7,2,5,12,2,0,1,1,0,1,0,1
"Jun 22, 2019 11:00 PM",12,4,8,,,,,,,,,,10,8,2,2,,,,5,5,0,2,5,4,1,3,3,0,0,0,0,0,0,0,0
"Jun 23, 2019 12:00 AM",11,2,9,,,,,,,,,,1,0,1,3,,,,7,6,1,2,8,3,3,0,3,0,0,0,0,0,0,0,0
"Jun 23, 2019 1:00 AM",10,2,8,,,,,,,,,,4,1,3,1,,,,7,7,0,2,1,3,2,1,2,0,0,0,0,0,0,0,0
"Jun 23, 2019 2:00 AM",4,1,3,,,,,,,,,,2,2,0,0,,,,3,3,0,0,4,0,0,0,0,0,0,0,0,0,0,0,0
"Jun 23, 2019 3:00 AM",4,1,3,,,,,,,,,,1,1,0,0,,,,5,5,0,0,1,2,1,1,1,1,1,1,0,1,0,0,0
"Jun 23, 2019 4:00 AM",4,1,3,,,,,,,,,,0,0,0,0,,,,2,2,0,1,0,0,0,0,1,1,0,0,0,0,0,0,0
"Jun 23, 2019 5:00 AM",6,3,3,,,,,,,,,,0,0,0,1,,,,1,1,0,0,0,0,0,0,4,0,0,0,0,0,0,0,0
"Jun 23, 2019 6:00 AM",3,2,1,,,,,,,,,,1,1,0,0,,,,2,2,0,5,5,3,1,2,12,2,0,0,0,0,0,0,0
"Jun 23, 2019 7:00 AM",13,6,7,,,,,,,,,,2,1,1,4,,,,7,5,2,3,8,7,4,3,15,2,4,0,0,0,0,0,0
"Jun 23, 2019 8:00 AM",20,10,10,,,,,,,,,,2,1,1,11,,,,9,7,2,6,9,5,1,4,17,3,11,0,0,0,0,0,0
"Jun 23, 2019 9:00 AM",27,13,14,,,,,,,,,,7,3,4,12,,,,10,7,3,12,23,11,6,5,24,5,6,0,0,0,0,0,0
"Jun 23, 2019 10:00 AM",33,14,19,,,,,,,,,,17,12,5,8,,,,8,3,5,13,19,19,4,15,28,4,4,2,2,0,1,0,1
"Jun 23, 2019 11:00 AM",42,27,15,,,,,,,,,,26,11,15,13,,,,11,10,1,28,27,24,6,18,18,4,4,2,1,1,0,0,0
"Jun 23, 2019 12:00 PM",35,20,15,,,,,,,,,,31,13,18,14,,,,14,9,5,10,21,40,16,24,31,3,4,4,4,0,0,0,0
"Jun 23, 2019 1:00 PM",34,19,15,,,,,,,,,,44,16,28,6,,,,12,11,1,23,24,11,7,4,21,3,3,7,3,4,4,3,1
"Jun 23, 2019 2:00 PM",34,17,17,,,,,,,,,,26,19,7,22,,,,19,15,4,17,24,26,11,15,16,4,1,3,3,0,0,0,0
"Jun 23, 2019 3:00 PM",23,11,12,,,,,,,,,,29,18,11,5,,,,10,8,2,5,13,13,9,4,19,4,0,2,2,0,0,0,0
"Jun 23, 2019 4:00 PM",31,15,16,,,,,,,,,,15,10,5,7,,,,10,10,0,6,9,10,2,8,25,2,2,1,1,0,1,1,0
"Jun 23, 2019 5:00 PM",22,6,16,,,,,,,,,,12,8,4,9,,,,9,9,0,8,10,4,2,2,15,2,1,1,1,0,0,0,0
"Jun 23, 2019 6:00 PM",18,5,13,,,,,,,,,,5,2,3,5,,,,16,12,4,4,7,3,2,1,13,0,0,2,1,1,0,0,0
"Jun 23, 2019 7:00 PM",24,13,11,,,,,,,,,,4,2,2,1,,,,7,7,0,1,11,8,4,4,11,0,0,2,2,0,0,0,0
"Jun 23, 2019 8:00 PM",10,3,7,,,,,,,,,,9,5,4,4,,,,6,5,1,7,9,1,0,1,4,1,0,1,0,1,0,0,0
"Jun 23, 2019 9:00 PM",16,4,12,,,,,,,,,,2,2,0,2,,,,3,3,0,4,0,0,0,0,3,0,0,0,0,0,0,0,0
"Jun 23, 2019 10:00 PM",10,5,5,,,,,,,,,,0,0,0,0,,,,2,2,0,1,3,0,0,0,6,0,0,0,0,0,0,0,0
"Jun 23, 2019 11:00 PM",2,0,2,,,,,,,,,,0,0,0,0,,,,1,1,0,1,0,0,0,0,0,0,0,0,0,0,0,0,0
"Jun 24, 2019 12:00 AM",7,1,6,,,,,,,,,,0,0,0,2,,,,3,3,0,1,3,0,0,0,3,0,0,0,0,0,0,0,0
"Jun 24, 2019 1:00 AM",2,0,2,,,,,,,,,,0,0,0,1,,,,3,3,0,0,0,0,0,0,1,0,0,0,0,0,0,0,0
"Jun 24, 2019 2:00 AM",2,0,2,,,,,,,,,,0,0,0,0,,,,3,3,0,0,1,0,0,0,0,0,0,0,0,0,0,0,0
"Jun 24, 2019 3:00 AM",1,1,0,,,,,,,,,,0,0,0,0,,,,0,0,0,0,0,1,0,1,0,1,0,0,0,0,0,0,0
"Jun 24, 2019 4:00 AM",2,0,2,,,,,,,,,,0,0,0,0,,,,0,0,0,1,0,0,0,0,1,0,0,0,0,0,0,0,0
"Jun 24, 2019 5:00 AM",8,5,3,,,,,,,,,,0,0,0,4,,,,0,0,0,7,5,0,0,0,14,1,0,0,0,0,0,0,0
"Jun 24, 2019 6:00 AM",39,27,12,,,,,,,,,,3,1,2,0,,,,3,1,2,21,15,13,4,9,47,0,0,3,2,1,1,0,1
"Jun 24, 2019 7:00 AM",154,123,31,,,,,,,,,,3,2,1,8,,,,39,33,6,103,29,40,30,10,147,2,6,5,4,1,3,1,2
"Jun 24, 2019 8:00 AM",323,256,67,,,,,,,,,,26,3,23,31,,,,18,15,3,222,55,94,71,23,276,5,6,3,2,1,1,0,1
"Jun 24, 2019 9:00 AM",150,133,17,,,,,,,,,,10,3,7,11,,,,24,14,10,84,28,27,18,9,105,4,1,4,4,0,0,0,0
"Jun 24, 2019 10:00 AM",41,34,7,,,,,,,,,,11,5,6,4,,,,12,9,3,19,9,12,6,6,26,1,2,2,1,1,1,0,1
"Jun 24, 2019 11:00 AM",22,12,10,,,,,,,,,,12,6,6,5,,,,10,10,0,20,6,9,5,4,20,3,3,1,1,0,0,0,0
"Jun 24, 2019 12:00 PM",39,21,18,,,,,,,,,,11,4,7,6,,,,11,10,1,11,6,12,4,8,16,3,0,2,0,2,0,0,0
"Jun 24, 2019 1:00 PM",41,17,24,,,,,,,,,,18,9,9,10,,,,16,14,2,17,14,13,4,9,20,3,4,0,0,0,0,0,0
"Jun 24, 2019 2:00 PM",49,22,27,,,,,,,,,,21,14,7,14,,,,14,11,3,7,14,11,2,9,10,2,2,0,0,0,0,0,0
"Jun 24, 2019 3:00 PM",60,25,35,,,,,,,,,,15,10,5,11,,,,26,26,0,8,21,22,5,17,14,4,2,2,1,1,1,1,0
"Jun 24, 2019 4:00 PM",108,35,73,,,,,,,,,,18,9,9,12,,,,56,56,0,24,73,43,8,35,26,2,1,3,2,1,2,2,0
"Jun 24, 2019 5:00 PM",285,54,231,,,,,,,,,,24,11,13,34,,,,133,129,4,43,181,80,15,65,72,9,4,6,1,5,1,1,0
"Jun 24, 2019 6:00 PM",292,49,243,,,,,,,,,,20,13,7,22,,,,160,158,2,39,156,77,11,66,47,5,2,8,7,1,3,2,1
"Jun 24, 2019 7:00 PM",134,39,95,,,,,,,,,,17,12,5,31,,,,79,73,6,25,65,56,10,46,29,7,3,7,4,3,0,0,0
"Jun 24, 2019 8:00 PM",78,23,55,,,,,,,,,,13,9,4,17,,,,35,33,2,10,26,32,10,22,19,1,3,6,1,5,2,1,1
"Jun 24, 2019 9:00 PM",60,14,46,,,,,,,,,,8,2,6,20,,,,26,24,2,6,17,14,5,9,29,1,1,4,1,3,3,3,0
"Jun 24, 2019 10:00 PM",22,5,17,,,,,,,,,,8,5,3,4,,,,10,9,1,5,13,9,3,6,9,0,0,8,5,3,2,1,1
"Jun 24, 2019 11:00 PM",15,7,8,,,,,,,,,,2,1,1,0,,,,8,8,0,2,4,4,2,2,4,0,0,3,1,2,0,0,0
"Jun 25, 2019 12:00 AM",5,1,4,,,,,,,,,,0,0,0,0,,,,2,1,1,0,3,1,0,1,3,0,0,0,0,0,0,0,0
"Jun 25, 2019 1:00 AM",3,0,3,,,,,,,,,,0,0,0,0,,,,2,2,0,0,2,2,1,1,1,0,0,0,0,0,0,0,0
"Jun 25, 2019 2:00 AM",2,1,1,,,,,,,,,,2,2,0,0,,,,1,1,0,0,6,0,0,0,0,0,0,0,0,0,0,0,0
"Jun 25, 2019 3:00 AM",2,0,2,,,,,,,,,,0,0,0,0,,,,0,0,0,0,1,0,0,0,0,0,0,0,0,0,0,0,0
"Jun 25, 2019 4:00 AM",4,0,4,,,,,,,,,,0,0,0,0,,,,0,0,0,1,2,0,0,0,1,2,0,0,0,0,0,0,0
"Jun 25, 2019 5:00 AM",11,8,3,,,,,,,,,,0,0,0,2,,,,0,0,0,6,5,0,0,0,14,2,0,0,0,0,0,0,0
"Jun 25, 2019 6:00 AM",55,41,14,,,,,,,,,,4,0,4,5,,,,9,8,1,37,32,8,3,5,54,1,3,2,1,1,3,0,3
"Jun 25, 2019 7:00 AM",218,165,53,,,,,,,,,,17,8,9,15,,,,43,38,5,144,42,56,39,17,223,3,3,5,4,1,0,0,0
"Jun 25, 2019 8:00 AM",396,312,84,,,,,,,,,,36,8,28,42,,,,33,23,10,259,65,133,100,33,352,4,5,9,7,2,0,0,0
"Jun 25, 2019 9:00 AM",179,153,26,,,,,,,,,,17,3,14,8,,,,34,22,12,102,39,45,35,10,107,7,5,1,1,0,1,0,1
"Jun 25, 2019 10:00 AM",63,45,18,,,,,,,,,,16,12,4,7,,,,21,13,8,35,15,27,11,16,35,3,8,2,2,0,1,0,1
"Jun 25, 2019 11:00 AM",44,30,14,,,,,,,,,,14,6,8,7,,,,7,6,1,24,10,8,2,6,17,0,4,1,1,0,1,0,1
"Jun 25, 2019 12:00 PM",53,31,22,,,,,,,,,,15,5,10,11,,,,14,12,2,30,11,16,10,6,24,5,1,1,0,1,0,0,0
"Jun 25, 2019 1:00 PM",68,30,38,,,,,,,,,,13,6,7,17,,,,23,20,3,13,19,22,6,16,25,1,3,2,1,1,0,0,0
"Jun 25, 2019 2:00 PM",60,30,30,,,,,,,,,,20,11,9,9,,,,20,18,2,14,14,13,4,9,15,6,2,2,2,0,1,0,1
"Jun 25, 2019 3:00 PM",75,30,45,,,,,,,,,,20,10,10,9,,,,30,28,2,15,31,29,12,17,15,3,0,2,1,1,3,2,1
"Jun 25, 2019 4:00 PM",141,30,111,,,,,,,,,,33,28,5,15,,,,61,60,1,27,104,44,12,32,37,2,4,8,4,4,1,1,0
"Jun 25, 2019 5:00 PM",314,55,259,,,,,,,,,,24,15,9,36,,,,167,164,3,48,224,86,17,69,83,6,6,5,2,3,4,2,2
"Jun 25, 2019 6:00 PM",302,63,239,,,,,,,,,,16,12,4,29,,,,178,175,3,39,170,99,14,85,63,10,5,5,1,4,0,0,0
"Jun 25, 2019 7:00 PM",155,41,114,,,,,,,,,,25,16,9,21,,,,62,61,1,23,94,47,9,38,29,6,2,5,3,2,2,0,2
"Jun 25, 2019 8:00 PM",139,47,92,,,,,,,,,,11,10,1,14,,,,46,41,5,17,48,33,9,24,32,4,7,4,2,2,1,1,0
"Jun 25, 2019 9:00 PM",54,20,34,,,,,,,,,,14,9,5,7,,,,27,26,1,12,25,16,4,12,21,2,1,2,1,1,1,1,0
"Jun 25, 2019 10:00 PM",50,16,34,,,,,,,,,,9,7,2,6,,,,25,21,4,7,9,6,3,3,9,0,1,2,1,1,1,1,0
"Jun 25, 2019 11:00 PM",24,2,22,,,,,,,,,,5,1,4,4,,,,7,7,0,3,6,3,1,2,6,1,1,0,0,0,0,0,0
"Jun 26, 2019 12:00 AM",9,2,7,,,,,,,,,,1,0,1,2,,,,4,4,0,3,3,4,1,3,4,0,0,0,0,0,0,0,0
"Jun 26, 2019 1:00 AM",2,1,1,,,,,,,,,,0,0,0,1,,,,5,5,0,2,1,0,0,0,0,0,0,0,0,0,0,0,0
"Jun 26, 2019 2:00 AM",2,0,2,,,,,,,,,,0,0,0,1,,,,2,2,0,1,4,0,0,0,0,0,0,0,0,0,0,0,0
"Jun 26, 2019 3:00 AM",2,0,2,,,,,,,,,,0,0,0,0,,,,1,1,0,0,1,0,0,0,3,1,0,0,0,0,0,0,0
"Jun 26, 2019 4:00 AM",3,1,2,,,,,,,,,,0,0,0,0,,,,1,1,0,1,1,6,0,6,6,1,0,0,0,0,0,0,0
"Jun 26, 2019 5:00 AM",11,6,5,,,,,,,,,,0,0,0,3,,,,0,0,0,5,5,7,6,1,14,1,0,0,0,0,0,0,0
"Jun 26, 2019 6:00 AM",64,46,18,,,,,,,,,,3,0,3,4,,,,6,4,2,33,24,10,8,2,56,1,2,2,0,2,1,0,1
"Jun 26, 2019 7:00 AM",211,160,51,,,,,,,,,,11,5,6,11,,,,35,33,2,150,22,48,35,13,206,3,2,8,4,4,0,0,0
"Jun 26, 2019 8:00 AM",396,324,72,,,,,,,,,,38,12,26,21,,,,44,30,14,217,74,98,71,27,309,6,6,8,5,3,2,0,2
"Jun 26, 2019 9:00 AM",189,159,30,,,,,,,,,,15,5,10,13,,,,18,13,5,100,30,45,29,16,122,5,13,13,6,7,0,0,0
"Jun 26, 2019 10:00 AM",63,42,21,,,,,,,,,,7,5,2,10,,,,13,9,4,31,14,26,13,13,32,6,3,2,1,1,1,1,0
"Jun 26, 2019 11:00 AM",41,29,12,,,,,,,,,,7,3,4,5,,,,14,11,3,23,18,20,4,16,27,6,1,3,1,2,3,3,0
"Jun 26, 2019 12:00 PM",59,25,34,,,,,,,,,,10,7,3,17,,,,11,10,1,23,17,12,6,6,32,1,0,5,3,2,1,1,0
"Jun 26, 2019 1:00 PM",69,35,34,,,,,,,,,,11,9,2,10,,,,20,15,5,17,27,16,6,10,16,3,3,1,1,0,0,0,0
"Jun 26, 2019 2:00 PM",68,31,37,,,,,,,,,,15,7,8,69,,,,17,11,6,11,19,19,6,13,25,5,0,3,0,3,1,0,1
"Jun 26, 2019 3:00 PM",58,21,37,,,,,,,,,,12,7,5,15,,,,32,31,1,12,33,22,7,15,17,3,5,3,2,1,1,1,0
"Jun 26, 2019 4:00 PM",143,42,101,,,,,,,,,,12,7,5,17,,,,52,51,1,28,99,49,10,39,40,3,5,0,0,0,3,3,0
"Jun 26, 2019 5:00 PM",321,59,262,,,,,,,,,,29,16,13,27,,,,155,151,4,37,207,113,24,89,101,10,5,9,6,3,2,1,1
"Jun 26, 2019 6:00 PM",305,67,238,,,,,,,,,,21,17,4,14,,,,168,163,5,35,173,105,19,86,62,8,8,7,2,5,4,4,0
"Jun 26, 2019 7:00 PM",146,41,105,,,,,,,,,,26,12,14,25,,,,74,71,3,24,78,52,15,37,38,4,6,7,6,1,1,1,0
"Jun 26, 2019 8:00 PM",99,22,77,,,,,,,,,,15,7,8,19,,,,38,37,1,19,49,46,19,27,31,4,2,6,3,3,3,3,0
"Jun 26, 2019 9:00 PM",77,24,53,,,,,,,,,,13,8,5,16,,,,32,31,1,15,31,26,9,17,30,2,2,6,3,3,0,0,0
"Jun 26, 2019 10:00 PM",52,17,35,,,,,,,,,,9,4,5,7,,,,20,19,1,10,11,16,8,8,23,1,0,3,2,1,0,0,0
"Jun 26, 2019 11:00 PM",22,3,19,,,,,,,,,,2,1,1,4,,,,14,14,0,7,12,3,2,1,8,0,0,0,0,0,0,0,0
"Jun 27, 2019 12:00 AM",13,2,11,,,,,,,,,,0,0,0,1,,,,2,2,0,1,4,2,0,2,3,0,0,0,0,0,0,0,0
"Jun 27, 2019 1:00 AM",4,1,3,,,,,,,,,,1,1,0,2,,,,2,1,1,1,1,1,1,0,1,0,0,2,1,1,0,0,0
"Jun 27, 2019 2:00 AM",3,1,2,,,,,,,,,,2,2,0,0,,,,3,3,0,1,0,0,0,0,1,0,0,0,0,0,0,0,0
"Jun 27, 2019 3:00 AM",0,0,0,,,,,,,,,,0,0,0,0,,,,1,1,0,1,1,1,0,1,3,1,0,0,0,0,0,0,0
"Jun 27, 2019 4:00 AM",2,1,1,,,,,,,,,,0,0,0,0,,,,1,1,0,1,1,0,0,0,0,0,0,0,0,0,0,0,0
"Jun 27, 2019 5:00 AM",11,9,2,,,,,,,,,,0,0,0,1,,,,0,0,0,8,1,2,0,2,17,3,0,0,0,0,0,0,0
"Jun 27, 2019 6:00 AM",54,37,17,,,,,,,,,,5,2,3,6,,,,5,2,3,26,20,14,9,5,37,1,2,3,1,2,1,0,1
"Jun 27, 2019 7:00 AM",176,135,41,,,,,,,,,,13,4,9,12,,,,35,32,3,120,38,42,30,12,180,4,3,5,3,2,0,0,0
"Jun 27, 2019 8:00 AM",335,278,57,,,,,,,,,,31,12,19,34,,,,35,27,8,230,66,104,73,31,312,9,7,10,7,3,2,1,1
"Jun 27, 2019 9:00 AM",182,150,32,,,,,,,,,,16,7,9,11,,,,35,20,15,105,29,51,30,21,107,3,3,3,0,3,1,0,1
"Jun 27, 2019 10:00 AM",69,47,22,,,,,,,,,,11,5,6,11,,,,10,7,3,30,13,13,4,9,36,2,8,2,1,1,0,0,0
"Jun 27, 2019 11:00 AM",40,26,14,,,,,,,,,,12,6,6,10,,,,14,12,2,28,26,23,11,12,23,4,1,5,1,4,0,0,0
"Jun 27, 2019 12:00 PM",54,27,27,,,,,,,,,,10,3,7,21,,,,22,19,3,34,14,21,9,12,33,6,5,4,2,2,2,1,1
"Jun 27, 2019 1:00 PM",70,28,42,,,,,,,,,,20,13,7,9,,,,23,22,1,22,28,24,7,17,30,1,1,0,0,0,0,0,0
"Jun 27, 2019 2:00 PM",58,30,28,,,,,,,,,,10,5,5,20,,,,25,24,1,16,27,41,19,22,33,3,4,3,3,0,1,1,0
"Jun 27, 2019 3:00 PM",63,23,40,,,,,,,,,,29,15,14,17,,,,35,32,3,14,42,36,11,25,19,6,8,4,3,1,0,0,0
"Jun 27, 2019 4:00 PM",138,37,101,,,,,,,,,,27,17,10,16,,,,56,54,2,31,93,71,28,43,44,12,3,4,3,1,0,0,0
"Jun 27, 2019 5:00 PM",279,57,222,,,,,,,,,,26,16,10,24,,,,160,155,5,44,191,120,25,95,72,9,8,7,4,3,3,3,0
"Jun 27, 2019 6:00 PM",275,64,211,,,,,,,,,,30,20,10,28,,,,151,149,2,32,174,105,28,77,61,12,5,5,4,1,2,1,1
"Jun 27, 2019 7:00 PM",140,45,95,,,,,,,,,,29,18,11,22,,,,64,62,2,18,67,52,11,41,41,5,2,4,1,3,1,1,0
"Jun 27, 2019 8:00 PM",102,22,80,,,,,,,,,,15,8,7,19,,,,33,29,4,21,40,42,21,21,27,4,2,4,2,2,1,1,0
"Jun 27, 2019 9:00 PM",67,13,54,,,,,,,,,,22,10,12,12,,,,42,37,5,10,24,34,14,20,36,2,0,7,2,5,3,3,0
"Jun 27, 2019 10:00 PM",46,9,37,,,,,,,,,,6,5,1,2,,,,25,24,1,13,23,9,4,5,16,4,0,2,1,1,0,0,0
"Jun 27, 2019 11:00 PM",26,3,23,,,,,,,,,,4,3,1,3,,,,8,8,0,1,6,4,1,3,8,2,2,0,0,0,0,0,0
"Jun 28, 2019 12:00 AM",16,3,13,,,,,,,,,,2,0,2,4,,,,10,10,0,3,12,2,0,2,5,0,0,1,0,1,1,1,0
"Jun 28, 2019 1:00 AM",4,1,3,,,,,,,,,,1,1,0,2,,,,6,5,1,1,0,3,1,2,1,1,0,0,0,0,0,0,0
"Jun 28, 2019 2:00 AM",0,0,0,,,,,,,,,,0,0,0,0,,,,3,2,1,0,3,1,1,0,1,0,0,0,0,0,0,0,0
"Jun 28, 2019 3:00 AM",1,0,1,,,,,,,,,,1,1,0,0,,,,0,0,0,1,0,1,0,1,0,0,0,0,0,0,0,0,0
"Jun 28, 2019 4:00 AM",3,0,3,,,,,,,,,,0,0,0,0,,,,0,0,0,1,1,0,0,0,0,0,1,0,0,0,0,0,0
"Jun 28, 2019 5:00 AM",14,11,3,,,,,,,,,,2,1,1,2,,,,0,0,0,11,3,1,0,1,6,2,0,0,0,0,0,0,0
"Jun 28, 2019 6:00 AM",42,30,12,,,,,,,,,,2,1,1,3,,,,8,5,3,26,16,10,7,3,46,1,0,3,2,1,2,0,2
"Jun 28, 2019 7:00 AM",157,121,36,,,,,,,,,,5,2,3,18,,,,29,24,5,95,34,46,27,19,138,4,2,3,1,2,1,0,1
"Jun 28, 2019 8:00 AM",311,249,62,,,,,,,,,,18,4,14,14,,,,27,18,9,179,73,66,48,18,214,2,7,3,2,1,1,0,1
"Jun 28, 2019 9:00 AM",158,125,33,,,,,,,,,,15,3,12,7,,,,21,15,6,92,26,44,27,17,89,5,9,4,3,1,4,0,4
"Jun 28, 2019 10:00 AM",59,40,19,,,,,,,,,,11,3,8,9,,,,17,11,6,31,21,18,11,7,37,1,1,2,0,2,3,2,1
"Jun 28, 2019 11:00 AM",44,27,17,,,,,,,,,,17,11,6,6,,,,13,12,1,20,29,22,7,15,27,3,5,2,0,2,0,0,0
"Jun 28, 2019 12:00 PM",56,29,27,,,,,,,,,,17,9,8,13,,,,18,17,1,21,23,21,7,14,35,6,0,3,1,2,1,0,1
"Jun 28, 2019 1:00 PM",66,25,41,,,,,,,,,,9,6,3,11,,,,16,13,3,14,32,21,8,13,35,6,3,0,0,0,0,0,0
"Jun 28, 2019 2:00 PM",81,35,46,,,,,,,,,,11,4,7,10,,,,20,15,5,19,24,29,10,19,24,4,2,2,2,0,1,1,0
"Jun 28, 2019 3:00 PM",98,31,67,,,,,,,,,,30,21,9,21,,,,36,35,1,25,46,46,13,33,27,3,3,4,2,2,1,0,1
"Jun 28, 2019 4:00 PM",153,42,111,,,,,,,,,,26,15,11,16,,,,53,53,0,19,95,49,17,32,57,4,4,5,4,1,1,1,0
"Jun 28, 2019 5:00 PM",260,66,194,,,,,,,,,,24,18,6,23,,,,134,131,3,32,131,104,20,84,79,8,2,3,2,1,3,2,1
"Jun 28, 2019 6:00 PM",179,47,132,,,,,,,,,,16,10,6,22,,,,86,83,3,29,107,75,17,58,41,0,5,7,3,4,1,1,0
"Jun 28, 2019 7:00 PM",84,27,57,,,,,,,,,,16,10,6,17,,,,45,41,4,14,50,38,12,26,25,8,4,1,0,1,5,5,0
"Jun 28, 2019 8:00 PM",64,24,40,,,,,,,,,,16,9,7,8,,,,31,30,1,12,36,24,9,15,21,1,0,2,2,0,1,1,0
"Jun 28, 2019 9:00 PM",38,12,26,,,,,,,,,,5,1,4,7,,,,13,13,0,14,15,12,5,7,18,2,0,0,0,0,0,0,0
"Jun 28, 2019 10:00 PM",23,9,14,,,,,,,,,,3,2,1,7,,,,12,11,1,3,11,4,1,3,18,1,0,3,2,1,1,1,0
"Jun 28, 2019 11:00 PM",20,4,16,,,,,,,,,,1,1,0,4,,,,17,16,1,2,9,4,0,4,11,1,0,0,0,0,0,0,0
"Jun 29, 2019 12:00 AM",18,5,13,,,,,,,,,,2,0,2,3,,,,5,5,0,3,11,4,2,2,11,1,0,0,0,0,0,0,0
"Jun 29, 2019 1:00 AM",17,1,16,,,,,,,,,,2,2,0,1,,,,5,5,0,4,5,2,1,1,6,0,0,0,0,0,0,0,0
"Jun 29, 2019 2:00 AM",4,0,4,,,,,,,,,,3,2,1,1,,,,2,2,0,0,5,0,0,0,2,2,0,0,0,0,0,0,0
"Jun 29, 2019 3:00 AM",2,0,2,,,,,,,,,,0,0,0,0,,,,0,0,0,5,2,0,0,0,1,0,2,0,0,0,0,0,0
"Jun 29, 2019 4:00 AM",4,1,3,,,,,,,,,,0,0,0,0,,,,0,0,0,1,0,0,0,0,1,0,0,0,0,0,0,0,0
"Jun 29, 2019 5:00 AM",5,2,3,,,,,,,,,,0,0,0,1,,,,2,1,1,2,1,0,0,0,2,0,0,0,0,0,0,0,0
"Jun 29, 2019 6:00 AM",6,3,3,,,,,,,,,,2,2,0,1,,,,4,4,0,3,6,1,0,1,12,1,0,2,1,1,0,0,0
"Jun 29, 2019 7:00 AM",13,6,7,,,,,,,,,,3,1,2,2,,,,4,3,1,9,15,3,0,3,15,0,2,1,0,1,0,0,0
"Jun 29, 2019 8:00 AM",34,18,16,,,,,,,,,,5,4,1,3,,,,5,4,1,12,21,7,2,5,41,2,1,0,0,0,0,0,0
"Jun 29, 2019 9:00 AM",26,14,12,,,,,,,,,,15,5,10,10,,,,17,13,4,18,15,13,4,9,33,5,3,4,3,1,0,0,0
"Jun 29, 2019 10:00 AM",36,24,12,,,,,,,,,,20,8,12,8,,,,12,7,5,23,38,35,10,25,26,3,5,3,1,2,0,0,0
"Jun 29, 2019 11:00 AM",49,24,25,,,,,,,,,,21,8,13,20,,,,22,15,7,20,38,42,14,28,34,4,5,3,1,2,0,0,0
"Jun 29, 2019 12:00 PM",52,25,27,,,,,,,,,,38,24,14,18,,,,19,19,0,17,28,40,20,20,25,8,6,3,2,1,2,1,1
"Jun 29, 2019 1:00 PM",57,32,25,,,,,,,,,,25,15,10,10,,,,20,16,4,20,28,41,17,24,29,3,4,6,4,2,0,0,0
"Jun 29, 2019 2:00 PM",46,30,16,,,,,,,,,,29,18,11,11,,,,23,14,9,19,21,42,18,24,30,4,0,5,3,2,12,4,8
"Jun 29, 2019 3:00 PM",56,29,27,,,,,,,,,,27,15,12,35,,,,17,15,2,12,28,37,13,24,23,8,3,2,2,0,4,2,2
"Jun 29, 2019 4:00 PM",43,20,23,,,,,,,,,,24,17,7,19,,,,19,16,3,11,15,46,17,29,35,3,3,5,4,1,0,0,0
"Jun 29, 2019 5:00 PM",49,21,28,,,,,,,,,,19,15,4,24,,,,11,11,0,23,22,25,9,16,26,4,8,2,1,1,0,0,0
"Jun 29, 2019 6:00 PM",45,20,25,,,,,,,,,,25,18,7,30,,,,13,11,2,13,14,28,14,14,24,4,2,5,1,4,1,1,0
"Jun 29, 2019 7:00 PM",43,16,27,,,,,,,,,,17,11,6,15,,,,17,16,1,9,19,19,8,11,31,4,6,4,2,2,0,0,0
"Jun 29, 2019 8:00 PM",22,8,14,,,,,,,,,,7,5,2,17,,,,10,8,2,12,17,15,11,4,16,0,1,1,1,0,0,0,0
"Jun 29, 2019 9:00 PM",23,9,14,,,,,,,,,,10,8,2,17,,,,5,4,1,2,3,18,12,6,15,0,0,1,1,0,1,0,1
"Jun 29, 2019 10:00 PM",18,6,12,,,,,,,,,,3,1,2,4,,,,10,10,0,6,4,12,6,6,15,3,0,1,1,0,0,0,0
"Jun 29, 2019 11:00 PM",13,6,7,,,,,,,,,,0,0,0,3,,,,6,4,2,6,8,3,2,1,5,3,0,1,0,1,0,0,0
"Jun 30, 2019 12:00 AM",12,2,10,,,,,,,,,,3,2,1,1,,,,3,3,0,4,4,0,0,0,3,0,1,0,0,0,0,0,0
"Jun 30, 2019 1:00 AM",13,5,8,,,,,,,,,,1,1,0,5,,,,6,6,0,1,4,2,1,1,4,0,0,1,1,0,0,0,0
"Jun 30, 2019 2:00 AM",2,0,2,,,,,,,,,,0,0,0,1,,,,1,1,0,1,2,4,1,3,2,0,2,0,0,0,0,0,0
"Jun 30, 2019 3:00 AM",3,0,3,,,,,,,,,,0,0,0,0,,,,2,2,0,0,1,4,2,2,2,0,0,0,0,0,0,0,0
"Jun 30, 2019 4:00 AM",8,1,7,,,,,,,,,,0,0,0,0,,,,1,1,0,0,1,0,0,0,2,0,0,1,0,1,0,0,0
"Jun 30, 2019 5:00 AM",4,1,3,,,,,,,,,,2,2,0,1,,,,0,0,0,0,1,0,0,0,3,0,0,0,0,0,0,0,0
"Jun 30, 2019 6:00 AM",8,4,4,,,,,,,,,,0,0,0,0,,,,4,4,0,2,5,3,3,0,5,1,0,0,0,0,1,0,1
"Jun 30, 2019 7:00 AM",14,9,5,,,,,,,,,,2,2,0,2,,,,8,6,2,6,12,5,1,4,14,0,3,1,1,0,0,0,0
"Jun 30, 2019 8:00 AM",18,7,11,,,,,,,,,,3,1,2,8,,,,8,7,1,4,18,12,7,5,12,1,11,2,0,2,0,0,0
"Jun 30, 2019 9:00 AM",35,22,13,,,,,,,,,,9,6,3,12,,,,10,6,4,16,19,23,9,14,33,4,18,2,2,0,0,0,0
"Jun 30, 2019 10:00 AM",34,19,15,,,,,,,,,,20,4,16,21,,,,14,12,2,21,30,48,10,38,27,1,8,6,2,4,0,0,0
"Jun 30, 2019 11:00 AM",37,19,18,,,,,,,,,,36,15,21,14,,,,16,14,2,24,37,58,18,40,23,2,8,2,1,1,2,0,2
"Jun 30, 2019 12:00 PM",58,25,33,,,,,,,,,,38,16,22,11,,,,19,17,2,31,28,26,10,16,39,7,6,4,3,1,0,0,0
"Jun 30, 2019 1:00 PM",57,35,22,,,,,,,,,,30,11,19,10,,,,8,7,1,22,43,42,20,22,35,8,3,7,2,5,2,2,0
"Jun 30, 2019 2:00 PM",47,25,22,,,,,,,,,,35,26,9,3,,,,9,7,2,13,20,37,14,23,27,7,3,2,0,2,0,0,0
"Jun 30, 2019 3:00 PM",40,16,24,,,,,,,,,,24,16,8,10,,,,15,14,1,17,25,42,17,25,30,3,7,4,2,2,0,0,0
"Jun 30, 2019 4:00 PM",30,16,14,,,,,,,,,,43,24,19,7,,,,15,11,4,11,19,28,9,19,21,1,2,9,2,7,1,1,0
"Jun 30, 2019 5:00 PM",42,10,32,,,,,,,,,,37,27,10,12,,,,11,9,2,22,16,31,21,10,25,6,3,3,0,3,0,0,0
"Jun 30, 2019 6:00 PM",42,18,24,,,,,,,,,,30,21,9,12,,,,19,18,1,12,15,24,11,13,14,5,1,7,4,3,0,0,0
"Jun 30, 2019 7:00 PM",38,13,25,,,,,,,,,,18,15,3,9,,,,10,10,0,8,16,31,9,22,26,2,3,4,3,1,1,1,0
"Jun 30, 2019 8:00 PM",31,14,17,,,,,,,,,,8,5,3,8,,,,6,6,0,11,15,29,13,16,13,0,2,1,1,0,0,0,0
"Jun 30, 2019 9:00 PM",13,0,13,,,,,,,,,,10,7,3,4,,,,8,8,0,7,5,16,15,1,9,1,0,1,0,1,0,0,0
"Jun 30, 2019 10:00 PM",22,6,16,,,,,,,,,,2,2,0,1,,,,10,10,0,5,11,3,1,2,16,0,0,0,0,0,0,0,0
"Jun 30, 2019 11:00 PM",11,6,5,,,,,,,,,,1,1,0,2,,,,1,0,1,0,4,5,1,4,4,0,0,1,1,0,0,0,0
"Jul 1, 2019 12:00 AM",8,3,5,,,,,,,,,,0,0,0,1,,,,6,6,0,0,3,0,0,0,1,0,0,1,0,1,0,0,0
"Jul 1, 2019 1:00 AM",2,1,1,,,,,,,,,,0,0,0,0,,,,1,1,0,0,0,3,3,0,2,0,0,0,0,0,0,0,0
"Jul 1, 2019 2:00 AM",1,0,1,,,,,,,,,,0,0,0,0,,,,1,1,0,1,1,2,0,2,0,0,0,0,0,0,0,0,0
"Jul 1, 2019 3:00 AM",1,0,1,,,,,,,,,,0,0,0,0,,,,0,0,0,1,0,1,0,1,0,1,0,0,0,0,0,0,0
"Jul 1, 2019 4:00 AM",2,1,1,,,,,,,,,,0,0,0,0,,,,0,0,0,2,0,0,0,0,0,0,0,0,0,0,0,0,0
"Jul 1, 2019 5:00 AM",10,7,3,,,,,,,,,,0,0,0,1,,,,1,1,0,7,2,0,0,0,13,1,0,0,0,0,0,0,0
"Jul 1, 2019 6:00 AM",49,37,12,,,,,,,,,,3,2,1,6,,,,7,5,2,25,11,6,4,2,51,1,1,4,3,1,1,0,1
"Jul 1, 2019 7:00 AM",165,134,31,,,,,,,,,,11,4,7,14,,,,29,24,5,128,32,40,22,18,165,2,6,8,4,4,0,0,0
"Jul 1, 2019 8:00 AM",395,311,84,,,,,,,,,,23,8,15,22,,,,40,29,11,219,69,76,53,23,300,3,13,6,4,2,1,0,1
"Jul 1, 2019 9:00 AM",172,149,23,,,,,,,,,,28,7,21,10,,,,24,14,10,88,27,36,23,13,109,6,2,5,4,1,0,0,0
"Jul 1, 2019 10:00 AM",45,34,11,,,,,,,,,,20,7,13,4,,,,9,9,0,29,10,18,10,8,39,0,3,4,2,2,1,0,1
"Jul 1, 2019 11:00 AM",45,29,16,,,,,,,,,,12,5,7,7,,,,8,6,2,22,11,18,4,14,30,3,1,4,2,2,1,1,0
"Jul 1, 2019 12:00 PM",40,13,27,,,,,,,,,,13,6,7,9,,,,8,6,2,21,11,9,5,4,24,2,1,2,2,0,2,1,1
"Jul 1, 2019 1:00 PM",49,28,21,,,,,,,,,,18,14,4,33,,,,17,16,1,16,20,15,6,9,21,4,6,2,2,0,0,0,0
"Jul 1, 2019 2:00 PM",40,22,18,,,,,,,,,,11,6,5,17,,,,13,13,0,14,16,31,12,19,22,2,5,3,2,1,0,0,0
"Jul 1, 2019 3:00 PM",76,25,51,,,,,,,,,,16,11,5,17,,,,25,22,3,9,22,15,5,10,16,5,4,6,4,2,0,0,0
"Jul 1, 2019 4:00 PM",121,30,91,,,,,,,,,,23,14,9,19,,,,61,60,1,27,84,33,8,25,34,4,1,4,3,1,4,3,1
"Jul 1, 2019 5:00 PM",273,46,227,,,,,,,,,,30,23,7,15,,,,148,143,5,43,198,69,8,61,70,13,7,6,3,3,2,1,1
"Jul 1, 2019 6:00 PM",304,65,239,,,,,,,,,,56,43,13,20,,,,166,163,3,38,167,103,15,88,57,11,4,13,6,7,0,0,0
"Jul 1, 2019 7:00 PM",137,35,102,,,,,,,,,,28,20,8,26,,,,65,64,1,27,77,41,4,37,26,4,3,2,1,1,2,1,1
"Jul 1, 2019 8:00 PM",85,24,61,,,,,,,,,,17,11,6,10,,,,39,35,4,16,36,24,8,16,22,4,0,2,1,1,1,1,0
"Jul 1, 2019 9:00 PM",63,12,51,,,,,,,,,,10,7,3,8,,,,22,20,2,11,17,21,7,14,28,4,1,1,1,0,1,1,0
"Jul 1, 2019 10:00 PM",33,8,25,,,,,,,,,,6,6,0,5,,,,17,17,0,8,14,16,8,8,11,0,0,0,0,0,1,1,0
"Jul 1, 2019 11:00 PM",23,6,17,,,,,,,,,,0,0,0,4,,,,4,4,0,1,7,4,4,0,6,0,1,0,0,0,0,0,0
"Jul 2, 2019 12:00 AM",3,0,3,,,,,,,,,,0,0,0,0,,,,6,6,0,1,3,1,0,1,6,0,0,0,0,0,0,0,0
"Jul 2, 2019 1:00 AM",5,1,4,,,,,,,,,,1,1,0,0,,,,1,1,0,0,1,1,0,1,0,0,0,0,0,0,0,0,0
"Jul 2, 2019 2:00 AM",3,1,2,,,,,,,,,,1,0,1,0,,,,1,1,0,2,3,0,0,0,1,0,0,0,0,0,0,0,0
"Jul 2, 2019 3:00 AM",1,1,0,,,,,,,,,,0,0,0,0,,,,1,1,0,0,0,1,0,1,0,0,0,0,0,0,0,0,0
"Jul 2, 2019 4:00 AM",4,1,3,,,,,,,,,,0,0,0,0,,,,1,1,0,1,0,0,0,0,0,0,0,0,0,0,0,0,0
"Jul 2, 2019 5:00 AM",14,10,4,,,,,,,,,,0,0,0,3,,,,1,1,0,10,4,2,1,1,12,1,0,0,0,0,0,0,0
"Jul 2, 2019 6:00 AM",59,42,17,,,,,,,,,,3,1,2,6,,,,5,4,1,31,20,9,8,1,58,3,1,2,1,1,1,0,1
"Jul 2, 2019 7:00 AM",210,159,51,,,,,,,,,,9,3,6,11,,,,40,32,8,131,43,54,33,21,212,2,4,4,3,1,0,0,0
"Jul 2, 2019 8:00 AM",422,333,89,,,,,,,,,,27,4,23,20,,,,36,24,12,252,79,98,67,31,305,7,12,7,4,3,1,1,0
"Jul 2, 2019 9:00 AM",213,175,38,,,,,,,,,,33,6,27,13,,,,28,19,9,97,36,50,34,16,117,8,3,5,3,2,1,0,1
"Jul 2, 2019 10:00 AM",56,45,11,,,,,,,,,,13,7,6,10,,,,13,9,4,31,15,15,12,3,48,1,5,12,4,8,4,4,0
"Jul 2, 2019 11:00 AM",33,20,13,,,,,,,,,,22,9,13,5,,,,16,11,5,22,28,24,8,16,20,0,5,2,0,2,0,0,0
"Jul 2, 2019 12:00 PM",42,16,26,,,,,,,,,,21,12,9,11,,,,11,6,5,24,14,17,8,9,26,4,2,2,2,0,3,0,3
"Jul 2, 2019 1:00 PM",60,27,33,,,,,,,,,,33,20,13,12,,,,22,20,2,18,18,25,11,14,29,5,6,4,3,1,0,0,0
"Jul 2, 2019 2:00 PM",53,33,20,,,,,,,,,,10,6,4,13,,,,29,26,3,11,15,25,6,19,17,4,1,3,2,1,3,2,1
"Jul 2, 2019 3:00 PM",63,22,41,,,,,,,,,,20,17,3,9,,,,18,18,0,18,32,28,9,19,16,3,7,8,4,4,0,0,0
"Jul 2, 2019 4:00 PM",156,39,117,,,,,,,,,,20,12,8,30,,,,54,53,1,38,80,37,14,23,35,5,1,3,0,3,0,0,0
"Jul 2, 2019 5:00 PM",321,67,254,,,,,,,,,,25,18,7,27,,,,169,166,3,37,204,115,22,93,67,13,3,14,11,3,2,1,1
"Jul 2, 2019 6:00 PM",338,79,259,,,,,,,,,,22,9,13,37,,,,187,183,4,51,180,100,12,88,79,8,6,9,7,2,3,2,1
"Jul 2, 2019 7:00 PM",174,41,133,,,,,,,,,,27,16,11,31,,,,75,74,1,21,88,62,4,58,48,6,7,8,2,6,0,0,0
"Jul 2, 2019 8:00 PM",124,30,94,,,,,,,,,,19,11,8,18,,,,39,34,5,14,49,23,5,18,39,3,1,7,3,4,1,1,0
"Jul 2, 2019 9:00 PM",66,17,49,,,,,,,,,,11,6,5,15,,,,38,36,2,11,25,19,11,8,36,3,2,2,1,1,0,0,0
"Jul 2, 2019 10:00 PM",38,10,28,,,,,,,,,,9,8,1,6,,,,16,16,0,4,18,17,11,6,14,0,2,1,1,0,0,0,0
"Jul 2, 2019 11:00 PM",25,4,21,,,,,,,,,,4,3,1,3,,,,10,10,0,1,2,7,3,4,7,2,0,1,1,0,1,1,0
"Jul 3, 2019 12:00 AM",4,2,2,,,,,,,,,,1,1,0,6,,,,4,3,1,2,6,5,5,0,4,0,0,0,0,0,0,0,0
"Jul 3, 2019 1:00 AM",1,0,1,,,,,,,,,,2,1,1,2,,,,5,5,0,0,4,0,0,0,1,0,1,0,0,0,0,0,0
"Jul 3, 2019 2:00 AM",4,0,4,,,,,,,,,,2,2,0,0,,,,0,0,0,0,4,0,0,0,1,0,0,0,0,0,0,0,0
"Jul 3, 2019 3:00 AM",3,1,2,,,,,,,,,,2,0,2,0,,,,0,0,0,0,1,1,0,1,0,1,0,0,0,0,0,0,0
"Jul 3, 2019 4:00 AM",2,2,0,,,,,,,,,,0,0,0,0,,,,2,2,0,1,0,0,0,0,0,2,0,0,0,0,0,0,0
"Jul 3, 2019 5:00 AM",10,7,3,,,,,,,,,,3,1,2,6,,,,2,1,1,11,5,0,0,0,12,1,0,0,0,0,0,0,0
"Jul 3, 2019 6:00 AM",64,47,17,,,,,,,,,,5,0,5,6,,,,4,4,0,43,21,17,14,3,56,0,3,3,2,1,2,1,1
"Jul 3, 2019 7:00 AM",198,150,48,,,,,,,,,,7,1,6,21,,,,24,22,2,142,29,42,31,11,204,3,12,4,4,0,1,0,1
"Jul 3, 2019 8:00 AM",381,309,72,,,,,,,,,,15,2,13,25,,,,37,26,11,210,79,89,60,29,308,3,10,5,2,3,1,0,1
"Jul 3, 2019 9:00 AM",201,166,35,,,,,,,,,,23,8,15,5,,,,21,12,9,102,38,52,34,18,97,5,6,5,4,1,2,1,1
"Jul 3, 2019 10:00 AM",67,45,22,,,,,,,,,,18,6,12,9,,,,13,12,1,33,16,24,8,16,36,1,2,4,4,0,1,0,1
"Jul 3, 2019 11:00 AM",57,38,19,,,,,,,,,,18,10,8,12,,,,8,7,1,29,25,29,11,18,31,3,2,2,2,0,0,0,0
"Jul 3, 2019 12:00 PM",61,28,33,,,,,,,,,,23,8,15,13,,,,19,17,2,36,31,35,15,20,29,2,1,1,1,0,1,0,1
"Jul 3, 2019 1:00 PM",73,31,42,,,,,,,,,,15,12,3,13,,,,17,13,4,20,27,34,18,16,27,6,2,2,1,1,0,0,0
"Jul 3, 2019 2:00 PM",65,31,34,,,,,,,,,,16,5,11,15,,,,31,28,3,11,33,28,5,23,26,4,4,3,3,0,1,1,0
"Jul 3, 2019 3:00 PM",60,15,45,,,,,,,,,,19,13,6,16,,,,29,28,1,18,39,34,5,29,24,8,6,5,4,1,3,1,2
"Jul 3, 2019 4:00 PM",134,28,106,,,,,,,,,,13,10,3,20,,,,49,48,1,30,90,57,17,40,46,2,0,3,3,0,1,0,1
"Jul 3, 2019 5:00 PM",307,67,240,,,,,,,,,,31,20,11,26,,,,158,155,3,47,213,101,24,77,91,10,5,7,6,1,4,4,0
"Jul 3, 2019 6:00 PM",293,63,230,,,,,,,,,,28,16,12,30,,,,160,158,2,54,184,105,18,87,90,12,8,3,2,1,0,0,0
"Jul 3, 2019 7:00 PM",174,54,120,,,,,,,,,,21,12,9,33,,,,86,84,2,30,91,67,11,56,47,5,8,7,2,5,1,1,0
"Jul 3, 2019 8:00 PM",121,41,80,,,,,,,,,,33,16,17,13,,,,31,30,1,17,40,49,22,27,32,5,3,4,1,3,2,2,0
"Jul 3, 2019 9:00 PM",69,19,50,,,,,,,,,,13,7,6,6,,,,34,33,1,13,40,28,13,15,42,1,0,5,1,4,0,0,0
"Jul 3, 2019 10:00 PM",50,8,42,,,,,,,,,,7,7,0,7,,,,11,10,1,13,13,16,9,7,22,1,2,1,0,1,1,1,0
"Jul 3, 2019 11:00 PM",15,0,15,,,,,,,,,,4,3,1,3,,,,14,14,0,4,9,4,1,3,13,0,0,1,1,0,0,0,0
"Jul 4, 2019 12:00 AM",8,1,7,,,,,,,,,,1,1,0,0,,,,6,6,0,1,6,1,0,1,5,0,0,0,0,0,0,0,0
"Jul 4, 2019 1:00 AM",7,1,6,,,,,,,,,,0,0,0,1,,,,5,4,1,1,3,1,0,1,2,0,1,0,0,0,0,0,0
"Jul 4, 2019 2:00 AM",5,1,4,,,,,,,,,,1,1,0,0,,,,2,2,0,0,2,0,0,0,0,0,0,0,0,0,0,0,0
"Jul 4, 2019 3:00 AM",3,1,2,,,,,,,,,,0,0,0,0,,,,0,0,0,0,0,0,0,0,0,2,0,0,0,0,0,0,0
"Jul 4, 2019 4:00 AM",2,0,2,,,,,,,,,,0,0,0,0,,,,3,2,1,1,1,1,0,1,1,1,0,0,0,0,0,0,0
"Jul 4, 2019 5:00 AM",10,8,2,,,,,,,,,,1,1,0,2,,,,2,2,0,11,4,1,1,0,16,1,0,0,0,0,0,0,0
"Jul 4, 2019 6:00 AM",58,44,14,,,,,,,,,,4,1,3,5,,,,4,3,1,32,17,11,7,4,48,3,3,5,4,1,1,0,1
"Jul 4, 2019 7:00 AM",165,127,38,,,,,,,,,,11,3,8,19,,,,33,29,4,121,44,53,41,12,197,1,7,3,2,1,2,0,2
"Jul 4, 2019 8:00 AM",346,263,83,,,,,,,,,,19,3,16,19,,,,36,28,8,220,68,97,65,32,261,4,13,5,1,4,0,0,0
"Jul 4, 2019 9:00 AM",210,172,38,,,,,,,,,,21,9,12,17,,,,23,16,7,90,40,55,31,24,104,1,5,3,2,1,0,0,0
"Jul 4, 2019 10:00 AM",55,39,16,,,,,,,,,,15,3,12,18,,,,15,9,6,38,15,22,12,10,38,2,7,1,0,1,0,0,0
"Jul 4, 2019 11:00 AM",43,25,18,,,,,,,,,,14,8,6,18,,,,11,11,0,24,29,13,4,9,23,3,4,2,0,2,1,1,0
"Jul 4, 2019 12:00 PM",51,24,27,,,,,,,,,,14,8,6,8,,,,16,13,3,22,20,39,15,24,46,4,2,4,3,1,1,0,1
"Jul 4, 2019 1:00 PM",58,29,29,,,,,,,,,,23,17,6,10,,,,20,19,1,19,30,24,11,13,24,4,4,2,1,1,0,0,0
"Jul 4, 2019 2:00 PM",55,23,32,,,,,,,,,,24,14,10,11,,,,21,17,4,13,32,33,15,18,23,4,5,3,3,0,0,0,0
"Jul 4, 2019 3:00 PM",85,27,58,,,,,,,,,,16,9,7,19,,,,33,32,1,10,29,26,9,17,15,1,3,7,5,2,1,1,0
"Jul 4, 2019 4:00 PM",127,34,93,,,,,,,,,,22,11,11,14,,,,59,57,2,29,95,63,20,43,39,7,4,7,7,0,0,0,0
"Jul 4, 2019 5:00 PM",288,61,227,,,,,,,,,,31,22,9,18,,,,145,140,5,35,205,120,37,83,91,11,5,3,1,2,0,0,0
"Jul 4, 2019 6:00 PM",274,65,209,,,,,,,,,,36,21,15,38,,,,150,149,1,43,151,91,16,75,64,11,12,5,4,1,0,0,0
"Jul 4, 2019 7:00 PM",122,31,91,,,,,,,,,,29,19,10,16,,,,73,73,0,31,76,51,8,43,53,3,6,3,2,1,0,0,0
"Jul 4, 2019 8:00 PM",112,36,76,,,,,,,,,,20,11,9,35,,,,45,44,1,16,36,41,20,21,26,4,1,5,4,1,3,3,0
"Jul 4, 2019 9:00 PM",74,19,55,,,,,,,,,,14,10,4,9,,,,24,22,2,12,13,28,11,17,33,0,0,2,0,2,1,1,0
"Jul 4, 2019 10:00 PM",41,13,28,,,,,,,,,,8,7,1,6,,,,18,17,1,8,12,14,7,7,19,2,0,1,1,0,0,0,0
"Jul 4, 2019 11:00 PM",29,7,22,,,,,,,,,,5,2,3,5,,,,11,11,0,5,12,6,2,4,15,2,3,0,0,0,1,1,0
"Jul 5, 2019 12:00 AM",15,3,12,,,,,,,,,,1,0,1,2,,,,5,5,0,3,5,7,5,2,5,0,1,0,0,0,0,0,0
"Jul 5, 2019 1:00 AM",2,0,2,,,,,,,,,,1,1,0,0,,,,0,0,0,0,4,0,0,0,3,0,0,0,0,0,0,0,0
"Jul 5, 2019 2:00 AM",4,1,3,,,,,,,,,,0,0,0,0,,,,6,6,0,0,3,0,0,0,0,0,0,0,0,0,0,0,0
"Jul 5, 2019 3:00 AM",3,0,3,,,,,,,,,,0,0,0,0,,,,2,2,0,0,2,1,0,1,0,1,2,0,0,0,0,0,0
"Jul 5, 2019 4:00 AM",4,1,3,,,,,,,,,,0,0,0,0,,,,1,1,0,1,1,0,0,0,0,1,0,0,0,0,0,0,0
"Jul 5, 2019 5:00 AM",6,3,3,,,,,,,,,,1,0,1,1,,,,2,2,0,7,1,1,1,0,11,1,0,0,0,0,0,0,0
"Jul 5, 2019 6:00 AM",50,35,15,,,,,,,,,,2,1,1,4,,,,5,5,0,31,20,7,6,1,45,1,1,1,0,1,1,1,0
"Jul 5, 2019 7:00 AM",147,114,33,,,,,,,,,,11,6,5,12,,,,21,13,8,99,38,28,17,11,128,2,7,3,3,0,1,0,1
"Jul 5, 2019 8:00 AM",296,226,70,,,,,,,,,,23,4,19,15,,,,32,26,6,168,67,63,48,15,226,3,9,9,3,6,0,0,0
"Jul 5, 2019 9:00 AM",153,125,28,,,,,,,,,,16,6,10,15,,,,29,16,13,76,33,40,24,16,85,3,7,2,1,1,0,0,0
"Jul 5, 2019 10:00 AM",50,35,15,,,,,,,,,,12,2,10,11,,,,9,9,0,35,20,15,8,7,31,2,3,3,2,1,1,0,1
"Jul 5, 2019 11:00 AM",49,27,22,,,,,,,,,,28,8,20,12,,,,12,10,2,26,17,21,4,17,28,4,3,2,2,0,0,0,0
"Jul 5, 2019 12:00 PM",57,29,28,,,,,,,,,,20,12,8,19,,,,17,15,2,21,32,29,13,16,30,4,6,4,1,3,0,0,0
"Jul 5, 2019 1:00 PM",82,25,57,,,,,,,,,,11,10,1,28,,,,26,20,6,17,24,20,7,13,41,9,5,3,1,2,1,1,0
"Jul 5, 2019 2:00 PM",59,29,30,,,,,,,,,,15,9,6,15,,,,19,18,1,13,28,32,10,22,22,2,4,2,2,0,2,0,2
"Jul 5, 2019 3:00 PM",88,23,65,,,,,,,,,,15,10,5,14,,,,28,27,1,29,34,31,12,19,27,5,2,7,5,2,3,3,0
"Jul 5, 2019 4:00 PM",163,47,116,,,,,,,,,,21,12,9,24,,,,68,65,3,21,91,50,15,35,43,6,3,6,2,4,4,3,1
"Jul 5, 2019 5:00 PM",239,56,183,,,,,,,,,,22,16,6,40,,,,130,127,3,28,152,76,14,62,64,9,6,3,2,1,1,0,1
"Jul 5, 2019 6:00 PM",188,50,138,,,,,,,,,,17,12,5,15,,,,91,90,1,21,97,64,14,50,41,4,3,9,8,1,0,0,0
"Jul 5, 2019 7:00 PM",73,27,46,,,,,,,,,,18,9,9,14,,,,51,46,5,12,34,44,14,30,28,3,1,3,2,1,0,0,0
"Jul 5, 2019 8:00 PM",61,17,44,,,,,,,,,,7,5,2,24,,,,22,22,0,8,23,31,9,22,22,1,1,2,2,0,0,0,0
"Jul 5, 2019 9:00 PM",55,17,38,,,,,,,,,,10,4,6,10,,,,15,15,0,9,17,9,7,2,17,2,1,2,0,2,1,1,0
"Jul 5, 2019 10:00 PM",29,7,22,,,,,,,,,,8,6,2,7,,,,13,13,0,5,12,7,6,1,15,0,0,0,0,0,0,0,0
"Jul 5, 2019 11:00 PM",20,5,15,,,,,,,,,,0,0,0,4,,,,10,10,0,5,12,4,1,3,6,1,0,1,1,0,0,0,0
"Jul 6, 2019 12:00 AM",7,2,5,,,,,,,,,,2,1,1,0,,,,8,7,1,3,6,3,0,3,8,0,2,1,1,0,1,1,0
"Jul 6, 2019 1:00 AM",10,4,6,,,,,,,,,,1,1,0,3,,,,4,3,1,6,5,1,1,0,3,0,0,0,0,0,0,0,0
"Jul 6, 2019 2:00 AM",6,2,4,,,,,,,,,,0,0,0,4,,,,4,3,1,2,3,3,2,1,2,2,0,0,0,0,0,0,0
"Jul 6, 2019 3:00 AM",6,1,5,,,,,,,,,,0,0,0,0,,,,3,3,0,1,0,2,0,2,1,0,2,0,0,0,1,1,0
"Jul 6, 2019 4:00 AM",8,2,6,,,,,,,,,,1,1,0,1,,,,3,3,0,2,2,1,0,1,6,0,0,0,0,0,0,0,0
"Jul 6, 2019 5:00 AM",4,0,4,,,,,,,,,,0,0,0,0,,,,1,1,0,1,3,0,0,0,2,0,0,0,0,0,0,0,0
"Jul 6, 2019 6:00 AM",11,7,4,,,,,,,,,,2,1,1,3,,,,2,1,1,7,1,3,1,2,4,1,1,0,0,0,0,0,0
"Jul 6, 2019 7:00 AM",15,9,6,,,,,,,,,,1,1,0,1,,,,4,2,2,13,14,2,0,2,16,1,0,1,0,1,0,0,0
"Jul 6, 2019 8:00 AM",31,14,17,,,,,,,,,,3,1,2,5,,,,6,5,1,12,8,5,0,5,21,2,2,0,0,0,0,0,0
"Jul 6, 2019 9:00 AM",34,20,14,,,,,,,,,,16,6,10,6,,,,18,17,1,9,14,12,6,6,22,1,9,0,0,0,0,0,0
"Jul 6, 2019 10:00 AM",36,21,15,,,,,,,,,,19,6,13,10,,,,3,2,1,14,15,21,11,10,15,7,1,7,3,4,1,1,0
"Jul 6, 2019 11:00 AM",35,22,13,,,,,,,,,,9,6,3,11,,,,11,7,4,15,22,16,7,9,14,0,4,4,4,0,2,1,1
"Jul 6, 2019 12:00 PM",34,13,21,,,,,,,,,,26,15,11,30,,,,4,3,1,13,17,18,9,9,9,1,3,0,0,0,0,0,0
"Jul 6, 2019 1:00 PM",35,20,15,,,,,,,,,,10,5,5,9,,,,9,9,0,12,12,13,2,11,21,3,0,1,1,0,1,0,1
"Jul 6, 2019 2:00 PM",32,19,13,,,,,,,,,,4,3,1,11,,,,10,8,2,4,6,15,6,9,10,3,0,2,2,0,1,0,1
"Jul 6, 2019 3:00 PM",30,9,21,,,,,,,,,,14,6,8,12,,,,11,10,1,10,8,18,5,13,9,0,4,1,0,1,0,0,0
"Jul 6, 2019 4:00 PM",37,17,20,,,,,,,,,,13,11,2,4,,,,11,11,0,7,19,18,10,8,15,3,2,1,0,1,0,0,0
"Jul 6, 2019 5:00 PM",25,11,14,,,,,,,,,,20,9,11,18,,,,12,12,0,9,17,27,9,18,16,3,3,5,3,2,1,1,0
"Jul 6, 2019 6:00 PM",40,20,20,,,,,,,,,,11,8,3,8,,,,13,13,0,12,16,15,8,7,18,3,1,2,2,0,0,0,0
"Jul 6, 2019 7:00 PM",36,11,25,,,,,,,,,,9,6,3,6,,,,14,11,3,14,11,17,11,6,14,0,1,5,3,2,0,0,0
"Jul 6, 2019 8:00 PM",23,16,7,,,,,,,,,,7,5,2,13,,,,8,6,2,0,10,16,9,7,16,1,1,9,4,5,0,0,0
"Jul 6, 2019 9:00 PM",18,9,9,,,,,,,,,,6,3,3,3,,,,6,6,0,3,7,6,4,2,12,2,1,5,2,3,1,0,1
"Jul 6, 2019 10:00 PM",13,7,6,,,,,,,,,,5,4,1,5,,,,4,3,1,6,8,16,8,8,11,0,0,0,0,0,0,0,0
"Jul 6, 2019 11:00 PM",15,4,11,,,,,,,,,,1,1,0,5,,,,1,1,0,3,4,1,0,1,5,0,0,0,0,0,0,0,0
"Jul 7, 2019 12:00 AM",14,6,8,,,,,,,,,,3,2,1,6,,,,9,7,2,1,6,2,2,0,2,0,1,0,0,0,0,0,0
"Jul 7, 2019 1:00 AM",3,2,1,,,,,,,,,,0,0,0,0,,,,0,0,0,4,0,1,0,1,3,0,0,1,0,1,1,1,0
"Jul 7, 2019 2:00 AM",3,0,3,,,,,,,,,,0,0,0,0,,,,1,1,0,2,4,0,0,0,1,0,0,0,0,0,0,0,0
"Jul 7, 2019 3:00 AM",7,1,6,,,,,,,,,,0,0,0,0,,,,1,1,0,0,4,0,0,0,1,1,3,0,0,0,0,0,0
"Jul 7, 2019 4:00 AM",9,0,9,,,,,,,,,,2,1,1,2,,,,1,1,0,1,1,0,0,0,1,0,0,0,0,0,0,0,0
"Jul 7, 2019 5:00 AM",4,1,3,,,,,,,,,,0,0,0,0,,,,0,0,0,0,1,0,0,0,1,1,0,0,0,0,0,0,0
"Jul 7, 2019 6:00 AM",7,4,3,,,,,,,,,,0,0,0,2,,,,3,3,0,2,5,2,1,1,7,2,1,0,0,0,0,0,0
"Jul 7, 2019 7:00 AM",16,5,11,,,,,,,,,,2,1,1,2,,,,6,4,2,10,21,10,2,8,23,3,1,1,0,1,2,0,2
"Jul 7, 2019 8:00 AM",20,8,12,,,,,,,,,,2,1,1,3,,,,5,4,1,7,15,15,6,9,19,1,22,3,1,2,0,0,0
"Jul 7, 2019 9:00 AM",49,27,22,,,,,,,,,,15,4,11,13,,,,14,12,2,14,22,29,13,16,34,4,7,4,2,2,0,0,0
"Jul 7, 2019 10:00 AM",34,18,16,,,,,,,,,,15,10,5,8,,,,18,15,3,33,38,47,7,40,24,3,5,3,1,2,4,4,0
"Jul 7, 2019 11:00 AM",46,32,14,,,,,,,,,,36,11,25,16,,,,11,9,2,16,45,55,20,35,35,7,8,3,2,1,1,0,1
"Jul 7, 2019 12:00 PM",56,29,27,,,,,,,,,,69,31,38,19,,,,15,15,0,26,44,74,28,46,31,17,5,7,4,3,5,2,3
"Jul 7, 2019 1:00 PM",55,27,28,,,,,,,,,,55,28,27,20,,,,12,11,1,20,55,59,22,37,31,11,3,6,5,1,1,0,1
"Jul 7, 2019 2:00 PM",53,22,31,,,,,,,,,,56,37,19,27,,,,24,22,2,13,44,74,30,44,50,3,7,9,5,4,0,0,0
"Jul 7, 2019 3:00 PM",53,23,30,,,,,,,,,,28,10,18,9,,,,18,18,0,15,42,64,26,38,47,11,1,4,3,1,1,0,1
"Jul 7, 2019 4:00 PM",45,25,20,,,,,,,,,,37,21,16,22,,,,18,14,4,15,25,55,25,30,46,1,5,1,1,0,0,0,0
"Jul 7, 2019 5:00 PM",49,17,32,,,,,,,,,,30,15,15,13,,,,14,12,2,13,28,63,36,27,54,5,3,3,1,2,2,1,1
"Jul 7, 2019 6:00 PM",57,28,29,,,,,,,,,,17,15,2,17,,,,22,19,3,15,18,39,25,14,45,3,2,1,1,0,0,0,0
"Jul 7, 2019 7:00 PM",49,25,24,,,,,,,,,,15,12,3,5,,,,17,14,3,14,15,33,20,13,52,2,2,3,3,0,0,0,0
"Jul 7, 2019 8:00 PM",26,6,20,,,,,,,,,,14,8,6,9,,,,10,10,0,9,12,23,9,14,21,3,4,2,2,0,0,0,0
"Jul 7, 2019 9:00 PM",24,9,15,,,,,,,,,,11,6,5,6,,,,2,2,0,7,8,12,9,3,15,4,1,4,3,1,0,0,0
"Jul 7, 2019 10:00 PM",19,6,13,,,,,,,,,,1,1,0,5,,,,4,3,1,4,1,1,0,1,10,0,0,0,0,0,0,0,0
"Jul 7, 2019 11:00 PM",11,3,8,,,,,,,,,,0,0,0,2,,,,5,5,0,6,4,1,1,0,6,1,0,1,0,1,2,2,0
"Jul 8, 2019 12:00 AM",9,5,4,,,,,,,,,,0,0,0,2,,,,3,3,0,1,5,0,0,0,2,0,2,1,0,1,0,0,0
"Jul 8, 2019 1:00 AM",5,0,5,,,,,,,,,,2,2,0,0,,,,3,3,0,0,2,1,1,0,1,0,0,0,0,0,0,0,0
"Jul 8, 2019 2:00 AM",3,1,2,,,,,,,,,,0,0,0,0,,,,1,1,0,0,0,0,0,0,0,0,0,0,0,0,0,0,0
"Jul 8, 2019 3:00 AM",2,0,2,,,,,,,,,,0,0,0,0,,,,0,0,0,0,0,0,0,0,0,1,0,0,0,0,0,0,0
"Jul 8, 2019 4:00 AM",1,0,1,,,,,,,,,,0,0,0,1,,,,0,0,0,0,0,0,0,0,0,0,0,0,0,0,0,0,0
"Jul 8, 2019 5:00 AM",7,6,1,,,,,,,,,,1,1,0,3,,,,3,3,0,8,0,0,0,0,11,2,0,0,0,0,0,0,0
"Jul 8, 2019 6:00 AM",51,32,19,,,,,,,,,,3,0,3,1,,,,10,7,3,34,20,9,6,3,43,0,3,3,1,2,1,0,1
"Jul 8, 2019 7:00 AM",156,118,38,,,,,,,,,,16,3,13,15,,,,25,17,8,115,43,41,29,12,171,4,8,3,3,0,0,0,0
"Jul 8, 2019 8:00 AM",347,278,69,,,,,,,,,,20,3,17,22,,,,32,24,8,225,64,93,69,24,272,6,6,5,4,1,0,0,0
"Jul 8, 2019 9:00 AM",176,140,36,,,,,,,,,,23,10,13,5,,,,26,17,9,86,28,52,33,19,114,6,1,6,3,3,0,0,0
"Jul 8, 2019 10:00 AM",53,39,14,,,,,,,,,,8,6,2,10,,,,7,6,1,34,16,21,7,14,30,2,6,5,3,2,1,0,1
"Jul 8, 2019 11:00 AM",46,26,20,,,,,,,,,,15,7,8,11,,,,15,14,1,20,11,19,8,11,21,0,3,2,2,0,1,0,1
"Jul 8, 2019 12:00 PM",41,23,18,,,,,,,,,,15,8,7,14,,,,14,13,1,22,15,9,6,3,16,4,2,1,1,0,0,0,0
"Jul 8, 2019 1:00 PM",52,23,29,,,,,,,,,,16,11,5,13,,,,11,10,1,16,23,19,7,12,19,1,2,6,3,3,1,0,1
"Jul 8, 2019 2:00 PM",37,13,24,,,,,,,,,,10,5,5,10,,,,22,20,2,9,16,16,5,11,19,1,3,2,2,0,2,2,0
"Jul 8, 2019 3:00 PM",58,20,38,,,,,,,,,,18,7,11,8,,,,26,26,0,11,24,17,8,9,19,4,3,5,2,3,1,1,0
"Jul 8, 2019 4:00 PM",100,20,80,,,,,,,,,,24,13,11,16,,,,42,41,1,25,70,39,13,26,27,8,2,7,5,2,1,1,0
"Jul 8, 2019 5:00 PM",336,56,280,,,,,,,,,,27,19,8,38,,,,140,139,1,34,218,100,21,79,84,8,6,5,1,4,1,1,0
"Jul 8, 2019 6:00 PM",300,56,244,,,,,,,,,,17,14,3,14,,,,160,157,3,41,170,99,6,93,59,7,9,2,0,2,2,1,1
"Jul 8, 2019 7:00 PM",145,45,100,,,,,,,,,,14,9,5,17,,,,76,75,1,22,78,41,10,31,45,2,4,2,1,1,2,2,0
"Jul 8, 2019 8:00 PM",80,27,53,,,,,,,,,,10,8,2,9,,,,39,37,2,17,34,19,3,16,16,2,1,1,0,1,0,0,0
"Jul 8, 2019 9:00 PM",46,15,31,,,,,,,,,,3,3,0,11,,,,16,15,1,9,14,19,5,14,21,1,1,0,0,0,1,1,0
"Jul 8, 2019 10:00 PM",31,7,24,,,,,,,,,,5,5,0,7,,,,11,11,0,4,15,5,1,4,7,0,1,3,1,2,0,0,0
"Jul 8, 2019 11:00 PM",7,2,5,,,,,,,,,,0,0,0,1,,,,2,2,0,2,3,0,0,0,3,0,0,1,0,1,1,1,0
"Jul 9, 2019 12:00 AM",9,1,8,,,,,,,,,,0,0,0,0,,,,3,3,0,1,6,0,0,0,1,0,1,0,0,0,0,0,0
"Jul 9, 2019 1:00 AM",3,1,2,,,,,,,,,,0,0,0,0,,,,2,2,0,1,0,0,0,0,1,0,0,0,0,0,0,0,0
"Jul 9, 2019 2:00 AM",2,0,2,,,,,,,,,,0,0,0,0,,,,0,0,0,0,4,0,0,0,0,0,0,0,0,0,0,0,0
"Jul 9, 2019 3:00 AM",1,1,0,,,,,,,,,,0,0,0,0,,,,0,0,0,0,0,1,0,1,1,0,0,1,1,0,0,0,0
"Jul 9, 2019 4:00 AM",4,2,2,,,,,,,,,,0,0,0,0,,,,0,0,0,1,0,1,0,1,1,0,0,0,0,0,0,0,0
"Jul 9, 2019 5:00 AM",8,7,1,,,,,,,,,,1,0,1,3,,,,0,0,0,7,2,1,0,1,15,2,0,0,0,0,0,0,0
"Jul 9, 2019 6:00 AM",65,45,20,,,,,,,,,,4,0,4,7,,,,7,6,1,30,19,12,7,5,54,0,2,3,2,1,2,0,2
"Jul 9, 2019 7:00 AM",206,153,53,,,,,,,,,,15,2,13,20,,,,35,27,8,141,40,58,39,19,196,3,6,8,7,1,1,0,1
"Jul 9, 2019 8:00 AM",416,324,92,,,,,,,,,,19,2,17,20,,,,42,30,12,236,64,93,70,23,315,5,10,6,2,4,0,0,0
"Jul 9, 2019 9:00 AM",171,141,30,,,,,,,,,,23,5,18,1,,,,23,18,5,86,37,44,30,14,88,6,6,6,1,5,0,0,0
"Jul 9, 2019 10:00 AM",54,39,15,,,,,,,,,,16,3,13,11,,,,15,11,4,30,10,16,7,9,37,4,4,4,2,2,1,1,0
"Jul 9, 2019 11:00 AM",33,21,12,,,,,,,,,,10,7,3,3,,,,6,5,1,24,15,22,9,13,24,3,3,4,0,4,0,0,0
"Jul 9, 2019 12:00 PM",43,23,20,,,,,,,,,,22,9,13,8,,,,15,14,1,32,18,23,14,9,24,1,2,1,1,0,0,0,0
"Jul 9, 2019 1:00 PM",65,26,39,,,,,,,,,,25,15,10,12,,,,17,16,1,15,17,20,4,16,26,4,3,2,1,1,1,1,0
"Jul 9, 2019 2:00 PM",49,14,35,,,,,,,,,,12,8,4,4,,,,28,24,4,19,19,24,5,19,13,7,6,1,1,0,1,1,0
"Jul 9, 2019 3:00 PM",63,25,38,,,,,,,,,,18,11,7,15,,,,26,24,2,14,34,22,6,16,25,5,0,4,4,0,0,0,0
"Jul 9, 2019 4:00 PM",145,32,113,,,,,,,,,,28,12,16,20,,,,59,59,0,31,82,52,14,38,35,8,4,5,2,3,3,3,0
"Jul 9, 2019 5:00 PM",322,71,251,,,,,,,,,,30,21,9,22,,,,159,155,4,44,240,94,19,75,75,9,6,8,3,5,1,1,0
"Jul 9, 2019 6:00 PM",340,84,256,,,,,,,,,,41,29,12,31,,,,147,145,2,41,211,98,13,85,72,9,5,10,6,4,4,3,1
"Jul 9, 2019 7:00 PM",158,40,118,,,,,,,,,,14,11,3,16,,,,86,84,2,31,88,65,21,44,42,2,5,5,2,3,6,6,0
"Jul 9, 2019 8:00 PM",122,35,87,,,,,,,,,,17,10,7,18,,,,48,43,5,17,48,33,6,27,43,3,4,7,2,5,1,1,0
"Jul 9, 2019 9:00 PM",64,14,50,,,,,,,,,,11,7,4,12,,,,33,29,4,21,32,26,14,12,35,3,2,2,2,0,0,0,0
"Jul 9, 2019 10:00 PM",37,11,26,,,,,,,,,,9,6,3,6,,,,15,14,1,8,15,9,6,3,24,1,1,1,1,0,1,0,1
"Jul 9, 2019 11:00 PM",23,2,21,,,,,,,,,,5,5,0,0,,,,13,10,3,6,11,0,0,0,6,0,0,0,0,0,0,0,0
"Jul 10, 2019 12:00 AM",7,1,6,,,,,,,,,,0,0,0,5,,,,5,5,0,2,6,7,5,2,5,1,0,0,0,0,0,0,0
"Jul 10, 2019 1:00 AM",5,0,5,,,,,,,,,,0,0,0,5,,,,1,1,0,0,2,0,0,0,0,0,1,0,0,0,0,0,0
"Jul 10, 2019 2:00 AM",2,1,1,,,,,,,,,,0,0,0,0,,,,5,4,1,1,4,1,1,0,1,0,0,0,0,0,0,0,0
"Jul 10, 2019 3:00 AM",2,2,0,,,,,,,,,,0,0,0,0,,,,0,0,0,0,0,0,0,0,0,1,0,0,0,0,0,0,0
"Jul 10, 2019 4:00 AM",1,0,1,,,,,,,,,,0,0,0,0,,,,1,1,0,1,0,5,0,5,0,1,0,0,0,0,0,0,0
"Jul 10, 2019 5:00 AM",12,10,2,,,,,,,,,,0,0,0,2,,,,3,2,1,6,3,1,1,0,15,2,0,0,0,0,0,0,0
"Jul 10, 2019 6:00 AM",52,37,15,,,,,,,,,,4,0,4,4,,,,6,5,1,35,29,12,11,1,55,1,4,3,1,2,0,0,0
"Jul 10, 2019 7:00 AM",184,137,47,,,,,,,,,,14,4,10,14,,,,35,27,8,117,42,45,28,17,177,3,7,5,4,1,1,1,0
"Jul 10, 2019 8:00 AM",368,297,71,,,,,,,,,,29,7,22,21,,,,42,34,8,229,69,92,66,26,271,3,8,2,1,1,0,0,0
"Jul 10, 2019 9:00 AM",163,133,30,,,,,,,,,,25,5,20,11,,,,27,22,5,87,29,43,30,13,98,3,11,4,1,3,3,1,2
"Jul 10, 2019 10:00 AM",61,42,19,,,,,,,,,,9,3,6,6,,,,14,13,1,33,17,9,7,2,30,2,3,6,6,0,0,0,0
"Jul 10, 2019 11:00 AM",35,22,13,,,,,,,,,,13,7,6,7,,,,4,3,1,24,14,14,5,9,26,4,1,2,0,2,0,0,0
"Jul 10, 2019 12:00 PM",39,20,19,,,,,,,,,,21,15,6,13,,,,12,10,2,21,12,9,5,4,20,5,1,1,1,0,0,0,0
"Jul 10, 2019 1:00 PM",59,20,39,,,,,,,,,,21,12,9,7,,,,18,15,3,15,21,17,7,10,21,3,3,3,2,1,0,0,0
"Jul 10, 2019 2:00 PM",48,23,25,,,,,,,,,,10,6,4,16,,,,19,18,1,21,16,15,2,13,17,2,2,4,3,1,0,0,0
"Jul 10, 2019 3:00 PM",54,16,38,,,,,,,,,,25,10,15,24,,,,18,15,3,15,25,16,3,13,10,3,5,3,2,1,1,0,1
"Jul 10, 2019 4:00 PM",115,35,80,,,,,,,,,,25,14,11,14,,,,52,51,1,24,71,32,5,27,41,7,3,1,1,0,4,2,2
"Jul 10, 2019 5:00 PM",299,63,236,,,,,,,,,,36,25,11,31,,,,147,145,2,34,169,79,18,61,85,11,10,12,5,7,3,0,3
"Jul 10, 2019 6:00 PM",241,31,210,,,,,,,,,,31,20,11,10,,,,131,128,3,34,167,57,10,47,55,1,6,4,2,2,3,3,0
"Jul 10, 2019 7:00 PM",135,30,105,,,,,,,,,,5,4,1,6,,,,57,56,1,20,59,20,2,18,21,6,4,5,3,2,4,2,2
"Jul 10, 2019 8:00 PM",71,12,59,,,,,,,,,,10,7,3,6,,,,39,38,1,15,38,15,1,14,9,5,1,2,0,2,0,0,0
"Jul 10, 2019 9:00 PM",57,10,47,,,,,,,,,,6,2,4,7,,,,27,26,1,2,15,11,1,10,12,1,3,4,2,2,4,0,4
"Jul 10, 2019 10:00 PM",28,6,22,,,,,,,,,,2,2,0,2,,,,12,11,1,4,18,3,0,3,14,0,1,2,0,2,1,1,0
"Jul 10, 2019 11:00 PM",12,3,9,,,,,,,,,,4,4,0,2,,,,10,10,0,4,6,4,1,3,1,0,0,2,1,1,0,0,0
"Jul 11, 2019 12:00 AM",4,1,3,,,,,,,,,,0,0,0,2,,,,4,3,1,2,2,0,0,0,3,0,0,0,0,0,1,1,0
"Jul 11, 2019 1:00 AM",3,0,3,,,,,,,,,,1,0,1,0,,,,4,4,0,2,2,2,2,0,0,0,0,1,1,0,0,0,0
"Jul 11, 2019 2:00 AM",2,0,2,,,,,,,,,,0,0,0,0,,,,1,0,1,2,2,0,0,0,0,1,0,0,0,0,0,0,0
"Jul 11, 2019 3:00 AM",2,1,1,,,,,,,,,,0,0,0,0,,,,1,1,0,0,0,0,0,0,1,0,0,0,0,0,0,0,0
"Jul 11, 2019 4:00 AM",2,1,1,,,,,,,,,,0,0,0,0,,,,2,2,0,1,1,0,0,0,0,1,0,0,0,0,0,0,0
"Jul 11, 2019 5:00 AM",8,5,3,,,,,,,,,,1,0,1,4,,,,0,0,0,11,5,1,1,0,11,2,0,0,0,0,0,0,0
"Jul 11, 2019 6:00 AM",59,40,19,,,,,,,,,,5,1,4,4,,,,7,7,0,34,23,11,8,3,45,2,3,6,4,2,1,0,1
"Jul 11, 2019 7:00 AM",161,122,39,,,,,,,,,,13,2,11,18,,,,25,19,6,128,32,45,26,19,168,1,6,11,10,1,3,1,2
"Jul 11, 2019 8:00 AM",303,229,74,,,,,,,,,,23,3,20,22,,,,32,25,7,204,69,87,67,20,271,0,7,5,3,2,4,0,4
"Jul 11, 2019 9:00 AM",137,109,28,,,,,,,,,,20,6,14,7,,,,30,20,10,87,17,35,24,11,91,6,5,9,5,4,6,0,6
"Jul 11, 2019 10:00 AM",52,47,5,,,,,,,,,,15,4,11,9,,,,6,5,1,23,13,15,7,8,38,2,2,5,2,3,2,1,1
"Jul 11, 2019 11:00 AM",45,29,16,,,,,,,,,,24,15,9,12,,,,11,8,3,24,19,13,4,9,21,5,3,3,2,1,0,0,0
"Jul 11, 2019 12:00 PM",48,26,22,,,,,,,,,,28,12,16,13,,,,13,10,3,21,31,24,12,12,24,3,2,3,2,1,4,2,2
"Jul 11, 2019 1:00 PM",73,32,41,,,,,,,,,,23,17,6,9,,,,12,11,1,21,24,30,6,24,19,4,4,5,4,1,1,1,0
"Jul 11, 2019 2:00 PM",62,32,30,,,,,,,,,,12,6,6,16,,,,26,23,3,16,22,11,2,9,16,3,3,1,0,1,2,1,1
"Jul 11, 2019 3:00 PM",58,26,32,,,,,,,,,,16,8,8,13,,,,27,26,1,15,27,27,10,17,20,3,7,7,4,3,1,1,0
"Jul 11, 2019 4:00 PM",139,38,101,,,,,,,,,,18,8,10,17,,,,52,49,3,27,64,52,21,31,35,8,4,10,8,2,3,3,0
"Jul 11, 2019 5:00 PM",316,66,250,,,,,,,,,,23,14,9,30,,,,129,126,3,40,186,95,21,74,73,10,1,10,5,5,2,0,2
"Jul 11, 2019 6:00 PM",263,66,197,,,,,,,,,,30,23,7,22,,,,145,143,2,39,164,108,23,85,62,10,12,8,5,3,7,4,3
"Jul 11, 2019 7:00 PM",139,41,98,,,,,,,,,,18,12,6,9,,,,63,63,0,19,77,64,19,45,50,4,5,6,4,2,0,0,0
"Jul 11, 2019 8:00 PM",100,30,70,,,,,,,,,,11,9,2,16,,,,46,46,0,16,44,40,15,25,47,6,8,4,2,2,0,0,0
"Jul 11, 2019 9:00 PM",64,16,48,,,,,,,,,,22,14,8,13,,,,26,26,0,11,36,31,12,19,36,2,2,4,1,3,1,1,0
"Jul 11, 2019 10:00 PM",39,8,31,,,,,,,,,,5,3,2,5,,,,19,18,1,9,23,13,6,7,19,0,1,3,2,1,0,0,0
"Jul 11, 2019 11:00 PM",24,5,19,,,,,,,,,,2,2,0,2,,,,8,8,0,9,11,7,4,3,10,0,0,0,0,0,0,0,0
"Jul 12, 2019 12:00 AM",10,4,6,,,,,,,,,,3,2,1,4,,,,5,4,1,4,9,5,1,4,3,0,0,0,0,0,0,0,0
"Jul 12, 2019 1:00 AM",4,0,4,,,,,,,,,,0,0,0,0,,,,1,1,0,2,1,1,1,0,2,0,1,0,0,0,0,0,0
"Jul 12, 2019 2:00 AM",3,0,3,,,,,,,,,,2,0,2,0,,,,5,5,0,0,3,1,0,1,3,0,0,0,0,0,0,0,0
"Jul 12, 2019 3:00 AM",7,3,4,,,,,,,,,,0,0,0,0,,,,1,1,0,0,2,0,0,0,0,1,0,0,0,0,0,0,0
"Jul 12, 2019 4:00 AM",4,2,2,,,,,,,,,,3,3,0,0,,,,0,0,0,2,2,0,0,0,0,0,0,0,0,0,0,0,0
"Jul 12, 2019 5:00 AM",14,8,6,,,,,,,,,,1,1,0,3,,,,1,1,0,9,3,1,1,0,11,1,0,0,0,0,0,0,0
"Jul 12, 2019 6:00 AM",51,34,17,,,,,,,,,,3,0,3,3,,,,9,9,0,32,18,9,5,4,52,2,2,3,2,1,0,0,0
"Jul 12, 2019 7:00 AM",146,103,43,,,,,,,,,,10,6,4,15,,,,22,17,5,102,36,27,17,10,141,2,6,3,3,0,1,0,1
"Jul 12, 2019 8:00 AM",281,219,62,,,,,,,,,,29,7,22,21,,,,40,28,12,169,64,77,46,31,219,1,10,4,1,3,2,0,2
"Jul 12, 2019 9:00 AM",164,128,36,,,,,,,,,,28,15,13,8,,,,23,16,7,75,18,36,21,15,94,3,5,8,3,5,1,0,1
"Jul 12, 2019 10:00 AM",51,32,19,,,,,,,,,,18,8,10,3,,,,15,11,4,30,14,10,3,7,24,3,1,8,3,5,2,2,0
"Jul 12, 2019 11:00 AM",51,34,17,,,,,,,,,,15,4,11,11,,,,4,4,0,24,13,10,6,4,15,1,2,1,1,0,2,2,0
"Jul 12, 2019 12:00 PM",57,29,28,,,,,,,,,,9,7,2,8,,,,20,17,3,21,30,19,7,12,18,1,2,2,1,1,1,1,0
"Jul 12, 2019 1:00 PM",83,29,54,,,,,,,,,,12,9,3,4,,,,17,14,3,12,18,18,6,12,26,5,4,4,2,2,0,0,0
"Jul 12, 2019 2:00 PM",63,32,31,,,,,,,,,,29,15,14,13,,,,16,16,0,10,32,24,6,18,23,5,0,5,3,2,1,1,0
"Jul 12, 2019 3:00 PM",80,31,49,,,,,,,,,,26,20,6,11,,,,26,25,1,27,25,27,9,18,15,7,1,6,5,1,0,0,0
"Jul 12, 2019 4:00 PM",135,32,103,,,,,,,,,,28,18,10,17,,,,62,57,5,25,81,42,12,30,49,5,1,4,1,3,6,3,3
"Jul 12, 2019 5:00 PM",254,60,194,,,,,,,,,,31,20,11,26,,,,134,129,5,35,121,66,16,50,71,10,5,6,2,4,1,1,0
"Jul 12, 2019 6:00 PM",166,48,118,,,,,,,,,,27,20,7,26,,,,95,94,1,27,98,44,7,37,57,7,5,4,2,2,4,4,0
"Jul 12, 2019 7:00 PM",99,29,70,,,,,,,,,,22,17,5,8,,,,49,49,0,9,33,22,7,15,19,3,3,3,0,3,0,0,0
"Jul 12, 2019 8:00 PM",58,16,42,,,,,,,,,,20,11,9,11,,,,28,27,1,10,25,14,5,9,20,2,1,2,1,1,1,0,1
"Jul 12, 2019 9:00 PM",39,12,27,,,,,,,,,,8,6,2,8,,,,15,14,1,10,17,19,3,16,14,0,1,1,0,1,0,0,0
"Jul 12, 2019 10:00 PM",38,8,30,,,,,,,,,,7,6,1,5,,,,11,11,0,7,9,8,5,3,9,2,0,5,1,4,0,0,0
"Jul 12, 2019 11:00 PM",16,3,13,,,,,,,,,,5,3,2,4,,,,10,9,1,6,2,2,0,2,6,0,0,1,0,1,0,0,0
"Jul 13, 2019 12:00 AM",18,4,14,,,,,,,,,,2,0,2,7,,,,5,4,1,4,9,1,0,1,4,1,0,1,1,0,1,0,1
"Jul 13, 2019 1:00 AM",14,1,13,,,,,,,,,,2,2,0,0,,,,1,1,0,2,3,1,1,0,4,1,1,0,0,0,0,0,0
"Jul 13, 2019 2:00 AM",8,1,7,,,,,,,,,,2,0,2,0,,,,3,3,0,0,4,0,0,0,3,1,0,0,0,0,0,0,0
"Jul 13, 2019 3:00 AM",5,1,4,,,,,,,,,,0,0,0,0,,,,1,1,0,2,0,2,0,2,2,0,2,0,0,0,0,0,0
"Jul 13, 2019 4:00 AM",5,2,3,,,,,,,,,,0,0,0,0,,,,1,0,1,1,1,0,0,0,1,0,0,0,0,0,0,0,0
"Jul 13, 2019 5:00 AM",3,0,3,,,,,,,,,,0,0,0,2,,,,3,3,0,2,0,2,0,2,2,1,1,0,0,0,0,0,0
"Jul 13, 2019 6:00 AM",25,15,10,,,,,,,,,,1,1,0,0,,,,5,5,0,4,8,1,0,1,8,1,0,0,0,0,1,0,1
"Jul 13, 2019 7:00 AM",28,12,16,,,,,,,,,,1,1,0,5,,,,4,4,0,8,8,2,1,1,18,1,7,0,0,0,1,0,1
"Jul 13, 2019 8:00 AM",39,21,18,,,,,,,,,,5,4,1,1,,,,13,7,6,11,18,1,0,1,22,2,11,5,2,3,1,0,1
"Jul 13, 2019 9:00 AM",53,34,19,,,,,,,,,,18,5,13,1,,,,13,12,1,42,22,23,4,19,17,4,7,5,2,3,1,1,0
"Jul 13, 2019 10:00 AM",52,30,22,,,,,,,,,,27,8,19,20,,,,16,13,3,15,33,37,7,30,26,5,8,1,1,0,0,0,0
"Jul 13, 2019 11:00 AM",47,19,28,,,,,,,,,,15,10,5,6,,,,19,15,4,25,33,17,6,11,22,5,5,1,0,1,2,2,0
"Jul 13, 2019 12:00 PM",57,27,30,,,,,,,,,,26,14,12,6,,,,13,11,2,20,28,32,14,18,44,15,4,2,2,0,2,2,0
"Jul 13, 2019 1:00 PM",58,33,25,,,,,,,,,,22,21,1,7,,,,17,16,1,20,26,25,11,14,38,12,7,6,3,3,0,0,0
"Jul 13, 2019 2:00 PM",52,33,19,,,,,,,,,,36,25,11,8,,,,16,14,2,9,20,42,21,21,17,13,5,4,3,1,1,0,1
"Jul 13, 2019 3:00 PM",54,24,30,,,,,,,,,,22,10,12,9,,,,15,15,0,29,31,36,7,29,20,2,4,4,4,0,1,0,1
"Jul 13, 2019 4:00 PM",49,19,30,,,,,,,,,,47,24,23,10,,,,20,20,0,19,27,34,15,19,34,2,1,8,6,2,4,4,0
"Jul 13, 2019 5:00 PM",47,22,25,,,,,,,,,,34,14,20,14,,,,15,13,2,18,26,36,13,23,34,1,7,3,3,0,0,0,0
"Jul 13, 2019 6:00 PM",58,28,30,,,,,,,,,,35,26,9,10,,,,17,17,0,12,29,30,13,17,33,3,1,4,1,3,0,0,0
"Jul 13, 2019 7:00 PM",41,23,18,,,,,,,,,,17,12,5,7,,,,10,9,1,13,16,16,9,7,24,4,0,7,5,2,5,2,3
"Jul 13, 2019 8:00 PM",31,15,16,,,,,,,,,,11,4,7,4,,,,10,8,2,7,14,24,13,11,21,3,1,3,3,0,0,0,0
"Jul 13, 2019 9:00 PM",33,13,20,,,,,,,,,,11,3,8,6,,,,7,6,1,5,7,15,7,8,19,1,0,2,0,2,0,0,0
"Jul 13, 2019 10:00 PM",18,8,10,,,,,,,,,,3,1,2,1,,,,9,8,1,8,2,6,3,3,18,0,0,0,0,0,0,0,0
"Jul 13, 2019 11:00 PM",26,5,21,,,,,,,,,,13,9,4,2,,,,1,1,0,4,2,6,5,1,13,0,0,0,0,0,1,0,1
"Jul 14, 2019 12:00 AM",12,4,8,,,,,,,,,,7,6,1,0,,,,5,5,0,5,7,0,0,0,13,0,0,0,0,0,0,0,0
"Jul 14, 2019 1:00 AM",12,5,7,,,,,,,,,,3,2,1,3,,,,4,4,0,3,3,2,1,1,5,0,1,1,1,0,0,0,0
"Jul 14, 2019 2:00 AM",2,0,2,,,,,,,,,,2,2,0,1,,,,2,2,0,2,0,2,2,0,4,1,0,0,0,0,0,0,0
"Jul 14, 2019 3:00 AM",7,1,6,,,,,,,,,,0,0,0,1,,,,3,3,0,2,1,4,2,2,0,1,0,0,0,0,0,0,0
"Jul 14, 2019 4:00 AM",4,0,4,,,,,,,,,,1,0,1,0,,,,1,1,0,0,1,0,0,0,1,0,2,0,0,0,0,0,0
"Jul 14, 2019 5:00 AM",5,1,4,,,,,,,,,,0,0,0,0,,,,1,1,0,0,1,0,0,0,4,0,0,0,0,0,0,0,0
"Jul 14, 2019 6:00 AM",11,3,8,,,,,,,,,,1,0,1,0,,,,5,5,0,5,4,3,2,1,11,1,1,0,0,0,0,0,0
"Jul 14, 2019 7:00 AM",13,5,8,,,,,,,,,,2,1,1,0,,,,10,8,2,13,28,6,2,4,11,3,3,0,0,0,0,0,0
"Jul 14, 2019 8:00 AM",30,13,17,,,,,,,,,,8,3,5,7,,,,6,6,0,6,35,14,5,9,16,1,11,1,0,1,0,0,0
"Jul 14, 2019 9:00 AM",35,19,16,,,,,,,,,,22,0,22,6,,,,18,15,3,18,36,45,9,36,46,2,10,4,2,2,4,4,0
"Jul 14, 2019 10:00 AM",46,30,16,,,,,,,,,,15,4,11,10,,,,17,13,4,17,39,42,15,27,29,7,6,8,3,5,1,1,0
"Jul 14, 2019 11:00 AM",50,28,22,,,,,,,,,,33,19,14,6,,,,11,9,2,19,56,67,17,50,68,13,16,8,6,2,2,1,1
"Jul 14, 2019 12:00 PM",37,19,18,,,,,,,,,,51,21,30,12,,,,16,16,0,32,78,71,27,44,50,7,7,4,1,3,0,0,0
"Jul 14, 2019 1:00 PM",59,33,26,,,,,,,,,,42,25,17,14,,,,22,19,3,22,70,63,23,40,40,20,3,7,4,3,0,0,0
"Jul 14, 2019 2:00 PM",60,25,35,,,,,,,,,,53,33,20,7,,,,11,8,3,17,44,65,29,36,55,14,7,4,2,2,0,0,0
"Jul 14, 2019 3:00 PM",53,30,23,,,,,,,,,,39,22,17,7,,,,16,15,1,25,33,33,15,18,40,6,2,6,5,1,2,0,2
"Jul 14, 2019 4:00 PM",52,27,25,,,,,,,,,,37,27,10,14,,,,7,7,0,24,26,70,46,24,47,4,5,3,2,1,0,0,0
"Jul 14, 2019 5:00 PM",32,9,23,,,,,,,,,,19,6,13,16,,,,10,7,3,10,20,39,17,22,40,5,2,4,2,2,2,0,2
"Jul 14, 2019 6:00 PM",32,14,18,,,,,,,,,,13,7,6,10,,,,22,19,3,20,23,49,26,23,27,5,2,1,1,0,1,1,0
"Jul 14, 2019 7:00 PM",40,18,22,,,,,,,,,,13,8,5,33,,,,12,11,1,12,24,29,19,10,44,1,0,2,1,1,1,1,0
"Jul 14, 2019 8:00 PM",55,27,28,,,,,,,,,,10,5,5,7,,,,12,12,0,15,12,36,17,19,33,2,1,3,2,1,0,0,0
"Jul 14, 2019 9:00 PM",28,12,16,,,,,,,,,,13,4,9,8,,,,6,6,0,12,8,28,23,5,13,2,0,7,4,3,3,2,1
"Jul 14, 2019 10:00 PM",24,9,15,,,,,,,,,,4,1,3,3,,,,4,3,1,6,6,2,1,1,15,1,0,1,0,1,0,0,0
"Jul 14, 2019 11:00 PM",9,3,6,,,,,,,,,,3,2,1,1,,,,2,2,0,3,2,2,2,0,3,1,0,0,0,0,0,0,0
"Jul 15, 2019 12:00 AM",7,1,6,,,,,,,,,,1,1,0,0,,,,3,3,0,3,3,3,0,3,1,0,2,2,1,1,1,0,1
"Jul 15, 2019 1:00 AM",3,0,3,,,,,,,,,,1,1,0,0,,,,0,0,0,1,2,2,1,1,1,0,0,0,0,0,0,0,0
"Jul 15, 2019 2:00 AM",3,0,3,,,,,,,,,,0,0,0,0,,,,0,0,0,0,0,0,0,0,0,1,0,1,1,0,0,0,0
"Jul 15, 2019 3:00 AM",0,0,0,,,,,,,,,,0,0,0,0,,,,0,0,0,0,1,0,0,0,1,0,0,0,0,0,0,0,0
"Jul 15, 2019 4:00 AM",2,0,2,,,,,,,,,,0,0,0,0,,,,0,0,0,1,0,2,0,2,0,0,0,0,0,0,0,0,0
"Jul 15, 2019 5:00 AM",13,10,3,,,,,,,,,,0,0,0,1,,,,1,1,0,6,3,1,1,0,10,1,0,0,0,0,0,0,0
"Jul 15, 2019 6:00 AM",53,31,22,,,,,,,,,,6,1,5,5,,,,8,5,3,36,19,9,6,3,67,2,4,4,3,1,2,1,1
"Jul 15, 2019 7:00 AM",173,130,43,,,,,,,,,,7,2,5,7,,,,28,24,4,139,39,44,32,12,179,1,6,6,4,2,2,0,2
"Jul 15, 2019 8:00 AM",372,298,74,,,,,,,,,,23,4,19,18,,,,40,28,12,216,67,97,72,25,320,3,8,7,4,3,0,0,0
"Jul 15, 2019 9:00 AM",210,174,36,,,,,,,,,,20,8,12,6,,,,30,20,10,98,33,48,29,19,110,5,2,3,3,0,0,0,0
"Jul 15, 2019 10:00 AM",48,35,13,,,,,,,,,,17,6,11,13,,,,11,9,2,29,19,30,9,21,36,5,3,3,2,1,3,1,2
"Jul 15, 2019 11:00 AM",40,25,15,,,,,,,,,,26,13,13,11,,,,15,14,1,16,24,23,9,14,32,1,2,1,1,0,2,2,0
"Jul 15, 2019 12:00 PM",49,24,25,,,,,,,,,,31,13,18,3,,,,12,12,0,17,20,27,10,17,26,3,3,5,4,1,1,1,0
"Jul 15, 2019 1:00 PM",74,33,41,,,,,,,,,,22,12,10,14,,,,13,12,1,17,19,39,19,20,26,5,2,4,1,3,3,3,0
"Jul 15, 2019 2:00 PM",45,20,25,,,,,,,,,,17,11,6,10,,,,15,13,2,10,33,32,15,17,21,3,1,4,3,1,1,0,1
"Jul 15, 2019 3:00 PM",59,26,33,,,,,,,,,,27,17,10,6,,,,29,29,0,13,35,25,4,21,26,4,1,4,3,1,0,0,0
"Jul 15, 2019 4:00 PM",144,41,103,,,,,,,,,,28,22,6,19,,,,71,66,5,29,91,52,14,38,44,8,2,4,4,0,2,1,1
"Jul 15, 2019 5:00 PM",303,59,244,,,,,,,,,,20,13,7,27,,,,146,144,2,55,209,110,23,87,79,8,4,7,3,4,0,0,0
"Jul 15, 2019 6:00 PM",318,60,258,,,,,,,,,,38,25,13,28,,,,175,168,7,48,179,114,19,95,62,3,4,4,1,3,1,1,0
"Jul 15, 2019 7:00 PM",141,52,89,,,,,,,,,,17,8,9,20,,,,78,73,5,23,79,64,19,45,59,2,7,5,1,4,2,2,0
"Jul 15, 2019 8:00 PM",95,30,65,,,,,,,,,,14,7,7,17,,,,40,39,1,26,42,44,13,31,42,4,2,3,2,1,0,0,0
"Jul 15, 2019 9:00 PM",77,17,60,,,,,,,,,,7,4,3,10,,,,33,32,1,16,28,27,13,14,26,5,1,7,4,3,2,2,0
"Jul 15, 2019 10:00 PM",39,10,29,,,,,,,,,,7,5,2,4,,,,21,20,1,6,11,10,5,5,15,1,0,2,1,1,1,1,0
"Jul 15, 2019 11:00 PM",18,3,15,,,,,,,,,,3,3,0,2,,,,11,11,0,2,11,14,10,4,5,0,0,1,1,0,1,0,1
"Jul 16, 2019 12:00 AM",7,2,5,,,,,,,,,,0,0,0,0,,,,4,4,0,2,3,1,0,1,3,0,0,2,2,0,0,0,0
"Jul 16, 2019 1:00 AM",4,0,4,,,,,,,,,,0,0,0,0,,,,4,3,1,0,0,0,0,0,0,0,1,0,0,0,0,0,0
"Jul 16, 2019 2:00 AM",3,1,2,,,,,,,,,,0,0,0,0,,,,0,0,0,0,2,1,0,1,0,0,0,0,0,0,0,0,0
"Jul 16, 2019 3:00 AM",3,2,1,,,,,,,,,,0,0,0,0,,,,0,0,0,1,1,0,0,0,1,0,0,0,0,0,0,0,0
"Jul 16, 2019 4:00 AM",4,2,2,,,,,,,,,,0,0,0,0,,,,1,1,0,2,1,0,0,0,2,1,0,0,0,0,0,0,0
"Jul 16, 2019 5:00 AM",8,6,2,,,,,,,,,,0,0,0,1,,,,1,1,0,11,2,0,0,0,15,1,0,0,0,0,0,0,0
"Jul 16, 2019 6:00 AM",54,36,18,,,,,,,,,,5,3,2,5,,,,9,9,0,29,21,14,11,3,50,1,2,4,3,1,1,0,1
"Jul 16, 2019 7:00 AM",216,161,55,,,,,,,,,,15,5,10,13,,,,37,32,5,139,48,53,37,16,216,6,4,6,5,1,2,2,0
"Jul 16, 2019 8:00 AM",372,306,66,,,,,,,,,,21,2,19,26,,,,38,29,9,240,82,119,89,30,336,1,6,7,5,2,2,1,1
"Jul 16, 2019 9:00 AM",197,153,44,,,,,,,,,,29,8,21,6,,,,31,23,8,122,29,59,41,18,108,7,9,5,4,1,1,0,1
"Jul 16, 2019 10:00 AM",55,42,13,,,,,,,,,,7,5,2,9,,,,15,12,3,32,19,18,10,8,32,3,5,7,5,2,4,2,2
"Jul 16, 2019 11:00 AM",45,27,18,,,,,,,,,,35,7,28,2,,,,11,10,1,21,17,16,6,10,16,2,0,0,0,0,1,0,1
"Jul 16, 2019 12:00 PM",35,21,14,,,,,,,,,,18,14,4,14,,,,18,16,2,20,19,25,13,12,24,2,4,6,3,3,3,1,2
"Jul 16, 2019 1:00 PM",61,24,37,,,,,,,,,,26,15,11,19,,,,17,12,5,19,18,26,6,20,26,5,3,2,2,0,0,0,0
"Jul 16, 2019 2:00 PM",46,21,25,,,,,,,,,,14,9,5,5,,,,21,19,2,7,19,16,6,10,21,2,2,1,1,0,0,0,0
"Jul 16, 2019 3:00 PM",67,29,38,,,,,,,,,,14,9,5,10,,,,21,20,1,15,28,21,5,16,23,3,1,3,3,0,3,3,0
"Jul 16, 2019 4:00 PM",147,38,109,,,,,,,,,,14,7,7,10,,,,58,56,2,34,88,59,11,48,34,4,4,5,1,4,4,2,2
"Jul 16, 2019 5:00 PM",288,61,227,,,,,,,,,,35,22,13,30,,,,176,173,3,54,213,96,24,72,72,10,4,6,3,3,1,1,0
"Jul 16, 2019 6:00 PM",346,69,277,,,,,,,,,,39,29,10,29,,,,197,190,7,40,221,109,14,95,66,9,9,9,5,4,1,1,0
"Jul 16, 2019 7:00 PM",167,37,130,,,,,,,,,,23,16,7,20,,,,72,69,3,15,90,49,5,44,51,9,6,6,5,1,2,0,2
"Jul 16, 2019 8:00 PM",118,37,81,,,,,,,,,,12,7,5,22,,,,47,45,2,24,57,31,5,26,27,3,6,9,5,4,0,0,0
"Jul 16, 2019 9:00 PM",66,15,51,,,,,,,,,,15,9,6,16,,,,28,27,1,11,24,30,13,17,21,4,5,7,4,3,0,0,0
"Jul 16, 2019 10:00 PM",38,10,28,,,,,,,,,,7,3,4,8,,,,21,19,2,3,19,11,5,6,16,2,0,0,0,0,0,0,0
"Jul 16, 2019 11:00 PM",22,4,18,,,,,,,,,,1,1,0,4,,,,11,10,1,2,7,4,2,2,10,0,0,0,0,0,1,1,0
"Jul 17, 2019 12:00 AM",4,1,3,,,,,,,,,,0,0,0,1,,,,4,4,0,1,3,1,0,1,3,2,1,0,0,0,0,0,0
"Jul 17, 2019 1:00 AM",3,0,3,,,,,,,,,,0,0,0,0,,,,3,3,0,0,0,1,1,0,1,1,0,0,0,0,0,0,0
"Jul 17, 2019 2:00 AM",2,0,2,,,,,,,,,,0,0,0,0,,,,0,0,0,1,2,0,0,0,0,0,0,0,0,0,0,0,0
"Jul 17, 2019 3:00 AM",1,1,0,,,,,,,,,,0,0,0,0,,,,0,0,0,0,1,0,0,0,1,1,0,0,0,0,0,0,0
"Jul 17, 2019 4:00 AM",4,2,2,,,,,,,,,,2,0,2,0,,,,1,1,0,1,0,0,0,0,1,0,0,0,0,0,1,1,0
"Jul 17, 2019 5:00 AM",8,5,3,,,,,,,,,,0,0,0,4,,,,2,1,1,9,2,0,0,0,17,2,0,0,0,0,0,0,0
"Jul 17, 2019 6:00 AM",62,46,16,,,,,,,,,,3,1,2,1,,,,10,9,1,33,25,8,7,1,47,2,3,4,4,0,1,0,1
"Jul 17, 2019 7:00 AM",195,152,43,,,,,,,,,,13,6,7,16,,,,24,18,6,143,30,39,29,10,184,2,5,4,3,1,3,1,2
"Jul 17, 2019 8:00 AM",374,302,72,,,,,,,,,,13,1,12,23,,,,38,24,14,237,82,90,66,24,298,4,13,5,2,3,2,1,1
"Jul 17, 2019 9:00 AM",179,152,27,,,,,,,,,,16,7,9,9,,,,21,16,5,88,39,32,16,16,86,6,3,9,7,2,1,0,1
"Jul 17, 2019 10:00 AM",40,31,9,,,,,,,,,,6,3,3,2,,,,7,5,2,17,14,6,3,3,16,1,0,2,0,2,2,2,0
"Jul 17, 2019 11:00 AM",33,25,8,,,,,,,,,,2,1,1,7,,,,10,9,1,11,12,4,4,0,18,0,1,0,0,0,1,1,0
"Jul 17, 2019 12:00 PM",49,22,27,,,,,,,,,,3,1,2,25,,,,10,9,1,20,6,11,3,8,19,1,0,2,1,1,0,0,0
"Jul 17, 2019 1:00 PM",53,15,38,,,,,,,,,,9,4,5,11,,,,15,12,3,21,16,10,6,4,22,1,1,3,2,1,0,0,0
"Jul 17, 2019 2:00 PM",39,18,21,,,,,,,,,,13,7,6,13,,,,18,14,4,12,14,10,2,8,11,3,2,1,1,0,1,1,0
"Jul 17, 2019 3:00 PM",55,18,37,,,,,,,,,,11,8,3,11,,,,28,28,0,18,21,23,5,18,21,3,2,4,3,1,1,0,1
"Jul 17, 2019 4:00 PM",125,37,88,,,,,,,,,,17,9,8,12,,,,45,42,3,23,71,28,3,25,32,4,2,5,3,2,1,1,0
"Jul 17, 2019 5:00 PM",267,59,208,,,,,,,,,,35,22,13,29,,,,136,134,2,30,182,71,14,57,86,9,5,11,6,5,3,3,0
"Jul 17, 2019 6:00 PM",280,54,226,,,,,,,,,,23,17,6,24,,,,149,147,2,45,176,80,12,68,59,5,4,3,2,1,0,0,0
"Jul 17, 2019 7:00 PM",149,37,112,,,,,,,,,,10,5,5,20,,,,77,73,4,20,75,45,11,34,23,4,7,10,3,7,2,2,0
"Jul 17, 2019 8:00 PM",90,13,77,,,,,,,,,,14,8,6,17,,,,47,44,3,9,42,28,8,20,26,2,2,12,6,6,1,0,1
"Jul 17, 2019 9:00 PM",47,14,33,,,,,,,,,,10,8,2,7,,,,38,35,3,12,20,17,4,13,16,1,1,2,0,2,3,3,0
"Jul 17, 2019 10:00 PM",40,7,33,,,,,,,,,,2,2,0,3,,,,16,16,0,2,11,14,6,8,13,3,0,2,2,0,1,1,0
"Jul 17, 2019 11:00 PM",19,2,17,,,,,,,,,,0,0,0,1,,,,8,8,0,5,8,0,0,0,2,1,0,0,0,0,0,0,0
"Jul 18, 2019 12:00 AM",11,2,9,,,,,,,,,,4,2,2,2,,,,4,4,0,3,4,2,0,2,3,2,0,1,1,0,0,0,0
"Jul 18, 2019 1:00 AM",5,1,4,,,,,,,,,,0,0,0,0,,,,4,3,1,1,2,0,0,0,1,0,0,0,0,0,0,0,0
"Jul 18, 2019 2:00 AM",1,0,1,,,,,,,,,,0,0,0,0,,,,1,1,0,1,1,0,0,0,0,0,0,0,0,0,0,0,0
"Jul 18, 2019 3:00 AM",2,1,1,,,,,,,,,,0,0,0,0,,,,0,0,0,0,0,0,0,0,2,1,0,0,0,0,0,0,0
"Jul 18, 2019 4:00 AM",5,2,3,,,,,,,,,,0,0,0,0,,,,2,2,0,1,0,0,0,0,0,0,0,0,0,0,0,0,0
"Jul 18, 2019 5:00 AM",13,11,2,,,,,,,,,,0,0,0,3,,,,2,2,0,11,2,1,1,0,21,1,0,0,0,0,0,0,0
"Jul 18, 2019 6:00 AM",51,35,16,,,,,,,,,,6,1,5,4,,,,8,6,2,35,27,8,7,1,47,0,1,3,2,1,1,0,1
"Jul 18, 2019 7:00 AM",174,128,46,,,,,,,,,,14,3,11,14,,,,27,21,6,114,40,36,28,8,177,1,4,7,6,1,3,1,2
"Jul 18, 2019 8:00 AM",337,263,74,,,,,,,,,,16,4,12,16,,,,42,31,11,229,82,83,60,23,297,2,15,3,1,2,0,0,0
"Jul 18, 2019 9:00 AM",168,133,35,,,,,,,,,,15,1,14,9,,,,26,18,8,109,26,40,24,16,87,8,7,4,3,1,1,0,1
"Jul 18, 2019 10:00 AM",35,28,7,,,,,,,,,,16,4,12,14,,,,15,12,3,18,13,15,7,8,38,0,6,6,3,3,2,1,1
"Jul 18, 2019 11:00 AM",41,31,10,,,,,,,,,,18,8,10,3,,,,7,7,0,23,18,18,12,6,13,2,3,4,2,2,2,2,0
"Jul 18, 2019 12:00 PM",42,23,19,,,,,,,,,,15,8,7,3,,,,12,11,1,21,21,20,9,11,13,2,3,5,4,1,0,0,0
"Jul 18, 2019 1:00 PM",67,26,41,,,,,,,,,,17,11,6,11,,,,24,21,3,10,28,23,11,12,37,2,4,4,1,3,2,2,0
"Jul 18, 2019 2:00 PM",50,16,34,,,,,,,,,,14,9,5,14,,,,9,9,0,15,21,30,4,26,15,7,1,4,1,3,0,0,0
"Jul 18, 2019 3:00 PM",58,27,31,,,,,,,,,,10,7,3,11,,,,23,21,2,20,32,35,13,22,26,3,5,4,4,0,1,0,1
"Jul 18, 2019 4:00 PM",120,43,77,,,,,,,,,,28,15,13,12,,,,63,61,2,25,87,42,14,28,50,8,5,3,2,1,1,1,0
"Jul 18, 2019 5:00 PM",251,53,198,,,,,,,,,,32,17,15,26,,,,131,131,0,45,207,77,13,64,68,11,7,4,3,1,0,0,0
"Jul 18, 2019 6:00 PM",277,60,217,,,,,,,,,,32,20,12,28,,,,138,135,3,41,172,88,12,76,63,6,9,5,2,3,2,0,2
"Jul 18, 2019 7:00 PM",148,36,112,,,,,,,,,,18,12,6,16,,,,71,69,2,18,76,64,14,50,46,10,3,4,3,1,0,0,0
"Jul 18, 2019 8:00 PM",89,28,61,,,,,,,,,,10,7,3,14,,,,43,40,3,28,38,35,17,18,28,5,4,12,7,5,4,4,0
"Jul 18, 2019 9:00 PM",71,13,58,,,,,,,,,,8,6,2,13,,,,20,17,3,10,23,13,5,8,31,3,1,0,0,0,0,0,0
"Jul 18, 2019 10:00 PM",37,10,27,,,,,,,,,,4,4,0,4,,,,20,17,3,5,16,9,5,4,15,1,3,0,0,0,0,0,0
"Jul 18, 2019 11:00 PM",21,5,16,,,,,,,,,,3,2,1,1,,,,13,13,0,11,7,9,3,6,7,1,2,2,1,1,1,1,0
"Jul 19, 2019 12:00 AM",13,5,8,,,,,,,,,,1,1,0,0,,,,5,5,0,4,7,2,1,1,1,0,0,1,1,0,1,0,1
"Jul 19, 2019 1:00 AM",3,0,3,,,,,,,,,,0,0,0,1,,,,1,1,0,2,7,1,0,1,2,0,1,0,0,0,0,0,0
"Jul 19, 2019 2:00 AM",0,0,0,,,,,,,,,,0,0,0,1,,,,2,2,0,2,2,0,0,0,0,1,0,0,0,0,0,0,0
"Jul 19, 2019 3:00 AM",3,1,2,,,,,,,,,,0,0,0,0,,,,2,2,0,0,2,0,0,0,0,1,0,0,0,0,0,0,0
"Jul 19, 2019 4:00 AM",2,1,1,,,,,,,,,,0,0,0,0,,,,1,1,0,0,0,0,0,0,3,0,0,0,0,0,0,0,0
"Jul 19, 2019 5:00 AM",7,7,0,,,,,,,,,,0,0,0,1,,,,1,1,0,5,0,0,0,0,8,1,0,0,0,0,0,0,0
"Jul 19, 2019 6:00 AM",31,25,6,,,,,,,,,,2,1,1,0,,,,8,5,3,13,10,4,3,1,22,1,0,6,4,2,1,0,1
"Jul 19, 2019 7:00 AM",97,73,24,,,,,,,,,,3,2,1,7,,,,11,11,0,44,21,17,11,6,84,1,4,3,2,1,0,0,0
"Jul 19, 2019 8:00 AM",205,159,46,,,,,,,,,,8,3,5,14,,,,16,13,3,122,40,46,29,17,137,2,6,4,2,2,2,1,1
"Jul 19, 2019 9:00 AM",112,92,20,,,,,,,,,,7,2,5,4,,,,17,12,5,55,24,28,21,7,78,4,3,1,0,1,0,0,0
"Jul 19, 2019 10:00 AM",31,18,13,,,,,,,,,,2,0,2,6,,,,3,1,2,16,4,7,5,2,22,1,2,5,3,2,1,1,0
"Jul 19, 2019 11:00 AM",22,12,10,,,,,,,,,,6,1,5,4,,,,6,5,1,16,10,10,5,5,20,0,0,0,0,0,0,0,0
"Jul 19, 2019 12:00 PM",29,13,16,,,,,,,,,,5,4,1,7,,,,7,6,1,12,14,6,5,1,18,3,2,3,2,1,0,0,0
"Jul 19, 2019 1:00 PM",59,19,40,,,,,,,,,,7,5,2,4,,,,16,15,1,15,12,5,0,5,25,1,3,4,1,3,0,0,0
"Jul 19, 2019 2:00 PM",43,18,25,,,,,,,,,,13,9,4,7,,,,10,9,1,8,11,16,3,13,14,1,1,0,0,0,2,2,0
"Jul 19, 2019 3:00 PM",58,22,36,,,,,,,,,,11,5,6,5,,,,15,13,2,18,26,15,4,11,21,3,2,4,3,1,1,1,0
"Jul 19, 2019 4:00 PM",96,32,64,,,,,,,,,,18,14,4,7,,,,46,45,1,13,76,25,3,22,28,5,3,5,4,1,1,1,0
"Jul 19, 2019 5:00 PM",187,40,147,,,,,,,,,,10,8,2,9,,,,80,78,2,29,101,41,7,34,35,5,2,4,4,0,0,0,0
"Jul 19, 2019 6:00 PM",123,28,95,,,,,,,,,,18,11,7,18,,,,66,64,2,22,66,31,2,29,26,3,2,8,3,5,3,2,1
"Jul 19, 2019 7:00 PM",75,18,57,,,,,,,,,,16,13,3,14,,,,33,31,2,10,33,31,14,17,22,2,4,3,1,2,2,2,0
"Jul 19, 2019 8:00 PM",50,15,35,,,,,,,,,,8,6,2,7,,,,15,15,0,8,14,15,7,8,17,5,2,10,8,2,0,0,0
"Jul 19, 2019 9:00 PM",25,10,15,,,,,,,,,,4,3,1,5,,,,16,15,1,11,14,12,4,8,9,1,0,1,0,1,3,3,0
"Jul 19, 2019 10:00 PM",26,5,21,,,,,,,,,,3,1,2,2,,,,7,7,0,4,12,3,0,3,5,2,0,0,0,0,1,1,0
"Jul 19, 2019 11:00 PM",19,4,15,,,,,,,,,,5,3,2,3,,,,7,7,0,4,6,5,3,2,2,0,0,2,1,1,0,0,0
"Jul 20, 2019 12:00 AM",16,5,11,,,,,,,,,,1,0,1,1,,,,2,2,0,3,7,1,1,0,3,0,0,0,0,0,0,0,0
"Jul 20, 2019 1:00 AM",3,1,2,,,,,,,,,,1,0,1,0,,,,2,2,0,2,2,0,0,0,1,0,1,0,0,0,0,0,0
"Jul 20, 2019 2:00 AM",5,0,5,,,,,,,,,,2,0,2,1,,,,2,2,0,1,7,1,0,1,1,1,0,1,1,0,0,0,0
"Jul 20, 2019 3:00 AM",3,1,2,,,,,,,,,,0,0,0,1,,,,2,2,0,0,0,0,0,0,0,1,2,0,0,0,0,0,0
"Jul 20, 2019 4:00 AM",5,1,4,,,,,,,,,,0,0,0,0,,,,0,0,0,1,0,0,0,0,1,0,0,0,0,0,0,0,0
"Jul 20, 2019 5:00 AM",5,2,3,,,,,,,,,,0,0,0,1,,,,5,5,0,1,0,0,0,0,0,1,0,1,0,1,0,0,0
"Jul 20, 2019 6:00 AM",15,8,7,,,,,,,,,,2,2,0,0,,,,2,2,0,1,5,2,0,2,9,0,1,0,0,0,0,0,0
"Jul 20, 2019 7:00 AM",11,8,3,,,,,,,,,,0,0,0,3,,,,3,1,2,10,14,5,2,3,9,1,2,0,0,0,0,0,0
"Jul 20, 2019 8:00 AM",33,18,15,,,,,,,,,,6,5,1,6,,,,5,5,0,13,11,4,0,4,13,0,10,2,1,1,1,0,1
"Jul 20, 2019 9:00 AM",29,20,9,,,,,,,,,,10,3,7,4,,,,12,9,3,13,20,12,5,7,21,1,3,2,2,0,0,0,0
"Jul 20, 2019 10:00 AM",41,23,18,,,,,,,,,,16,7,9,8,,,,13,7,6,21,22,13,3,10,25,4,5,3,2,1,1,1,0
"Jul 20, 2019 11:00 AM",46,30,16,,,,,,,,,,22,13,9,10,,,,9,7,2,14,21,29,8,21,20,6,10,3,2,1,0,0,0
"Jul 20, 2019 12:00 PM",35,17,18,,,,,,,,,,12,10,2,13,,,,15,13,2,24,43,27,9,18,23,5,3,1,1,0,0,0,0
"Jul 20, 2019 1:00 PM",43,19,24,,,,,,,,,,22,7,15,9,,,,14,11,3,17,31,28,13,15,28,3,4,5,4,1,1,0,1
"Jul 20, 2019 2:00 PM",49,31,18,,,,,,,,,,15,10,5,16,,,,14,12,2,16,31,31,16,15,29,6,8,1,0,1,0,0,0
"Jul 20, 2019 3:00 PM",44,20,24,,,,,,,,,,15,11,4,14,,,,22,20,2,16,27,56,15,41,20,4,1,5,1,4,1,0,1
"Jul 20, 2019 4:00 PM",49,27,22,,,,,,,,,,23,16,7,18,,,,11,8,3,9,12,38,19,19,31,4,2,2,1,1,2,2,0
"Jul 20, 2019 5:00 PM",62,26,36,,,,,,,,,,27,21,6,19,,,,20,18,2,15,30,36,23,13,30,2,3,4,2,2,0,0,0
"Jul 20, 2019 6:00 PM",45,12,33,,,,,,,,,,26,12,14,10,,,,15,14,1,7,20,16,6,10,28,3,3,6,5,1,1,0,1
"Jul 20, 2019 7:00 PM",31,11,20,,,,,,,,,,10,9,1,7,,,,11,11,0,9,10,10,4,6,15,2,2,4,2,2,2,2,0
"Jul 20, 2019 8:00 PM",24,10,14,,,,,,,,,,21,6,15,9,,,,6,5,1,6,9,12,7,5,21,1,1,2,2,0,1,0,1
"Jul 20, 2019 9:00 PM",19,12,7,,,,,,,,,,11,5,6,4,,,,9,8,1,6,6,9,7,2,15,1,0,1,0,1,1,0,1
"Jul 20, 2019 10:00 PM",16,7,9,,,,,,,,,,6,5,1,1,,,,11,11,0,5,10,1,1,0,7,0,0,3,3,0,1,0,1
"Jul 20, 2019 11:00 PM",10,1,9,,,,,,,,,,2,0,2,0,,,,5,5,0,5,3,4,3,1,4,0,2,0,0,0,0,0,0
"Jul 21, 2019 12:00 AM",6,3,3,,,,,,,,,,0,0,0,4,,,,4,4,0,5,5,1,0,1,5,0,0,0,0,0,0,0,0
"Jul 21, 2019 1:00 AM",8,4,4,,,,,,,,,,1,1,0,0,,,,0,0,0,4,2,0,0,0,4,0,1,0,0,0,0,0,0
"Jul 21, 2019 2:00 AM",3,0,3,,,,,,,,,,2,1,1,1,,,,3,3,0,1,4,0,0,0,4,0,2,0,0,0,0,0,0
"Jul 21, 2019 3:00 AM",4,0,4,,,,,,,,,,0,0,0,0,,,,3,2,1,1,1,0,0,0,1,1,0,1,0,1,1,1,0
"Jul 21, 2019 4:00 AM",4,1,3,,,,,,,,,,0,0,0,0,,,,3,3,0,0,1,0,0,0,2,0,0,0,0,0,0,0,0
"Jul 21, 2019 5:00 AM",3,1,2,,,,,,,,,,0,0,0,1,,,,1,1,0,2,1,2,0,2,2,0,0,0,0,0,0,0,0
"Jul 21, 2019 6:00 AM",6,2,4,,,,,,,,,,0,0,0,1,,,,2,2,0,3,3,4,3,1,15,1,0,0,0,0,0,0,0
"Jul 21, 2019 7:00 AM",13,9,4,,,,,,,,,,2,2,0,1,,,,6,5,1,11,15,5,0,5,15,0,7,1,1,0,1,0,1
"Jul 21, 2019 8:00 AM",19,9,10,,,,,,,,,,2,1,1,11,,,,8,7,1,7,16,19,2,17,13,0,12,3,0,3,0,0,0
"Jul 21, 2019 9:00 AM",22,17,5,,,,,,,,,,12,3,9,13,,,,13,9,4,10,24,23,11,12,17,3,16,2,2,0,1,1,0
"Jul 21, 2019 10:00 AM",40,24,16,,,,,,,,,,14,5,9,5,,,,18,13,5,12,20,30,12,18,34,7,8,3,1,2,1,0,1
"Jul 21, 2019 11:00 AM",39,26,13,,,,,,,,,,30,12,18,13,,,,6,6,0,18,17,41,18,23,25,12,5,6,3,3,1,1,0
"Jul 21, 2019 12:00 PM",43,30,13,,,,,,,,,,35,13,22,23,,,,20,19,1,16,21,46,17,29,23,9,5,0,0,0,2,0,2
"Jul 21, 2019 1:00 PM",49,26,23,,,,,,,,,,27,11,16,25,,,,14,13,1,15,42,40,12,28,27,1,8,6,5,1,2,0,2
"Jul 21, 2019 2:00 PM",46,27,19,,,,,,,,,,20,9,11,6,,,,14,13,1,10,23,38,16,22,31,3,7,4,2,2,3,0,3
"Jul 21, 2019 3:00 PM",43,21,22,,,,,,,,,,15,10,5,15,,,,11,7,4,12,33,39,19,20,34,5,3,2,1,1,0,0,0
"Jul 21, 2019 4:00 PM",30,10,20,,,,,,,,,,28,17,11,12,,,,9,9,0,10,15,19,15,4,21,3,3,0,0,0,0,0,0
"Jul 21, 2019 5:00 PM",24,8,16,,,,,,,,,,18,16,2,6,,,,14,13,1,4,11,19,10,9,21,3,0,0,0,0,0,0,0
"Jul 21, 2019 6:00 PM",16,7,9,,,,,,,,,,6,2,4,6,,,,9,7,2,5,10,7,4,3,18,1,0,0,0,0,0,0,0
"Jul 21, 2019 7:00 PM",20,9,11,,,,,,,,,,2,1,1,1,,,,11,9,2,2,9,12,6,6,17,1,1,1,0,1,1,1,0
"Jul 21, 2019 8:00 PM",18,2,16,,,,,,,,,,5,4,1,2,,,,5,5,0,4,5,2,1,1,7,0,0,1,1,0,2,1,1
"Jul 21, 2019 9:00 PM",15,4,11,,,,,,,,,,0,0,0,2,,,,1,1,0,5,4,7,5,2,6,1,0,2,0,2,1,1,0
"Jul 21, 2019 10:00 PM",15,4,11,,,,,,,,,,0,0,0,0,,,,4,4,0,3,3,3,2,1,3,1,0,2,0,2,0,0,0
"Jul 21, 2019 11:00 PM",4,1,3,,,,,,,,,,2,1,1,0,,,,3,3,0,2,1,3,1,2,0,0,1,0,0,0,0,0,0
"Jul 22, 2019 12:00 AM",3,1,2,,,,,,,,,,0,0,0,0,,,,2,1,1,3,1,2,1,1,0,0,1,0,0,0,0,0,0
"Jul 22, 2019 1:00 AM",2,1,1,,,,,,,,,,1,0,1,0,,,,1,1,0,1,2,1,0,1,1,0,0,2,0,2,0,0,0
"Jul 22, 2019 2:00 AM",1,0,1,,,,,,,,,,3,1,2,0,,,,1,1,0,0,1,0,0,0,0,1,0,0,0,0,0,0,0
"Jul 22, 2019 3:00 AM",1,0,1,,,,,,,,,,0,0,0,0,,,,0,0,0,0,0,0,0,0,0,1,0,2,1,1,0,0,0
"Jul 22, 2019 4:00 AM",3,1,2,,,,,,,,,,0,0,0,0,,,,1,1,0,1,0,0,0,0,0,1,0,0,0,0,0,0,0
"Jul 22, 2019 5:00 AM",10,7,3,,,,,,,,,,0,0,0,2,,,,0,0,0,7,1,2,1,1,11,3,0,1,1,0,0,0,0
"Jul 22, 2019 6:00 AM",41,30,11,,,,,,,,,,6,1,5,4,,,,12,9,3,27,19,11,7,4,48,1,3,3,2,1,1,0,1
"Jul 22, 2019 7:00 AM",159,115,44,,,,,,,,,,11,1,10,17,,,,18,15,3,107,30,52,39,13,172,1,11,5,4,1,3,3,0
"Jul 22, 2019 8:00 AM",336,258,78,,,,,,,,,,20,5,15,20,,,,41,30,11,257,67,81,58,23,301,3,8,9,4,5,1,0,1
"Jul 22, 2019 9:00 AM",167,137,30,,,,,,,,,,25,4,21,9,,,,23,17,6,85,27,55,32,23,108,2,4,4,2,2,0,0,0
"Jul 22, 2019 10:00 AM",52,40,12,,,,,,,,,,15,6,9,2,,,,13,9,4,33,19,19,9,10,29,2,5,4,1,3,0,0,0
"Jul 22, 2019 11:00 AM",45,34,11,,,,,,,,,,15,6,9,17,,,,13,13,0,29,17,17,8,9,20,2,3,3,2,1,0,0,0
"Jul 22, 2019 12:00 PM",34,14,20,,,,,,,,,,12,5,7,3,,,,11,10,1,23,24,22,13,9,26,1,2,6,4,2,0,0,0
"Jul 22, 2019 1:00 PM",56,24,32,,,,,,,,,,30,17,13,7,,,,20,17,3,12,27,22,7,15,30,2,3,2,0,2,0,0,0
"Jul 22, 2019 2:00 PM",56,25,31,,,,,,,,,,16,6,10,6,,,,25,22,3,8,20,36,9,27,22,6,5,4,4,0,0,0,0
"Jul 22, 2019 3:00 PM",75,32,43,,,,,,,,,,17,13,4,11,,,,34,34,0,20,27,42,12,30,27,5,1,5,3,2,0,0,0
"Jul 22, 2019 4:00 PM",118,33,85,,,,,,,,,,31,21,10,14,,,,47,44,3,27,94,74,16,58,47,5,2,5,4,1,1,1,0
"Jul 22, 2019 5:00 PM",299,55,244,,,,,,,,,,27,17,10,21,,,,164,163,1,43,273,132,33,99,91,10,6,10,5,5,3,2,1
"Jul 22, 2019 6:00 PM",287,53,234,,,,,,,,,,38,25,13,38,,,,175,170,5,40,221,156,24,132,71,11,10,8,6,2,0,0,0
"Jul 22, 2019 7:00 PM",122,42,80,,,,,,,,,,23,15,8,23,,,,68,64,4,21,106,106,30,76,63,6,4,1,0,1,1,1,0
"Jul 22, 2019 8:00 PM",107,34,73,,,,,,,,,,27,17,10,35,,,,41,37,4,28,49,88,55,33,71,5,1,2,1,1,1,1,0
"Jul 22, 2019 9:00 PM",62,11,51,,,,,,,,,,11,6,5,18,,,,22,21,1,16,15,38,29,9,54,6,1,7,2,5,0,0,0
"Jul 22, 2019 10:00 PM",37,8,29,,,,,,,,,,7,4,3,3,,,,15,12,3,6,12,6,3,3,36,1,2,2,2,0,1,0,1
"Jul 22, 2019 11:00 PM",14,6,8,,,,,,,,,,1,1,0,1,,,,8,8,0,3,6,2,1,1,6,0,0,3,1,2,0,0,0
"Jul 23, 2019 12:00 AM",11,1,10,,,,,,,,,,0,0,0,0,,,,4,4,0,0,4,0,0,0,5,0,2,0,0,0,0,0,0
"Jul 23, 2019 1:00 AM",1,0,1,,,,,,,,,,0,0,0,1,,,,2,2,0,0,2,3,2,1,1,1,0,0,0,0,0,0,0
"Jul 23, 2019 2:00 AM",3,0,3,,,,,,,,,,0,0,0,0,,,,1,0,1,0,1,1,0,1,0,0,0,0,0,0,0,0,0
"Jul 23, 2019 3:00 AM",2,2,0,,,,,,,,,,0,0,0,0,,,,0,0,0,0,0,0,0,0,2,0,0,0,0,0,0,0,0
"Jul 23, 2019 4:00 AM",2,0,2,,,,,,,,,,1,1,0,0,,,,0,0,0,1,2,0,0,0,0,0,0,0,0,0,0,0,0
"Jul 23, 2019 5:00 AM",8,6,2,,,,,,,,,,0,0,0,3,,,,1,1,0,10,1,1,1,0,18,2,0,0,0,0,0,0,0
"Jul 23, 2019 6:00 AM",66,51,15,,,,,,,,,,7,1,6,3,,,,14,11,3,41,26,16,10,6,63,0,3,5,4,1,1,0,1
"Jul 23, 2019 7:00 AM",197,150,47,,,,,,,,,,10,2,8,19,,,,39,32,7,164,51,57,38,19,217,1,8,4,3,1,0,0,0
"Jul 23, 2019 8:00 AM",378,289,89,,,,,,,,,,23,8,15,21,,,,45,34,11,263,72,104,79,25,319,4,15,5,1,4,1,0,1
"Jul 23, 2019 9:00 AM",171,143,28,,,,,,,,,,25,8,17,3,,,,26,19,7,103,34,57,30,27,112,4,5,8,5,3,3,0,3
"Jul 23, 2019 10:00 AM",52,41,11,,,,,,,,,,8,3,5,9,,,,14,12,2,26,19,26,14,12,36,1,4,1,0,1,0,0,0
"Jul 23, 2019 11:00 AM",41,24,17,,,,,,,,,,18,6,12,10,,,,4,4,0,25,19,16,9,7,25,3,0,2,2,0,1,0,1
"Jul 23, 2019 12:00 PM",51,25,26,,,,,,,,,,20,14,6,7,,,,14,13,1,25,22,31,13,18,28,5,2,3,3,0,1,0,1
"Jul 23, 2019 1:00 PM",84,33,51,,,,,,,,,,26,17,9,15,,,,16,11,5,19,32,24,7,17,34,4,0,3,1,2,0,0,0
"Jul 23, 2019 2:00 PM",43,22,21,,,,,,,,,,19,14,5,9,,,,21,19,2,16,26,35,15,20,27,1,0,2,2,0,0,0,0
"Jul 23, 2019 3:00 PM",73,27,46,,,,,,,,,,24,13,11,19,,,,28,27,1,19,41,42,16,26,33,4,2,9,7,2,1,1,0
"Jul 23, 2019 4:00 PM",123,27,96,,,,,,,,,,26,19,7,14,,,,68,64,4,25,108,85,10,75,49,3,1,5,4,1,0,0,0
"Jul 23, 2019 5:00 PM",335,66,269,,,,,,,,,,40,24,16,26,,,,159,153,6,55,277,179,43,136,100,14,11,11,9,2,1,0,1
"Jul 23, 2019 6:00 PM",297,71,226,,,,,,,,,,47,30,17,23,,,,180,175,5,45,250,153,42,111,88,11,6,7,5,2,2,2,0
"Jul 23, 2019 7:00 PM",153,36,117,,,,,,,,,,18,13,5,18,,,,80,77,3,22,94,110,50,60,82,8,10,8,3,5,4,3,1
"Jul 23, 2019 8:00 PM",119,38,81,,,,,,,,,,31,17,14,10,,,,35,34,1,25,51,48,26,22,92,7,7,3,2,1,1,1,0
"Jul 23, 2019 9:00 PM",67,16,51,,,,,,,,,,18,10,8,10,,,,33,32,1,22,20,31,22,9,49,1,1,4,2,2,3,2,1
"Jul 23, 2019 10:00 PM",35,8,27,,,,,,,,,,8,6,2,4,,,,13,13,0,8,13,13,6,7,16,4,0,2,2,0,1,0,1
"Jul 23, 2019 11:00 PM",16,4,12,,,,,,,,,,12,10,2,2,,,,11,10,1,5,7,5,1,4,6,0,1,1,1,0,1,1,0
"Jul 24, 2019 12:00 AM",8,3,5,,,,,,,,,,4,4,0,0,,,,9,9,0,3,2,0,0,0,9,0,0,0,0,0,0,0,0
"Jul 24, 2019 1:00 AM",1,0,1,,,,,,,,,,0,0,0,0,,,,1,1,0,0,5,2,1,1,1,0,0,0,0,0,0,0,0
"Jul 24, 2019 2:00 AM",2,1,1,,,,,,,,,,0,0,0,0,,,,0,0,0,0,4,0,0,0,1,1,0,0,0,0,0,0,0
"Jul 24, 2019 3:00 AM",4,4,0,,,,,,,,,,0,0,0,0,,,,0,0,0,0,1,0,0,0,0,1,0,0,0,0,0,0,0
"Jul 24, 2019 4:00 AM",2,0,2,,,,,,,,,,0,0,0,0,,,,1,1,0,1,1,0,0,0,0,0,0,0,0,0,0,0,0
"Jul 24, 2019 5:00 AM",8,6,2,,,,,,,,,,0,0,0,4,,,,1,0,1,8,0,0,0,0,13,3,0,0,0,0,0,0,0
"Jul 24, 2019 6:00 AM",65,43,22,,,,,,,,,,3,1,2,4,,,,6,6,0,37,24,11,5,6,58,0,4,5,4,1,1,0,1
"Jul 24, 2019 7:00 AM",207,160,47,,,,,,,,,,12,1,11,22,,,,30,23,7,139,39,39,30,9,197,4,4,7,5,2,2,2,0
"Jul 24, 2019 8:00 AM",374,300,74,,,,,,,,,,17,3,14,14,,,,52,36,16,248,72,107,79,28,320,5,12,15,7,8,2,1,1
"Jul 24, 2019 9:00 AM",183,151,32,,,,,,,,,,26,11,15,10,,,,26,19,7,112,33,50,30,20,104,9,6,8,4,4,2,2,0
"Jul 24, 2019 10:00 AM",67,52,15,,,,,,,,,,13,8,5,6,,,,14,8,6,28,13,13,5,8,33,0,6,4,1,3,0,0,0
"Jul 24, 2019 11:00 AM",48,34,14,,,,,,,,,,24,10,14,6,,,,10,5,5,20,23,14,5,9,25,3,3,5,2,3,0,0,0
"Jul 24, 2019 12:00 PM",47,25,22,,,,,,,,,,14,9,5,13,,,,11,10,1,19,17,15,6,9,26,2,0,7,3,4,0,0,0
"Jul 24, 2019 1:00 PM",75,26,49,,,,,,,,,,20,10,10,9,,,,16,13,3,14,18,21,7,14,35,8,2,2,2,0,0,0,0
"Jul 24, 2019 2:00 PM",55,18,37,,,,,,,,,,10,6,4,11,,,,20,19,1,16,24,32,8,24,17,6,8,3,2,1,1,0,1
"Jul 24, 2019 3:00 PM",55,22,33,,,,,,,,,,30,16,14,7,,,,25,25,0,15,29,30,7,23,26,7,4,9,7,2,2,2,0
"Jul 24, 2019 4:00 PM",127,35,92,,,,,,,,,,27,11,16,6,,,,59,55,4,29,87,69,21,48,43,8,4,9,6,3,2,2,0
"Jul 24, 2019 5:00 PM",296,50,246,,,,,,,,,,33,23,10,19,,,,148,146,2,49,203,112,20,92,91,12,6,5,3,2,3,2,1
"Jul 24, 2019 6:00 PM",284,50,234,,,,,,,,,,34,25,9,24,,,,188,184,4,44,206,127,25,102,90,7,7,6,3,3,5,5,0
"Jul 24, 2019 7:00 PM",172,34,138,,,,,,,,,,15,10,5,29,,,,79,79,0,31,88,86,37,49,58,7,6,6,5,1,0,0,0
"Jul 24, 2019 8:00 PM",95,26,69,,,,,,,,,,8,7,1,11,,,,47,44,3,20,56,42,24,18,44,5,8,7,2,5,0,0,0
"Jul 24, 2019 9:00 PM",65,12,53,,,,,,,,,,11,9,2,14,,,,36,34,2,9,22,27,12,15,39,0,4,2,1,1,1,0,1
"Jul 24, 2019 10:00 PM",42,9,33,,,,,,,,,,11,7,4,7,,,,14,13,1,7,14,5,3,2,15,4,2,3,2,1,1,0,1
"Jul 24, 2019 11:00 PM",16,2,14,,,,,,,,,,2,2,0,5,,,,10,9,1,3,10,5,4,1,6,2,1,1,1,0,0,0,0
"Jul 25, 2019 12:00 AM",9,6,3,,,,,,,,,,0,0,0,2,,,,5,5,0,4,5,4,2,2,4,0,0,0,0,0,0,0,0
"Jul 25, 2019 1:00 AM",2,0,2,,,,,,,,,,1,0,1,0,,,,5,5,0,0,2,3,0,3,4,0,0,0,0,0,0,0,0
"Jul 25, 2019 2:00 AM",0,0,0,,,,,,,,,,0,0,0,0,,,,1,1,0,0,3,0,0,0,1,1,1,0,0,0,0,0,0
"Jul 25, 2019 3:00 AM",4,2,2,,,,,,,,,,0,0,0,0,,,,0,0,0,0,0,0,0,0,1,0,0,0,0,0,0,0,0
"Jul 25, 2019 4:00 AM",1,0,1,,,,,,,,,,0,0,0,0,,,,2,2,0,1,1,0,0,0,2,1,0,0,0,0,0,0,0
"Jul 25, 2019 5:00 AM",12,7,5,,,,,,,,,,0,0,0,4,,,,1,0,1,10,4,0,0,0,11,3,0,0,0,0,0,0,0
"Jul 25, 2019 6:00 AM",50,34,16,,,,,,,,,,9,1,8,0,,,,11,11,0,24,20,9,4,5,57,1,3,7,3,4,0,0,0
"Jul 25, 2019 7:00 AM",155,120,35,,,,,,,,,,10,3,7,17,,,,27,21,6,113,48,41,32,9,181,3,4,4,4,0,1,0,1
"Jul 25, 2019 8:00 AM",353,283,70,,,,,,,,,,23,8,15,19,,,,36,26,10,221,61,78,58,20,254,2,7,7,4,3,1,0,1
"Jul 25, 2019 9:00 AM",159,124,35,,,,,,,,,,28,13,15,6,,,,27,21,6,88,32,40,25,15,97,4,6,3,1,2,1,1,0
"Jul 25, 2019 10:00 AM",56,44,12,,,,,,,,,,15,8,7,12,,,,13,10,3,32,12,11,3,8,30,1,2,5,3,2,3,2,1
"Jul 25, 2019 11:00 AM",41,25,16,,,,,,,,,,12,3,9,6,,,,10,9,1,21,10,20,11,9,24,5,2,7,3,4,0,0,0
"Jul 25, 2019 12:00 PM",50,25,25,,,,,,,,,,16,9,7,15,,,,13,10,3,21,20,16,4,12,24,5,2,6,5,1,2,2,0
"Jul 25, 2019 1:00 PM",67,25,42,,,,,,,,,,19,16,3,17,,,,10,9,1,13,13,19,5,14,25,3,3,4,0,4,0,0,0
"Jul 25, 2019 2:00 PM",61,23,38,,,,,,,,,,10,6,4,16,,,,21,19,2,22,18,17,5,12,20,2,2,3,2,1,1,0,1
"Jul 25, 2019 3:00 PM",50,22,28,,,,,,,,,,18,8,10,4,,,,36,29,7,18,34,17,5,12,19,5,2,3,2,1,0,0,0
"Jul 25, 2019 4:00 PM",109,34,75,,,,,,,,,,22,16,6,9,,,,56,55,1,36,62,53,8,45,40,4,5,6,3,3,1,1,0
"Jul 25, 2019 5:00 PM",293,62,231,,,,,,,,,,30,17,13,23,,,,119,115,4,39,179,81,16,65,68,6,7,8,5,3,0,0,0
"Jul 25, 2019 6:00 PM",249,52,197,,,,,,,,,,30,16,14,32,,,,159,155,4,33,137,75,9,66,57,6,4,3,3,0,2,2,0
"Jul 25, 2019 7:00 PM",128,32,96,,,,,,,,,,13,10,3,31,,,,65,65,0,15,80,48,15,33,31,2,2,3,1,2,1,1,0
"Jul 25, 2019 8:00 PM",100,32,68,,,,,,,,,,15,12,3,11,,,,37,36,1,19,40,31,8,23,31,6,1,2,0,2,2,2,0
"Jul 25, 2019 9:00 PM",66,5,61,,,,,,,,,,15,13,2,18,,,,26,26,0,13,24,15,8,7,28,2,2,2,2,0,1,0,1
"Jul 25, 2019 10:00 PM",31,7,24,,,,,,,,,,5,4,1,10,,,,21,20,1,8,13,12,4,8,11,0,0,0,0,0,0,0,0
"Jul 25, 2019 11:00 PM",19,5,14,,,,,,,,,,5,4,1,1,,,,16,16,0,4,7,5,2,3,3,0,0,0,0,0,1,1,0
"Jul 26, 2019 12:00 AM",11,1,10,,,,,,,,,,0,0,0,0,,,,3,3,0,4,3,1,0,1,12,0,0,0,0,0,0,0,0
"Jul 26, 2019 1:00 AM",7,1,6,,,,,,,,,,7,3,4,3,,,,2,2,0,1,6,0,0,0,0,0,0,0,0,0,0,0,0
"Jul 26, 2019 2:00 AM",2,0,2,,,,,,,,,,0,0,0,0,,,,2,2,0,0,5,0,0,0,1,0,0,0,0,0,0,0,0
"Jul 26, 2019 3:00 AM",5,1,4,,,,,,,,,,0,0,0,0,,,,1,1,0,0,1,0,0,0,1,1,0,0,0,0,0,0,0
"Jul 26, 2019 4:00 AM",4,1,3,,,,,,,,,,0,0,0,0,,,,0,0,0,1,0,0,0,0,1,0,0,0,0,0,0,0,0
"Jul 26, 2019 5:00 AM",11,8,3,,,,,,,,,,1,0,1,3,,,,3,3,0,12,1,0,0,0,10,3,0,0,0,0,0,0,0
"Jul 26, 2019 6:00 AM",52,41,11,,,,,,,,,,2,2,0,4,,,,8,6,2,28,27,13,8,5,34,1,2,3,2,1,0,0,0
"Jul 26, 2019 7:00 AM",148,114,34,,,,,,,,,,9,2,7,18,,,,21,17,4,97,23,35,21,14,132,3,4,4,3,1,1,1,0
"Jul 26, 2019 8:00 AM",273,222,51,,,,,,,,,,7,2,5,12,,,,31,22,9,186,61,70,45,25,199,3,7,2,2,0,0,0,0
"Jul 26, 2019 9:00 AM",134,103,31,,,,,,,,,,18,6,12,6,,,,22,15,7,71,33,33,22,11,106,2,3,7,2,5,2,0,2
"Jul 26, 2019 10:00 AM",52,40,12,,,,,,,,,,17,4,13,4,,,,14,11,3,28,19,17,10,7,32,2,5,2,2,0,0,0,0
"Jul 26, 2019 11:00 AM",46,26,20,,,,,,,,,,16,6,10,11,,,,8,8,0,14,18,23,5,18,21,0,0,0,0,0,1,1,0
"Jul 26, 2019 12:00 PM",46,20,26,,,,,,,,,,19,12,7,10,,,,8,7,1,22,14,24,8,16,30,2,1,4,2,2,0,0,0
"Jul 26, 2019 1:00 PM",77,23,54,,,,,,,,,,13,10,3,8,,,,16,12,4,19,26,14,4,10,27,7,3,2,2,0,0,0,0
"Jul 26, 2019 2:00 PM",69,31,38,,,,,,,,,,18,13,5,10,,,,23,20,3,14,31,27,7,20,9,2,2,0,0,0,0,0,0
"Jul 26, 2019 3:00 PM",61,18,43,,,,,,,,,,13,9,4,21,,,,41,39,2,27,44,46,8,38,29,1,5,1,1,0,2,1,1
"Jul 26, 2019 4:00 PM",144,37,107,,,,,,,,,,17,13,4,15,,,,55,54,1,16,68,51,17,34,36,5,3,2,1,1,1,1,0
"Jul 26, 2019 5:00 PM",236,56,180,,,,,,,,,,32,18,14,35,,,,120,117,3,40,149,89,24,65,65,6,1,3,2,1,0,0,0
"Jul 26, 2019 6:00 PM",180,42,138,,,,,,,,,,21,10,11,9,,,,106,102,4,33,126,79,22,57,41,5,3,3,3,0,2,1,1
"Jul 26, 2019 7:00 PM",103,32,71,,,,,,,,,,12,9,3,16,,,,38,35,3,19,53,44,21,23,48,3,6,5,4,1,0,0,0
"Jul 26, 2019 8:00 PM",56,14,42,,,,,,,,,,12,6,6,4,,,,20,20,0,9,26,20,12,8,28,1,8,4,3,1,2,1,1
"Jul 26, 2019 9:00 PM",38,10,28,,,,,,,,,,3,2,1,7,,,,12,11,1,7,14,8,5,3,20,2,1,0,0,0,0,0,0
"Jul 26, 2019 10:00 PM",22,5,17,,,,,,,,,,10,8,2,1,,,,8,7,1,7,13,11,6,5,15,0,1,3,2,1,0,0,0
"Jul 26, 2019 11:00 PM",19,1,18,,,,,,,,,,6,4,2,1,,,,8,8,0,7,5,5,1,4,8,1,1,0,0,0,1,0,1
"Jul 27, 2019 12:00 AM",9,5,4,,,,,,,,,,0,0,0,0,,,,8,8,0,4,8,6,3,3,11,0,0,0,0,0,0,0,0
"Jul 27, 2019 1:00 AM",10,1,9,,,,,,,,,,2,1,1,0,,,,7,6,1,1,1,0,0,0,3,1,1,0,0,0,0,0,0
"Jul 27, 2019 2:00 AM",7,3,4,,,,,,,,,,2,2,0,2,,,,5,5,0,0,2,3,3,0,3,1,0,0,0,0,0,0,0
"Jul 27, 2019 3:00 AM",1,1,0,,,,,,,,,,2,1,1,0,,,,6,5,1,1,4,2,0,2,3,0,2,0,0,0,0,0,0
"Jul 27, 2019 4:00 AM",7,1,6,,,,,,,,,,2,1,1,1,,,,1,1,0,1,4,0,0,0,3,0,0,0,0,0,0,0,0
"Jul 27, 2019 5:00 AM",4,0,4,,,,,,,,,,1,1,0,2,,,,2,2,0,1,2,1,0,1,3,1,0,0,0,0,0,0,0
"Jul 27, 2019 6:00 AM",12,9,3,,,,,,,,,,1,1,0,0,,,,4,4,0,7,5,3,1,2,11,1,1,0,0,0,0,0,0
"Jul 27, 2019 7:00 AM",17,8,9,,,,,,,,,,2,2,0,5,,,,5,5,0,7,23,6,1,5,11,2,11,1,1,0,0,0,0
"Jul 27, 2019 8:00 AM",27,15,12,,,,,,,,,,7,2,5,12,,,,7,7,0,15,13,16,8,8,14,5,17,2,1,1,1,0,1
"Jul 27, 2019 9:00 AM",33,20,13,,,,,,,,,,15,7,8,8,,,,15,13,2,9,31,22,6,16,32,3,5,3,3,0,0,0,0
"Jul 27, 2019 10:00 AM",37,24,13,,,,,,,,,,9,3,6,8,,,,11,9,2,15,31,18,3,15,21,7,4,2,0,2,1,1,0
"Jul 27, 2019 11:00 AM",49,26,23,,,,,,,,,,25,10,15,11,,,,14,10,4,18,36,29,7,22,36,6,4,3,0,3,1,0,1
"Jul 27, 2019 12:00 PM",46,25,21,,,,,,,,,,34,16,18,12,,,,21,19,2,14,46,36,13,23,35,17,8,1,0,1,0,0,0
"Jul 27, 2019 1:00 PM",55,27,28,,,,,,,,,,32,19,13,15,,,,18,12,6,16,43,27,10,17,44,5,6,4,3,1,0,0,0
"Jul 27, 2019 2:00 PM",53,24,29,,,,,,,,,,27,16,11,16,,,,16,16,0,27,35,35,12,23,44,5,4,1,1,0,2,0,2
"Jul 27, 2019 3:00 PM",49,17,32,,,,,,,,,,20,11,9,28,,,,13,12,1,20,34,30,14,16,38,5,8,3,2,1,0,0,0
"Jul 27, 2019 4:00 PM",38,16,22,,,,,,,,,,31,19,12,29,,,,11,9,2,17,36,58,22,36,34,4,2,3,2,1,2,2,0
"Jul 27, 2019 5:00 PM",55,22,33,,,,,,,,,,21,13,8,21,,,,21,21,0,12,27,36,21,15,53,6,3,5,5,0,0,0,0
"Jul 27, 2019 6:00 PM",35,18,17,,,,,,,,,,18,10,8,18,,,,23,23,0,24,23,40,24,16,30,3,2,4,3,1,1,1,0
"Jul 27, 2019 7:00 PM",30,19,11,,,,,,,,,,9,6,3,11,,,,13,10,3,24,16,26,12,14,28,1,2,2,0,2,0,0,0
"Jul 27, 2019 8:00 PM",40,17,23,,,,,,,,,,13,10,3,11,,,,9,8,1,12,11,11,4,7,27,2,3,1,1,0,0,0,0
"Jul 27, 2019 9:00 PM",15,3,12,,,,,,,,,,4,2,2,5,,,,6,6,0,13,8,12,8,4,16,0,0,1,1,0,0,0,0
"Jul 27, 2019 10:00 PM",18,9,9,,,,,,,,,,7,1,6,1,,,,5,2,3,3,7,6,5,1,11,0,0,1,1,0,1,1,0
"Jul 27, 2019 11:00 PM",12,3,9,,,,,,,,,,7,2,5,1,,,,7,6,1,10,4,6,3,3,6,0,0,1,1,0,0,0,0
"Jul 28, 2019 12:00 AM",12,4,8,,,,,,,,,,0,0,0,1,,,,6,6,0,3,7,5,2,3,5,1,0,0,0,0,0,0,0
"Jul 28, 2019 1:00 AM",12,5,7,,,,,,,,,,0,0,0,1,,,,4,4,0,4,1,4,3,1,4,0,1,1,1,0,0,0,0
"Jul 28, 2019 2:00 AM",4,2,2,,,,,,,,,,0,0,0,0,,,,3,3,0,5,4,2,2,0,4,0,1,0,0,0,0,0,0
"Jul 28, 2019 3:00 AM",6,1,5,,,,,,,,,,0,0,0,0,,,,3,2,1,1,1,1,0,1,1,0,1,0,0,0,0,0,0
"Jul 28, 2019 4:00 AM",9,2,7,,,,,,,,,,0,0,0,0,,,,1,1,0,0,3,0,0,0,1,0,0,0,0,0,0,0,0
"Jul 28, 2019 5:00 AM",1,0,1,,,,,,,,,,0,0,0,0,,,,2,2,0,3,5,0,0,0,1,0,0,0,0,0,0,0,0
"Jul 28, 2019 6:00 AM",7,5,2,,,,,,,,,,0,0,0,1,,,,5,5,0,3,6,1,0,1,14,2,0,1,0,1,1,1,0
"Jul 28, 2019 7:00 AM",14,8,6,,,,,,,,,,3,2,1,1,,,,5,4,1,2,23,6,1,5,21,0,3,3,1,2,0,0,0
"Jul 28, 2019 8:00 AM",34,11,23,,,,,,,,,,5,3,2,6,,,,11,8,3,8,24,17,6,11,35,0,11,0,0,0,1,0,1
"Jul 28, 2019 9:00 AM",29,20,9,,,,,,,,,,15,4,11,12,,,,7,6,1,20,43,21,10,11,33,4,18,4,3,1,1,0,1
"Jul 28, 2019 10:00 AM",40,20,20,,,,,,,,,,24,10,14,5,,,,15,11,4,17,35,45,16,29,32,6,18,3,2,1,1,1,0
"Jul 28, 2019 11:00 AM",40,25,15,,,,,,,,,,28,12,16,12,,,,13,12,1,13,50,46,18,28,45,10,5,0,0,0,1,1,0
"Jul 28, 2019 12:00 PM",40,15,25,,,,,,,,,,55,25,30,5,,,,28,23,5,27,54,71,22,49,26,10,4,4,3,1,4,2,2
"Jul 28, 2019 1:00 PM",55,33,22,,,,,,,,,,27,19,8,22,,,,20,17,3,27,47,54,19,35,44,10,13,7,4,3,2,0,2
"Jul 28, 2019 2:00 PM",42,22,20,,,,,,,,,,50,29,21,13,,,,12,11,1,26,49,57,26,31,40,12,7,0,0,0,1,1,0
"Jul 28, 2019 3:00 PM",34,15,19,,,,,,,,,,46,29,17,9,,,,19,17,2,21,30,75,26,49,25,2,1,9,5,4,2,0,2
"Jul 28, 2019 4:00 PM",38,18,20,,,,,,,,,,35,25,10,16,,,,11,11,0,16,22,41,28,13,28,6,3,2,1,1,1,0,1
"Jul 28, 2019 5:00 PM",40,17,23,,,,,,,,,,31,15,16,21,,,,13,9,4,27,17,33,20,13,46,8,7,4,1,3,1,0,1
"Jul 28, 2019 6:00 PM",44,18,26,,,,,,,,,,23,14,9,14,,,,16,15,1,14,20,47,28,19,42,3,2,9,8,1,1,0,1
"Jul 28, 2019 7:00 PM",43,24,19,,,,,,,,,,7,5,2,20,,,,15,13,2,20,19,37,24,13,35,2,2,1,0,1,0,0,0
"Jul 28, 2019 8:00 PM",38,11,27,,,,,,,,,,15,9,6,3,,,,12,12,0,20,15,15,7,8,18,4,7,1,0,1,0,0,0
"Jul 28, 2019 9:00 PM",24,9,15,,,,,,,,,,12,9,3,11,,,,8,8,0,5,5,8,3,5,16,0,0,0,0,0,0,0,0
"Jul 28, 2019 10:00 PM",19,4,15,,,,,,,,,,5,3,2,3,,,,6,6,0,3,4,6,5,1,10,0,0,0,0,0,0,0,0
"Jul 28, 2019 11:00 PM",9,4,5,,,,,,,,,,1,1,0,0,,,,5,5,0,5,4,0,0,0,1,2,1,0,0,0,0,0,0
"Jul 29, 2019 12:00 AM",7,3,4,,,,,,,,,,1,1,0,0,,,,2,2,0,3,3,0,0,0,5,0,0,0,0,0,0,0,0
"Jul 29, 2019 1:00 AM",2,1,1,,,,,,,,,,0,0,0,0,,,,0,0,0,2,0,2,1,1,0,0,1,0,0,0,0,0,0
"Jul 29, 2019 2:00 AM",2,0,2,,,,,,,,,,0,0,0,0,,,,5,4,1,1,0,0,0,0,0,1,0,0,0,0,0,0,0
"Jul 29, 2019 3:00 AM",0,0,0,,,,,,,,,,0,0,0,0,,,,0,0,0,0,0,0,0,0,0,0,0,0,0,0,0,0,0
"Jul 29, 2019 4:00 AM",4,1,3,,,,,,,,,,0,0,0,0,,,,0,0,0,1,0,1,0,1,3,1,0,0,0,0,0,0,0
"Jul 29, 2019 5:00 AM",8,6,2,,,,,,,,,,0,0,0,1,,,,1,1,0,7,4,2,0,2,20,3,0,0,0,0,0,0,0
"Jul 29, 2019 6:00 AM",51,37,14,,,,,,,,,,6,1,5,7,,,,9,7,2,28,22,13,7,6,46,2,4,3,2,1,1,0,1
"Jul 29, 2019 7:00 AM",178,132,46,,,,,,,,,,13,4,9,14,,,,35,30,5,131,45,42,29,13,196,3,7,3,2,1,2,1,1
"Jul 29, 2019 8:00 AM",359,294,65,,,,,,,,,,24,7,17,21,,,,48,32,16,253,66,93,71,22,305,4,9,3,2,1,1,0,1
"Jul 29, 2019 9:00 AM",176,148,28,,,,,,,,,,21,6,15,8,,,,24,14,10,98,36,54,33,21,121,7,5,4,3,1,1,0,1
"Jul 29, 2019 10:00 AM",44,36,8,,,,,,,,,,12,2,10,9,,,,9,6,3,37,12,27,12,15,33,5,0,2,2,0,1,0,1
"Jul 29, 2019 11:00 AM",48,29,19,,,,,,,,,,28,14,14,11,,,,14,9,5,28,26,29,9,20,24,5,2,9,6,3,3,2,1
"Jul 29, 2019 12:00 PM",44,23,21,,,,,,,,,,19,7,12,69,,,,9,9,0,21,18,23,10,13,19,0,2,3,3,0,2,0,2
"Jul 29, 2019 1:00 PM",61,33,28,,,,,,,,,,16,6,10,18,,,,16,15,1,17,33,32,18,14,29,2,2,3,1,2,6,5,1
"Jul 29, 2019 2:00 PM",53,21,32,,,,,,,,,,13,8,5,19,,,,22,19,3,16,18,19,11,8,24,1,3,1,0,1,0,0,0
"Jul 29, 2019 3:00 PM",61,20,41,,,,,,,,,,19,10,9,12,,,,30,28,2,14,24,26,11,15,30,7,2,5,3,2,0,0,0
"Jul 29, 2019 4:00 PM",111,23,88,,,,,,,,,,26,17,9,54,,,,44,44,0,22,92,49,7,42,35,6,3,8,1,7,4,2,2
"Jul 29, 2019 5:00 PM",295,48,247,,,,,,,,,,22,16,6,29,,,,160,159,1,43,210,81,9,72,74,9,2,6,3,3,11,9,2
"Jul 29, 2019 6:00 PM",327,66,261,,,,,,,,,,28,19,9,24,,,,201,197,4,45,209,94,13,81,61,9,5,8,5,3,4,2,2
"Jul 29, 2019 7:00 PM",142,30,112,,,,,,,,,,19,12,7,30,,,,81,75,6,28,67,53,14,39,31,5,5,7,5,2,6,5,1
"Jul 29, 2019 8:00 PM",71,17,54,,,,,,,,,,15,12,3,40,,,,36,36,0,18,32,28,8,20,19,6,4,6,1,5,7,7,0
"Jul 29, 2019 9:00 PM",47,13,34,,,,,,,,,,7,3,4,5,,,,20,20,0,7,18,11,5,6,19,2,2,1,1,0,0,0,0
"Jul 29, 2019 10:00 PM",25,8,17,,,,,,,,,,3,2,1,6,,,,8,8,0,4,11,0,0,0,10,3,0,2,1,1,1,0,1
"Jul 29, 2019 11:00 PM",18,4,14,,,,,,,,,,1,1,0,1,,,,3,3,0,3,5,1,1,0,0,2,0,1,0,1,0,0,0
"Jul 30, 2019 12:00 AM",7,0,7,,,,,,,,,,0,0,0,2,,,,1,1,0,5,1,2,2,0,4,0,0,2,1,1,0,0,0
"Jul 30, 2019 1:00 AM",2,1,1,,,,,,,,,,0,0,0,0,,,,1,1,0,0,1,2,0,2,0,0,2,2,1,1,1,1,0
"Jul 30, 2019 2:00 AM",2,0,2,,,,,,,,,,0,0,0,0,,,,0,0,0,0,2,0,0,0,1,0,1,0,0,0,2,0,2
"Jul 30, 2019 3:00 AM",3,2,1,,,,,,,,,,0,0,0,0,,,,1,1,0,0,0,0,0,0,0,1,0,0,0,0,0,0,0
"Jul 30, 2019 4:00 AM",5,2,3,,,,,,,,,,0,0,0,0,,,,1,1,0,1,0,0,0,0,0,0,0,0,0,0,0,0,0
"Jul 30, 2019 5:00 AM",10,7,3,,,,,,,,,,0,0,0,1,,,,1,1,0,8,3,0,0,0,19,3,0,0,0,0,0,0,0
"Jul 30, 2019 6:00 AM",51,36,15,,,,,,,,,,6,1,5,5,,,,12,10,2,33,19,2,0,2,53,2,4,4,3,1,0,0,0
"Jul 30, 2019 7:00 AM",164,122,42,,,,,,,,,,13,2,11,15,,,,34,28,6,136,46,27,20,7,170,2,4,4,3,1,1,1,0
"Jul 30, 2019 8:00 AM",344,281,63,,,,,,,,,,17,4,13,18,,,,38,27,11,219,51,78,61,17,280,3,9,4,3,1,0,0,0
"Jul 30, 2019 9:00 AM",138,109,29,,,,,,,,,,11,3,8,6,,,,23,18,5,91,24,35,19,16,79,8,4,6,4,2,0,0,0
"Jul 30, 2019 10:00 AM",41,32,9,,,,,,,,,,2,1,1,5,,,,9,3,6,29,8,18,5,13,33,3,2,6,1,5,1,1,0
"Jul 30, 2019 11:00 AM",36,23,13,,,,,,,,,,5,1,4,19,,,,6,4,2,26,11,15,9,6,19,0,1,0,0,0,0,0,0
"Jul 30, 2019 12:00 PM",28,12,16,,,,,,,,,,11,6,5,30,,,,13,13,0,14,16,10,1,9,20,3,0,4,4,0,0,0,0
"Jul 30, 2019 1:00 PM",38,11,27,,,,,,,,,,4,2,2,9,,,,8,7,1,16,14,8,2,6,20,2,0,1,0,1,0,0,0
"Jul 30, 2019 2:00 PM",27,14,13,,,,,,,,,,10,8,2,16,,,,11,10,1,8,6,9,3,6,14,2,3,5,3,2,3,2,1
"Jul 30, 2019 3:00 PM",39,13,26,,,,,,,,,,12,9,3,11,,,,31,27,4,10,16,12,4,8,13,8,3,6,5,1,2,1,1
"Jul 30, 2019 4:00 PM",101,20,81,,,,,,,,,,10,7,3,5,,,,58,57,1,17,62,25,2,23,34,3,0,3,1,2,1,1,0
"Jul 30, 2019 5:00 PM",244,41,203,,,,,,,,,,15,12,3,23,,,,112,107,5,44,144,57,8,49,63,5,5,4,3,1,0,0,0
"Jul 30, 2019 6:00 PM",229,36,193,,,,,,,,,,11,7,4,15,,,,164,156,8,38,157,46,4,42,40,9,3,3,2,1,0,0,0
"Jul 30, 2019 7:00 PM",108,21,87,,,,,,,,,,5,5,0,10,,,,79,78,1,14,67,19,2,17,19,2,4,5,1,4,2,2,0
"Jul 30, 2019 8:00 PM",62,20,42,,,,,,,,,,4,3,1,5,,,,30,27,3,8,25,17,4,13,17,3,0,3,1,2,0,0,0
"Jul 30, 2019 9:00 PM",46,9,37,,,,,,,,,,5,2,3,5,,,,24,22,2,2,24,13,4,9,15,0,1,5,2,3,0,0,0
"Jul 30, 2019 10:00 PM",31,8,23,,,,,,,,,,3,2,1,2,,,,13,13,0,6,10,6,2,4,8,1,0,1,1,0,0,0,0
"Jul 30, 2019 11:00 PM",12,1,11,,,,,,,,,,3,1,2,2,,,,3,3,0,4,6,2,1,1,1,2,0,1,0,1,0,0,0
"Jul 31, 2019 12:00 AM",5,1,4,,,,,,,,,,1,0,1,0,,,,3,3,0,2,2,1,0,1,5,0,2,0,0,0,0,0,0
"Jul 31, 2019 1:00 AM",2,1,1,,,,,,,,,,0,0,0,0,,,,1,1,0,0,2,0,0,0,1,0,0,0,0,0,0,0,0
"Jul 31, 2019 2:00 AM",3,0,3,,,,,,,,,,0,0,0,2,,,,1,1,0,0,1,0,0,0,0,0,0,0,0,0,0,0,0
"Jul 31, 2019 3:00 AM",2,1,1,,,,,,,,,,0,0,0,0,,,,0,0,0,0,0,0,0,0,1,2,0,0,0,0,0,0,0
"Jul 31, 2019 4:00 AM",3,2,1,,,,,,,,,,0,0,0,1,,,,1,1,0,0,0,0,0,0,0,0,0,0,0,0,0,0,0
"Jul 31, 2019 5:00 AM",8,5,3,,,,,,,,,,0,0,0,3,,,,1,1,0,9,3,0,0,0,11,4,0,0,0,0,0,0,0
"Jul 31, 2019 6:00 AM",58,44,14,,,,,,,,,,5,1,4,6,,,,12,10,2,31,20,5,2,3,54,2,2,4,2,2,0,0,0
"Jul 31, 2019 7:00 AM",169,137,32,,,,,,,,,,10,0,10,11,,,,34,22,12,118,34,32,22,10,168,2,6,7,5,2,0,0,0
"Jul 31, 2019 8:00 AM",352,272,80,,,,,,,,,,19,2,17,17,,,,40,29,11,222,72,86,59,27,280,4,8,9,3,6,2,0,2
"Jul 31, 2019 9:00 AM",145,126,19,,,,,,,,,,19,7,12,7,,,,27,21,6,97,25,37,22,15,89,3,8,3,3,0,4,0,4
"Jul 31, 2019 10:00 AM",57,41,16,,,,,,,,,,16,3,13,11,,,,14,11,3,30,16,14,7,7,29,3,2,12,6,6,3,0,3
"Jul 31, 2019 11:00 AM",38,21,17,,,,,,,,,,20,7,13,31,,,,8,8,0,24,17,16,8,8,21,3,1,5,1,4,4,4,0
"Jul 31, 2019 12:00 PM",46,23,23,,,,,,,,,,24,11,13,12,,,,9,6,3,18,18,11,5,6,30,2,2,2,2,0,0,0,0
"Jul 31, 2019 1:00 PM",60,21,39,,,,,,,,,,24,16,8,10,,,,17,14,3,16,21,18,4,14,31,8,1,6,5,1,0,0,0
"Jul 31, 2019 2:00 PM",47,19,28,,,,,,,,,,9,8,1,12,,,,18,14,4,19,21,24,10,14,16,6,4,4,2,2,2,1,1
"Jul 31, 2019 3:00 PM",55,19,36,,,,,,,,,,14,8,6,13,,,,26,25,1,18,32,26,8,18,18,6,4,8,4,4,1,0,1
"Jul 31, 2019 4:00 PM",125,37,88,,,,,,,,,,18,11,7,18,,,,46,44,2,32,87,33,9,24,54,9,5,4,2,2,0,0,0
"Jul 31, 2019 5:00 PM",302,63,239,,,,,,,,,,34,16,18,29,,,,115,115,0,38,177,84,19,65,74,10,4,3,3,0,0,0,0
"Jul 31, 2019 6:00 PM",273,60,213,,,,,,,,,,28,19,9,14,,,,156,156,0,43,193,83,13,70,63,8,4,5,3,2,0,0,0
"Jul 31, 2019 7:00 PM",161,45,116,,,,,,,,,,23,12,11,39,,,,88,86,2,23,90,47,9,38,41,5,4,5,2,3,3,3,0
"Jul 31, 2019 8:00 PM",81,20,61,,,,,,,,,,9,5,4,20,,,,43,41,2,21,34,29,8,21,29,4,7,2,0,2,0,0,0
"Jul 31, 2019 9:00 PM",53,16,37,,,,,,,,,,9,6,3,8,,,,37,36,1,9,30,22,12,10,30,4,4,2,0,2,0,0,0
"Jul 31, 2019 10:00 PM",39,14,25,,,,,,,,,,8,5,3,3,,,,22,21,1,8,13,6,0,6,8,4,1,0,0,0,0,0,0
"Jul 31, 2019 11:00 PM",20,5,15,,,,,,,,,,1,0,1,0,,,,12,12,0,6,4,6,2,4,9,0,1,2,2,0,0,0,0
"Aug 1, 2019 12:00 AM",9,2,7,,,,,,,,,,4,4,0,1,,,,10,9,1,7,2,0,0,0,4,0,0,1,1,0,0,0,0
"Aug 1, 2019 1:00 AM",5,2,3,,,,,,,,,,0,0,0,0,,,,1,1,0,0,3,4,2,2,0,0,0,0,0,0,0,0,0
"Aug 1, 2019 2:00 AM",4,1,3,,,,,,,,,,1,0,1,0,,,,3,3,0,0,3,1,0,1,0,2,0,0,0,0,0,0,0
"Aug 1, 2019 3:00 AM",2,1,1,,,,,,,,,,0,0,0,0,,,,1,1,0,0,0,0,0,0,0,0,0,0,0,0,0,0,0
"Aug 1, 2019 4:00 AM",3,2,1,,,,,,,,,,0,0,0,0,,,,1,1,0,1,0,1,0,1,0,0,0,0,0,0,0,0,0
"Aug 1, 2019 5:00 AM",9,9,0,,,,,,,,,,0,0,0,2,,,,1,1,0,9,3,1,0,1,14,3,0,0,0,0,0,0,0
"Aug 1, 2019 6:00 AM",49,36,13,,,,,,,,,,5,2,3,6,,,,10,9,1,37,16,7,4,3,55,1,1,3,2,1,1,0,1
"Aug 1, 2019 7:00 AM",182,135,47,,,,,,,,,,15,6,9,17,,,,39,32,7,117,46,36,27,9,162,1,4,4,3,1,1,0,1
"Aug 1, 2019 8:00 AM",306,238,68,,,,,,,,,,29,7,22,19,,,,37,25,12,224,59,90,69,21,268,3,12,5,2,3,1,1,0
"Aug 1, 2019 9:00 AM",177,150,27,,,,,,,,,,29,9,20,9,,,,23,13,10,100,25,45,27,18,98,5,6,8,4,4,1,1,0
"Aug 1, 2019 10:00 AM",63,42,21,,,,,,,,,,9,4,5,5,,,,11,8,3,33,14,19,9,10,44,3,4,4,1,3,2,0,2
"Aug 1, 2019 11:00 AM",51,24,27,,,,,,,,,,24,11,13,11,,,,14,10,4,28,15,30,12,18,24,4,2,1,0,1,0,0,0
"Aug 1, 2019 12:00 PM",54,26,28,,,,,,,,,,17,6,11,16,,,,11,10,1,20,25,24,11,13,33,8,3,5,4,1,1,1,0
"Aug 1, 2019 1:00 PM",76,35,41,,,,,,,,,,21,16,5,11,,,,18,15,3,17,39,49,16,33,36,4,3,4,4,0,0,0,0
"Aug 1, 2019 2:00 PM",55,20,35,,,,,,,,,,20,11,9,16,,,,26,24,2,20,32,24,10,14,20,6,7,5,3,2,0,0,0
"Aug 1, 2019 3:00 PM",72,23,49,,,,,,,,,,24,19,5,18,,,,27,26,1,14,40,56,15,41,32,5,2,6,4,2,0,0,0
"Aug 1, 2019 4:00 PM",120,36,84,,,,,,,,,,25,17,8,19,,,,67,62,5,29,86,56,19,37,45,7,11,4,2,2,1,1,0
"Aug 1, 2019 5:00 PM",276,66,210,,,,,,,,,,33,21,12,32,,,,136,132,4,43,187,83,19,64,84,10,4,5,3,2,0,0,0
"Aug 1, 2019 6:00 PM",253,42,211,,,,,,,,,,35,29,6,34,,,,169,165,4,37,155,93,14,79,58,5,7,9,4,5,1,1,0
"Aug 1, 2019 7:00 PM",133,36,97,,,,,,,,,,23,10,13,17,,,,71,64,7,20,69,41,7,34,37,7,2,7,3,4,2,1,1
"Aug 1, 2019 8:00 PM",84,23,61,,,,,,,,,,20,9,11,23,,,,42,42,0,16,40,33,12,21,36,10,0,4,3,1,2,2,0
"Aug 1, 2019 9:00 PM",75,29,46,,,,,,,,,,13,12,1,8,,,,35,32,3,14,25,22,17,5,20,1,1,9,4,5,1,0,1
"Aug 1, 2019 10:00 PM",37,10,27,,,,,,,,,,10,8,2,6,,,,22,21,1,8,20,21,7,14,15,0,0,1,1,0,0,0,0
"Aug 1, 2019 11:00 PM",15,1,14,,,,,,,,,,9,6,3,3,,,,10,9,1,7,4,9,5,4,6,0,2,1,0,1,0,0,0
"Aug 2, 2019 12:00 AM",13,4,9,,,,,,,,,,3,3,0,3,,,,7,7,0,8,2,2,2,0,5,0,1,1,1,0,0,0,0
"Aug 2, 2019 1:00 AM",2,0,2,,,,,,,,,,1,1,0,0,,,,0,0,0,1,4,3,0,3,1,0,2,0,0,0,1,1,0
"Aug 2, 2019 2:00 AM",8,3,5,,,,,,,,,,0,0,0,1,,,,1,1,0,0,4,0,0,0,0,1,0,0,0,0,0,0,0
"Aug 2, 2019 3:00 AM",2,2,0,,,,,,,,,,0,0,0,0,,,,1,1,0,0,1,0,0,0,1,1,0,0,0,0,0,0,0
"Aug 2, 2019 4:00 AM",4,1,3,,,,,,,,,,1,1,0,0,,,,1,1,0,0,1,1,0,1,1,0,0,0,0,0,0,0,0
"Aug 2, 2019 5:00 AM",8,6,2,,,,,,,,,,3,2,1,3,,,,1,1,0,9,5,0,0,0,10,3,0,0,0,0,0,0,0
"Aug 2, 2019 6:00 AM",45,29,16,,,,,,,,,,4,2,2,3,,,,10,6,4,27,21,7,3,4,48,1,2,4,3,1,0,0,0
"Aug 2, 2019 7:00 AM",133,98,35,,,,,,,,,,12,3,9,10,,,,27,24,3,100,32,25,14,11,115,3,4,3,3,0,0,0,0
"Aug 2, 2019 8:00 AM",269,200,69,,,,,,,,,,12,3,9,15,,,,42,26,16,168,50,54,39,15,189,3,10,7,2,5,1,0,1
"Aug 2, 2019 9:00 AM",126,103,23,,,,,,,,,,30,9,21,4,,,,19,12,7,84,29,47,24,23,85,9,9,5,4,1,0,0,0
"Aug 2, 2019 10:00 AM",50,42,8,,,,,,,,,,15,2,13,19,,,,10,9,1,28,15,23,12,11,26,2,4,5,1,4,1,1,0
"Aug 2, 2019 11:00 AM",40,23,17,,,,,,,,,,21,10,11,9,,,,14,13,1,25,23,33,14,19,24,1,2,4,3,1,0,0,0
"Aug 2, 2019 12:00 PM",54,24,30,,,,,,,,,,28,17,11,13,,,,7,6,1,24,22,38,18,20,34,6,4,4,4,0,0,0,0
"Aug 2, 2019 1:00 PM",91,36,55,,,,,,,,,,20,16,4,11,,,,22,21,1,19,35,53,19,34,36,8,2,2,1,1,0,0,0
"Aug 2, 2019 2:00 PM",61,24,37,,,,,,,,,,16,10,6,11,,,,26,22,4,16,28,37,15,22,36,3,5,4,1,3,3,1,2
"Aug 2, 2019 3:00 PM",84,26,58,,,,,,,,,,23,18,5,21,,,,43,40,3,25,54,43,14,29,39,9,1,3,2,1,1,0,1
"Aug 2, 2019 4:00 PM",165,43,122,,,,,,,,,,35,17,18,20,,,,79,76,3,27,94,81,24,57,48,17,4,10,5,5,0,0,0
"Aug 2, 2019 5:00 PM",229,45,184,,,,,,,,,,38,27,11,31,,,,126,118,8,34,156,76,28,48,66,7,7,2,0,2,0,0,0
"Aug 2, 2019 6:00 PM",174,44,130,,,,,,,,,,23,15,8,11,,,,100,93,7,20,75,65,17,48,43,6,10,7,6,1,2,0,2
"Aug 2, 2019 7:00 PM",78,35,43,,,,,,,,,,23,14,9,25,,,,42,36,6,13,46,29,10,19,16,6,3,5,4,1,2,0,2
"Aug 2, 2019 8:00 PM",49,15,34,,,,,,,,,,24,19,5,9,,,,25,25,0,8,28,27,13,14,21,2,5,4,1,3,3,2,1
"Aug 2, 2019 9:00 PM",45,12,33,,,,,,,,,,4,2,2,5,,,,15,13,2,3,19,11,7,4,20,4,3,3,2,1,0,0,0
"Aug 2, 2019 10:00 PM",17,5,12,,,,,,,,,,1,0,1,4,,,,8,8,0,7,8,8,2,6,15,0,2,0,0,0,0,0,0
"Aug 2, 2019 11:00 PM",10,2,8,,,,,,,,,,4,4,0,3,,,,9,9,0,5,4,2,2,0,4,2,0,2,1,1,1,1,0
"Aug 3, 2019 12:00 AM",10,2,8,,,,,,,,,,1,1,0,0,,,,8,7,1,6,6,5,0,5,4,1,1,0,0,0,0,0,0
"Aug 3, 2019 1:00 AM",7,2,5,,,,,,,,,,2,1,1,1,,,,5,4,1,1,2,3,0,3,2,0,1,0,0,0,0,0,0
"Aug 3, 2019 2:00 AM",2,0,2,,,,,,,,,,1,1,0,0,,,,5,5,0,1,1,1,0,1,4,0,3,0,0,0,1,0,1
"Aug 3, 2019 3:00 AM",4,1,3,,,,,,,,,,0,0,0,0,,,,2,2,0,0,3,0,0,0,1,0,0,0,0,0,0,0,0
"Aug 3, 2019 4:00 AM",4,1,3,,,,,,,,,,0,0,0,0,,,,2,2,0,0,2,1,0,1,2,0,0,0,0,0,0,0,0
"Aug 3, 2019 5:00 AM",2,2,0,,,,,,,,,,0,0,0,0,,,,2,1,1,2,5,1,1,0,1,0,0,0,0,0,0,0,0
"Aug 3, 2019 6:00 AM",10,5,5,,,,,,,,,,1,1,0,4,,,,2,2,0,8,7,4,0,4,8,1,0,0,0,0,0,0,0
"Aug 3, 2019 7:00 AM",22,13,9,,,,,,,,,,3,2,1,2,,,,3,3,0,9,12,5,2,3,7,2,2,0,0,0,1,1,0
"Aug 3, 2019 8:00 AM",23,9,14,,,,,,,,,,7,3,4,5,,,,4,3,1,15,17,8,5,3,20,2,6,3,3,0,3,1,2
"Aug 3, 2019 9:00 AM",33,20,13,,,,,,,,,,14,6,8,2,,,,14,12,2,16,20,17,9,8,17,3,3,3,2,1,0,0,0
"Aug 3, 2019 10:00 AM",34,18,16,,,,,,,,,,8,1,7,7,,,,7,5,2,12,18,13,6,7,21,8,6,3,1,2,0,0,0
"Aug 3, 2019 11:00 AM",41,14,27,,,,,,,,,,18,10,8,11,,,,11,8,3,18,25,18,7,11,22,10,9,5,3,2,0,0,0
"Aug 3, 2019 12:00 PM",45,24,21,,,,,,,,,,19,10,9,15,,,,21,15,6,17,29,24,6,18,27,6,4,5,2,3,0,0,0
"Aug 3, 2019 1:00 PM",46,23,23,,,,,,,,,,21,11,10,23,,,,14,13,1,6,18,21,5,16,23,5,4,9,6,3,0,0,0
"Aug 3, 2019 2:00 PM",36,15,21,,,,,,,,,,16,9,7,17,,,,11,10,1,10,27,25,11,14,19,9,3,4,2,2,3,2,1
"Aug 3, 2019 3:00 PM",41,20,21,,,,,,,,,,26,13,13,12,,,,23,20,3,15,24,36,7,29,36,3,7,2,1,1,2,1,1
"Aug 3, 2019 4:00 PM",29,12,17,,,,,,,,,,22,12,10,35,,,,9,8,1,9,21,26,16,10,20,4,4,0,0,0,0,0,0
"Aug 3, 2019 5:00 PM",36,13,23,,,,,,,,,,28,20,8,11,,,,19,18,1,16,17,27,13,14,23,5,3,1,0,1,1,1,0
"Aug 3, 2019 6:00 PM",35,13,22,,,,,,,,,,23,14,9,15,,,,11,11,0,8,10,26,17,9,27,3,2,3,2,1,1,1,0
"Aug 3, 2019 7:00 PM",34,22,12,,,,,,,,,,7,7,0,15,,,,11,8,3,5,17,13,7,6,11,3,2,0,0,0,0,0,0
"Aug 3, 2019 8:00 PM",20,5,15,,,,,,,,,,11,7,4,9,,,,8,8,0,2,6,10,4,6,5,0,1,1,1,0,2,1,1
"Aug 3, 2019 9:00 PM",22,13,9,,,,,,,,,,3,3,0,9,,,,4,3,1,11,8,5,4,1,8,0,0,0,0,0,0,0,0
"Aug 3, 2019 10:00 PM",14,3,11,,,,,,,,,,6,4,2,5,,,,4,4,0,3,7,3,2,1,5,0,1,0,0,0,0,0,0
"Aug 3, 2019 11:00 PM",17,2,15,,,,,,,,,,3,1,2,5,,,,6,5,1,6,5,4,1,3,10,0,0,0,0,0,1,1,0
"Aug 4, 2019 12:00 AM",6,3,3,,,,,,,,,,0,0,0,1,,,,3,2,1,1,1,2,2,0,3,0,0,0,0,0,0,0,0
"Aug 4, 2019 1:00 AM",7,0,7,,,,,,,,,,1,1,0,0,,,,1,1,0,0,1,0,0,0,2,0,1,1,1,0,1,1,0
"Aug 4, 2019 2:00 AM",3,2,1,,,,,,,,,,1,1,0,2,,,,2,2,0,0,1,0,0,0,3,0,0,1,0,1,0,0,0
"Aug 4, 2019 3:00 AM",7,0,7,,,,,,,,,,0,0,0,0,,,,0,0,0,2,3,1,0,1,0,0,2,1,0,1,0,0,0
"Aug 4, 2019 4:00 AM",1,0,1,,,,,,,,,,0,0,0,0,,,,2,2,0,1,1,0,0,0,0,0,0,0,0,0,0,0,0
"Aug 4, 2019 5:00 AM",4,3,1,,,,,,,,,,1,1,0,0,,,,1,1,0,1,1,1,1,0,1,0,0,0,0,0,0,0,0
"Aug 4, 2019 6:00 AM",8,3,5,,,,,,,,,,2,2,0,2,,,,2,2,0,3,6,2,0,2,16,2,0,0,0,0,0,0,0
"Aug 4, 2019 7:00 AM",12,3,9,,,,,,,,,,2,2,0,0,,,,7,6,1,9,18,7,2,5,13,1,2,2,2,0,0,0,0
"Aug 4, 2019 8:00 AM",14,8,6,,,,,,,,,,9,6,3,5,,,,3,1,2,2,22,9,3,6,21,1,5,4,3,1,0,0,0
"Aug 4, 2019 9:00 AM",32,19,13,,,,,,,,,,14,3,11,6,,,,15,13,2,14,33,16,6,10,26,3,10,1,1,0,0,0,0
"Aug 4, 2019 10:00 AM",41,20,21,,,,,,,,,,13,3,10,13,,,,10,8,2,14,38,18,4,14,31,2,9,1,0,1,0,0,0
"Aug 4, 2019 11:00 AM",39,23,16,,,,,,,,,,26,18,8,15,,,,18,15,3,18,30,54,20,34,55,4,4,1,1,0,1,1,0
"Aug 4, 2019 12:00 PM",58,34,24,,,,,,,,,,32,12,20,12,,,,14,12,2,14,49,32,13,19,36,12,4,3,0,3,6,3,3
"Aug 4, 2019 1:00 PM",40,13,27,,,,,,,,,,49,28,21,16,,,,18,17,1,20,18,44,14,30,23,4,3,3,1,2,1,1,0
"Aug 4, 2019 2:00 PM",39,25,14,,,,,,,,,,15,11,4,6,,,,12,11,1,15,32,39,16,23,19,6,0,9,7,2,2,0,2
"Aug 4, 2019 3:00 PM",28,14,14,,,,,,,,,,43,20,23,25,,,,11,9,2,16,35,44,20,24,24,2,6,4,2,2,1,0,1
"Aug 4, 2019 4:00 PM",29,14,15,,,,,,,,,,32,17,15,11,,,,11,11,0,14,16,43,23,20,31,4,5,3,1,2,0,0,0
"Aug 4, 2019 5:00 PM",26,10,16,,,,,,,,,,32,18,14,9,,,,6,5,1,14,11,15,12,3,23,0,0,0,0,0,1,0,1
"Aug 4, 2019 6:00 PM",44,21,23,,,,,,,,,,2,0,2,6,,,,13,13,0,12,14,21,12,9,25,1,1,3,3,0,2,0,2
"Aug 4, 2019 7:00 PM",25,8,17,,,,,,,,,,9,6,3,14,,,,10,10,0,10,8,12,6,6,13,1,2,4,1,3,1,1,0
"Aug 4, 2019 8:00 PM",22,9,13,,,,,,,,,,7,5,2,4,,,,8,5,3,3,12,2,1,1,10,0,0,2,1,1,0,0,0
"Aug 4, 2019 9:00 PM",10,4,6,,,,,,,,,,9,3,6,5,,,,2,2,0,1,4,0,0,0,8,0,0,0,0,0,0,0,0
"Aug 4, 2019 10:00 PM",6,1,5,,,,,,,,,,6,3,3,4,,,,4,3,1,4,2,2,2,0,10,0,0,0,0,0,1,0,1
"Aug 4, 2019 11:00 PM",8,2,6,,,,,,,,,,1,0,1,4,,,,3,3,0,2,6,1,0,1,9,0,0,0,0,0,0,0,0
"Aug 5, 2019 12:00 AM",3,2,1,,,,,,,,,,0,0,0,0,,,,6,6,0,2,0,0,0,0,4,0,1,0,0,0,0,0,0
"Aug 5, 2019 1:00 AM",1,0,1,,,,,,,,,,5,2,3,1,,,,2,2,0,1,3,3,0,3,0,0,1,0,0,0,0,0,0
"Aug 5, 2019 2:00 AM",2,1,1,,,,,,,,,,1,1,0,0,,,,2,2,0,1,2,0,0,0,5,0,0,0,0,0,0,0,0
"Aug 5, 2019 3:00 AM",1,0,1,,,,,,,,,,0,0,0,0,,,,0,0,0,0,0,0,0,0,0,1,0,0,0,0,1,1,0
"Aug 5, 2019 4:00 AM",2,1,1,,,,,,,,,,0,0,0,0,,,,0,0,0,0,2,1,0,1,1,0,0,0,0,0,0,0,0
"Aug 5, 2019 5:00 AM",3,1,2,,,,,,,,,,0,0,0,1,,,,1,1,0,0,5,1,1,0,0,0,0,0,0,0,0,0,0
"Aug 5, 2019 6:00 AM",8,7,1,,,,,,,,,,0,0,0,0,,,,2,2,0,6,7,1,0,1,17,3,0,2,2,0,0,0,0
"Aug 5, 2019 7:00 AM",28,17,11,,,,,,,,,,2,0,2,1,,,,9,8,1,13,7,4,0,4,23,0,2,1,0,1,0,0,0
"Aug 5, 2019 8:00 AM",37,20,17,,,,,,,,,,5,2,3,6,,,,10,8,2,12,16,12,6,6,14,5,4,2,1,1,0,0,0
"Aug 5, 2019 9:00 AM",28,16,12,,,,,,,,,,21,5,16,8,,,,7,7,0,13,30,30,7,23,19,2,11,3,3,0,0,0,0
"Aug 5, 2019 10:00 AM",31,19,12,,,,,,,,,,20,8,12,3,,,,10,8,2,16,25,36,9,27,32,7,6,7,5,2,0,0,0
"Aug 5, 2019 11:00 AM",37,20,17,,,,,,,,,,52,40,12,17,,,,11,9,2,21,24,38,22,16,26,4,8,8,4,4,6,4,2
"Aug 5, 2019 12:00 PM",36,14,22,,,,,,,,,,46,21,25,16,,,,14,12,2,12,21,59,32,27,40,10,5,0,0,0,0,0,0
"Aug 5, 2019 1:00 PM",47,27,20,,,,,,,,,,67,41,26,13,,,,8,8,0,14,29,28,8,20,40,6,4,4,4,0,0,0,0
"Aug 5, 2019 2:00 PM",41,23,18,,,,,,,,,,50,32,18,7,,,,19,19,0,16,27,42,11,31,32,8,1,0,0,0,0,0,0
"Aug 5, 2019 3:00 PM",39,19,20,,,,,,,,,,36,26,10,19,,,,24,21,3,20,42,74,22,52,33,8,5,6,4,2,0,0,0
"Aug 5, 2019 4:00 PM",48,20,28,,,,,,,,,,35,22,13,19,,,,15,14,1,16,22,73,35,38,37,5,2,3,2,1,0,0,0
"Aug 5, 2019 5:00 PM",68,35,33,,,,,,,,,,12,3,9,10,,,,23,20,3,15,21,42,25,17,32,6,4,5,4,1,0,0,0
"Aug 5, 2019 6:00 PM",37,11,26,,,,,,,,,,14,7,7,37,,,,17,14,3,15,26,48,26,22,40,7,4,6,5,1,0,0,0
"Aug 5, 2019 7:00 PM",48,18,30,,,,,,,,,,20,18,2,15,,,,12,10,2,12,22,18,11,7,23,4,3,2,1,1,0,0,0
"Aug 5, 2019 8:00 PM",31,10,21,,,,,,,,,,4,3,1,7,,,,9,8,1,9,12,14,10,4,24,1,1,0,0,0,0,0,0
"Aug 5, 2019 9:00 PM",32,9,23,,,,,,,,,,9,7,2,7,,,,9,7,2,9,4,8,5,3,7,2,0,2,1,1,0,0,0
"Aug 5, 2019 10:00 PM",9,2,7,,,,,,,,,,4,3,1,3,,,,4,3,1,8,3,6,3,3,13,1,1,4,2,2,0,0,0
"Aug 5, 2019 11:00 PM",10,5,5,,,,,,,,,,1,0,1,0,,,,5,5,0,1,9,3,2,1,4,0,0,0,0,0,0,0,0
"Aug 6, 2019 12:00 AM",1,0,1,,,,,,,,,,0,0,0,0,,,,4,4,0,2,2,1,0,1,3,0,1,0,0,0,0,0,0
"Aug 6, 2019 1:00 AM",4,1,3,,,,,,,,,,0,0,0,2,,,,2,2,0,1,2,2,1,1,1,0,0,0,0,0,0,0,0
"Aug 6, 2019 2:00 AM",2,0,2,,,,,,,,,,0,0,0,0,,,,2,2,0,0,1,0,0,0,0,0,0,0,0,0,0,0,0
"Aug 6, 2019 3:00 AM",1,1,0,,,,,,,,,,1,1,0,0,,,,0,0,0,0,0,0,0,0,0,1,0,0,0,0,0,0,0
"Aug 6, 2019 4:00 AM",2,1,1,,,,,,,,,,0,0,0,0,,,,0,0,0,0,0,3,1,2,1,0,0,0,0,0,0,0,0
"Aug 6, 2019 5:00 AM",10,8,2,,,,,,,,,,0,0,0,2,,,,0,0,0,9,3,0,0,0,17,1,0,0,0,0,0,0,0
"Aug 6, 2019 6:00 AM",53,37,16,,,,,,,,,,2,0,2,4,,,,4,2,2,24,21,8,5,3,44,2,0,2,0,2,1,0,1
"Aug 6, 2019 7:00 AM",146,110,36,,,,,,,,,,14,4,10,15,,,,34,28,6,103,30,18,14,4,135,0,3,6,4,2,0,0,0
"Aug 6, 2019 8:00 AM",296,242,54,,,,,,,,,,18,5,13,15,,,,42,23,19,223,56,71,60,11,252,1,12,3,3,0,1,0,1
"Aug 6, 2019 9:00 AM",139,110,29,,,,,,,,,,16,5,11,3,,,,20,8,12,83,27,28,13,15,92,8,8,13,10,3,0,0,0
"Aug 6, 2019 10:00 AM",53,38,15,,,,,,,,,,14,11,3,6,,,,15,8,7,26,7,14,9,5,24,3,3,1,1,0,2,0,2
"Aug 6, 2019 11:00 AM",33,21,12,,,,,,,,,,8,4,4,7,,,,8,6,2,21,11,17,8,9,30,2,4,3,3,0,3,1,2
"Aug 6, 2019 12:00 PM",28,13,15,,,,,,,,,,12,6,6,10,,,,10,9,1,13,14,16,10,6,12,5,6,4,2,2,1,1,0
"Aug 6, 2019 1:00 PM",55,23,32,,,,,,,,,,14,8,6,12,,,,23,19,4,5,20,11,4,7,13,3,1,1,1,0,0,0,0
"Aug 6, 2019 2:00 PM",33,19,14,,,,,,,,,,12,8,4,5,,,,12,12,0,14,14,23,11,12,16,4,0,4,3,1,2,0,2
"Aug 6, 2019 3:00 PM",49,22,27,,,,,,,,,,23,16,7,3,,,,37,37,0,10,24,19,5,14,18,3,1,6,3,3,1,1,0
"Aug 6, 2019 4:00 PM",120,31,89,,,,,,,,,,13,7,6,9,,,,44,42,2,22,55,29,7,22,27,9,2,2,2,0,1,1,0
"Aug 6, 2019 5:00 PM",256,52,204,,,,,,,,,,29,17,12,24,,,,129,125,4,28,168,68,13,55,56,4,3,2,0,2,0,0,0
"Aug 6, 2019 6:00 PM",274,49,225,,,,,,,,,,18,13,5,16,,,,139,136,3,41,151,68,8,60,48,4,4,6,5,1,1,0,1
"Aug 6, 2019 7:00 PM",126,28,98,,,,,,,,,,8,5,3,10,,,,76,75,1,23,68,33,8,25,18,3,3,4,3,1,0,0,0
"Aug 6, 2019 8:00 PM",61,16,45,,,,,,,,,,14,8,6,4,,,,31,31,0,13,38,20,6,14,27,1,0,3,0,3,1,1,0
"Aug 6, 2019 9:00 PM",45,10,35,,,,,,,,,,11,6,5,7,,,,25,24,1,7,15,13,4,9,10,0,0,2,1,1,4,4,0
"Aug 6, 2019 10:00 PM",25,9,16,,,,,,,,,,3,2,1,5,,,,15,15,0,4,10,6,4,2,6,0,0,1,1,0,0,0,0
"Aug 6, 2019 11:00 PM",12,2,10,,,,,,,,,,3,3,0,0,,,,5,5,0,4,1,4,0,4,3,0,0,2,1,1,0,0,0
"Aug 7, 2019 12:00 AM",9,1,8,,,,,,,,,,0,0,0,0,,,,3,2,1,3,6,0,0,0,1,0,0,1,1,0,0,0,0
"Aug 7, 2019 1:00 AM",2,0,2,,,,,,,,,,0,0,0,0,,,,0,0,0,0,0,0,0,0,2,1,0,0,0,0,0,0,0
"Aug 7, 2019 2:00 AM",2,0,2,,,,,,,,,,1,1,0,6,,,,0,0,0,0,2,0,0,0,0,1,0,0,0,0,0,0,0
"Aug 7, 2019 3:00 AM",3,2,1,,,,,,,,,,0,0,0,0,,,,1,1,0,0,0,0,0,0,0,1,0,1,0,1,0,0,0
"Aug 7, 2019 4:00 AM",3,1,2,,,,,,,,,,0,0,0,0,,,,1,1,0,0,0,0,0,0,1,0,0,0,0,0,0,0,0
"Aug 7, 2019 5:00 AM",11,8,3,,,,,,,,,,3,1,2,2,,,,0,0,0,9,6,2,1,1,14,2,0,0,0,0,0,0,0
"Aug 7, 2019 6:00 AM",58,45,13,,,,,,,,,,3,0,3,4,,,,12,9,3,29,19,6,4,2,54,4,3,2,2,0,1,0,1
"Aug 7, 2019 7:00 AM",171,129,42,,,,,,,,,,14,3,11,15,,,,26,22,4,106,37,32,26,6,181,2,3,3,2,1,1,0,1
"Aug 7, 2019 8:00 AM",326,255,71,,,,,,,,,,20,2,18,16,,,,38,27,11,236,53,75,53,22,284,2,11,2,0,2,1,0,1
"Aug 7, 2019 9:00 AM",143,119,24,,,,,,,,,,18,4,14,8,,,,17,8,9,96,20,34,14,20,95,6,8,8,5,3,4,1,3
"Aug 7, 2019 10:00 AM",46,32,14,,,,,,,,,,14,6,8,6,,,,13,9,4,26,9,17,8,9,22,4,3,8,4,4,2,1,1
"Aug 7, 2019 11:00 AM",41,31,10,,,,,,,,,,22,7,15,11,,,,13,8,5,20,14,13,8,5,26,6,1,4,3,1,1,0,1
"Aug 7, 2019 12:00 PM",32,18,14,,,,,,,,,,21,11,10,18,,,,18,14,4,24,23,16,9,7,27,1,1,4,2,2,0,0,0
"Aug 7, 2019 1:00 PM",55,20,35,,,,,,,,,,13,8,5,17,,,,15,11,4,9,22,16,6,10,25,5,4,7,4,3,4,1,3
"Aug 7, 2019 2:00 PM",44,25,19,,,,,,,,,,21,7,14,7,,,,22,21,1,15,20,12,3,9,14,2,3,1,0,1,2,2,0
"Aug 7, 2019 3:00 PM",57,17,40,,,,,,,,,,16,12,4,15,,,,18,16,2,9,27,19,5,14,19,6,3,4,4,0,1,1,0
"Aug 7, 2019 4:00 PM",122,34,88,,,,,,,,,,12,9,3,4,,,,48,46,2,16,71,59,17,42,51,7,4,4,3,1,3,3,0
"Aug 7, 2019 5:00 PM",291,54,237,,,,,,,,,,35,21,14,43,,,,134,131,3,46,176,100,27,73,76,9,2,5,2,3,1,1,0
"Aug 7, 2019 6:00 PM",270,60,210,,,,,,,,,,24,17,7,32,,,,171,170,1,50,178,86,22,64,68,9,4,13,9,4,1,0,1
"Aug 7, 2019 7:00 PM",122,35,87,,,,,,,,,,12,11,1,28,,,,75,73,2,18,77,49,13,36,48,5,5,8,3,5,4,3,1
"Aug 7, 2019 8:00 PM",82,20,62,,,,,,,,,,5,4,1,36,,,,43,39,4,21,34,39,14,25,25,2,3,3,1,2,1,1,0
"Aug 7, 2019 9:00 PM",53,17,36,,,,,,,,,,13,8,5,19,,,,30,29,1,11,19,14,6,8,28,1,1,0,0,0,0,0,0
"Aug 7, 2019 10:00 PM",34,11,23,,,,,,,,,,5,3,2,7,,,,24,24,0,4,20,3,1,2,12,2,0,1,0,1,0,0,0
"Aug 7, 2019 11:00 PM",13,2,11,,,,,,,,,,0,0,0,3,,,,10,8,2,5,6,1,0,1,3,1,1,2,1,1,1,0,1
"Aug 8, 2019 12:00 AM",7,2,5,,,,,,,,,,0,0,0,3,,,,5,5,0,5,6,0,0,0,5,1,0,1,0,1,0,0,0
"Aug 8, 2019 1:00 AM",2,0,2,,,,,,,,,,0,0,0,1,,,,1,1,0,1,3,0,0,0,2,0,0,0,0,0,0,0,0
"Aug 8, 2019 2:00 AM",0,0,0,,,,,,,,,,0,0,0,1,,,,0,0,0,0,3,0,0,0,1,1,0,0,0,0,0,0,0
"Aug 8, 2019 3:00 AM",2,1,1,,,,,,,,,,0,0,0,0,,,,1,1,0,0,0,0,0,0,0,1,0,0,0,0,0,0,0
"Aug 8, 2019 4:00 AM",3,1,2,,,,,,,,,,1,0,1,0,,,,2,2,0,1,0,0,0,0,1,0,0,0,0,0,0,0,0
"Aug 8, 2019 5:00 AM",15,11,4,,,,,,,,,,0,0,0,1,,,,0,0,0,8,5,0,0,0,17,3,0,0,0,0,0,0,0
"Aug 8, 2019 6:00 AM",47,33,14,,,,,,,,,,6,1,5,6,,,,6,4,2,33,18,10,5,5,52,1,1,1,1,0,0,0,0
"Aug 8, 2019 7:00 AM",179,132,47,,,,,,,,,,17,4,13,21,,,,24,20,4,127,37,39,29,10,159,4,6,4,2,2,3,1,2
"Aug 8, 2019 8:00 AM",321,253,68,,,,,,,,,,22,4,18,22,,,,42,31,11,216,59,82,62,20,259,1,12,2,1,1,1,1,0
"Aug 8, 2019 9:00 AM",143,116,27,,,,,,,,,,11,4,7,6,,,,19,13,6,89,22,45,17,28,112,6,7,5,3,2,0,0,0
"Aug 8, 2019 10:00 AM",44,23,21,,,,,,,,,,16,7,9,20,,,,8,7,1,37,22,16,12,4,34,4,4,5,3,2,3,1,2
"Aug 8, 2019 11:00 AM",38,22,16,,,,,,,,,,24,10,14,9,,,,12,8,4,32,17,18,12,6,25,4,5,3,2,1,0,0,0
"Aug 8, 2019 12:00 PM",31,15,16,,,,,,,,,,20,8,12,12,,,,15,10,5,24,17,22,12,10,24,5,1,3,2,1,0,0,0
"Aug 8, 2019 1:00 PM",60,22,38,,,,,,,,,,25,17,8,10,,,,18,15,3,17,25,17,8,9,23,6,4,4,2,2,0,0,0
"Aug 8, 2019 2:00 PM",51,21,30,,,,,,,,,,18,12,6,6,,,,15,13,2,13,17,22,7,15,23,6,4,4,2,2,1,0,1
"Aug 8, 2019 3:00 PM",50,16,34,,,,,,,,,,26,13,13,8,,,,24,22,2,13,33,35,7,28,30,3,2,5,2,3,0,0,0
"Aug 8, 2019 4:00 PM",125,34,91,,,,,,,,,,26,17,9,11,,,,48,48,0,30,80,42,11,31,41,12,9,5,4,1,3,2,1
"Aug 8, 2019 5:00 PM",280,64,216,,,,,,,,,,31,21,10,49,,,,137,136,1,41,188,98,19,79,79,13,6,6,5,1,1,1,0
"Aug 8, 2019 6:00 PM",267,71,196,,,,,,,,,,18,15,3,25,,,,159,153,6,34,169,100,19,81,42,8,6,4,3,1,1,0,1
"Aug 8, 2019 7:00 PM",160,41,119,,,,,,,,,,11,8,3,11,,,,80,78,2,24,77,46,18,28,34,4,5,7,4,3,0,0,0
"Aug 8, 2019 8:00 PM",92,21,71,,,,,,,,,,12,9,3,6,,,,40,40,0,20,33,18,6,12,31,8,4,9,4,5,1,1,0
"Aug 8, 2019 9:00 PM",53,14,39,,,,,,,,,,6,6,0,5,,,,19,18,1,6,18,19,10,9,18,3,1,2,1,1,0,0,0
"Aug 8, 2019 10:00 PM",24,5,19,,,,,,,,,,4,2,2,4,,,,17,17,0,8,10,6,1,5,2,1,1,1,0,1,1,1,0
"Aug 8, 2019 11:00 PM",18,2,16,,,,,,,,,,0,0,0,1,,,,13,12,1,4,5,1,0,1,3,1,1,2,1,1,0,0,0
"Aug 9, 2019 12:00 AM",8,1,7,,,,,,,,,,1,1,0,0,,,,6,6,0,4,0,1,0,1,4,0,0,0,0,0,0,0,0
"Aug 9, 2019 1:00 AM",3,1,2,,,,,,,,,,0,0,0,0,,,,1,1,0,0,2,0,0,0,0,0,0,0,0,0,0,0,0
"Aug 9, 2019 2:00 AM",1,1,0,,,,,,,,,,0,0,0,0,,,,1,1,0,0,4,0,0,0,0,0,0,1,0,1,0,0,0
"Aug 9, 2019 3:00 AM",1,1,0,,,,,,,,,,0,0,0,0,,,,2,2,0,0,0,0,0,0,0,0,0,0,0,0,0,0,0
"Aug 9, 2019 4:00 AM",1,0,1,,,,,,,,,,0,0,0,0,,,,0,0,0,1,0,0,0,0,1,1,0,0,0,0,0,0,0
"Aug 9, 2019 5:00 AM",6,6,0,,,,,,,,,,0,0,0,1,,,,0,0,0,8,3,1,0,1,13,1,0,0,0,0,0,0,0
"Aug 9, 2019 6:00 AM",34,23,11,,,,,,,,,,2,0,2,6,,,,10,7,3,23,15,1,1,0,48,1,2,2,1,1,0,0,0
"Aug 9, 2019 7:00 AM",115,85,30,,,,,,,,,,12,7,5,9,,,,17,13,4,79,19,23,14,9,85,2,2,4,3,1,0,0,0
"Aug 9, 2019 8:00 AM",209,164,45,,,,,,,,,,15,1,14,10,,,,27,23,4,127,52,52,37,15,174,1,6,4,2,2,1,0,1
"Aug 9, 2019 9:00 AM",123,100,23,,,,,,,,,,16,3,13,6,,,,23,16,7,73,18,25,13,12,71,4,7,6,2,4,0,0,0
"Aug 9, 2019 10:00 AM",39,24,15,,,,,,,,,,8,5,3,2,,,,7,6,1,10,11,9,4,5,19,0,3,1,0,1,0,0,0
"Aug 9, 2019 11:00 AM",21,11,10,,,,,,,,,,4,3,1,3,,,,5,5,0,10,13,4,3,1,16,1,0,2,2,0,0,0,0
"Aug 9, 2019 12:00 PM",28,16,12,,,,,,,,,,7,3,4,8,,,,7,6,1,6,12,8,4,4,17,3,2,1,1,0,0,0,0
"Aug 9, 2019 1:00 PM",57,21,36,,,,,,,,,,1,1,0,10,,,,16,15,1,8,22,10,3,7,19,2,0,3,3,0,0,0,0
"Aug 9, 2019 2:00 PM",34,17,17,,,,,,,,,,6,4,2,10,,,,18,18,0,7,14,14,3,11,17,2,0,1,0,1,0,0,0
"Aug 9, 2019 3:00 PM",57,19,38,,,,,,,,,,11,6,5,7,,,,19,17,2,10,19,7,5,2,13,2,0,1,0,1,0,0,0
"Aug 9, 2019 4:00 PM",91,25,66,,,,,,,,,,14,7,7,8,,,,42,40,2,17,54,25,4,21,19,4,2,2,1,1,0,0,0
"Aug 9, 2019 5:00 PM",189,28,161,,,,,,,,,,10,8,2,12,,,,83,80,3,22,96,32,7,25,37,3,0,1,1,0,0,0,0
"Aug 9, 2019 6:00 PM",144,29,115,,,,,,,,,,6,5,1,10,,,,96,95,1,11,80,32,3,29,27,5,1,1,0,1,0,0,0
"Aug 9, 2019 7:00 PM",55,16,39,,,,,,,,,,7,3,4,8,,,,26,26,0,13,46,8,0,8,18,2,3,2,1,1,1,1,0
"Aug 9, 2019 8:00 PM",39,11,28,,,,,,,,,,7,4,3,6,,,,18,17,1,5,26,6,2,4,10,0,1,1,0,1,0,0,0
"Aug 9, 2019 9:00 PM",18,4,14,,,,,,,,,,3,2,1,0,,,,11,10,1,3,11,8,1,7,11,0,0,1,1,0,5,2,3
"Aug 9, 2019 10:00 PM",19,5,14,,,,,,,,,,2,1,1,4,,,,11,10,1,5,10,2,1,1,2,0,0,0,0,0,1,1,0
"Aug 9, 2019 11:00 PM",9,1,8,,,,,,,,,,1,0,1,3,,,,5,5,0,4,6,2,1,1,1,0,0,1,0,1,1,1,0
"Aug 10, 2019 12:00 AM",5,3,2,,,,,,,,,,0,0,0,0,,,,3,2,1,2,1,1,1,0,3,0,0,1,0,1,0,0,0
"Aug 10, 2019 1:00 AM",10,0,10,,,,,,,,,,0,0,0,0,,,,5,5,0,1,6,1,0,1,2,0,1,1,1,0,0,0,0
"Aug 10, 2019 2:00 AM",7,2,5,,,,,,,,,,0,0,0,0,,,,1,1,0,2,1,1,1,0,0,0,0,1,0,1,1,1,0
"Aug 10, 2019 3:00 AM",5,1,4,,,,,,,,,,2,2,0,0,,,,2,2,0,1,1,0,0,0,0,1,0,0,0,0,0,0,0
"Aug 10, 2019 4:00 AM",3,0,3,,,,,,,,,,0,0,0,0,,,,1,1,0,0,0,0,0,0,0,0,0,2,1,1,0,0,0
"Aug 10, 2019 5:00 AM",1,0,1,,,,,,,,,,0,0,0,0,,,,1,1,0,3,2,1,1,0,4,0,0,0,0,0,0,0,0
"Aug 10, 2019 6:00 AM",11,6,5,,,,,,,,,,1,1,0,0,,,,3,2,1,5,9,3,0,3,10,1,2,0,0,0,0,0,0
"Aug 10, 2019 7:00 AM",13,10,3,,,,,,,,,,4,4,0,3,,,,5,3,2,10,12,4,0,4,12,2,3,1,1,0,1,1,0
"Aug 10, 2019 8:00 AM",25,12,13,,,,,,,,,,7,2,5,1,,,,6,4,2,9,13,6,3,3,12,0,4,3,0,3,1,1,0
"Aug 10, 2019 9:00 AM",29,21,8,,,,,,,,,,5,3,2,2,,,,8,6,2,15,17,7,3,4,23,0,3,1,1,0,0,0,0
"Aug 10, 2019 10:00 AM",32,21,11,,,,,,,,,,11,3,8,3,,,,13,8,5,17,10,13,5,8,15,5,8,3,2,1,0,0,0
"Aug 10, 2019 11:00 AM",34,20,14,,,,,,,,,,9,1,8,8,,,,10,8,2,9,24,12,2,10,20,4,3,8,5,3,0,0,0
"Aug 10, 2019 12:00 PM",49,27,22,,,,,,,,,,12,2,10,9,,,,12,12,0,16,15,21,12,9,21,3,4,7,4,3,2,1,1
"Aug 10, 2019 1:00 PM",36,26,10,,,,,,,,,,17,9,8,12,,,,11,11,0,18,19,8,5,3,14,4,2,2,1,1,1,1,0
"Aug 10, 2019 2:00 PM",45,21,24,,,,,,,,,,10,9,1,9,,,,9,7,2,8,10,8,2,6,15,2,2,1,0,1,0,0,0
"Aug 10, 2019 3:00 PM",27,8,19,,,,,,,,,,17,10,7,6,,,,10,8,2,14,8,10,6,4,18,0,2,0,0,0,0,0,0
"Aug 10, 2019 4:00 PM",43,15,28,,,,,,,,,,9,2,7,8,,,,12,11,1,10,8,12,2,10,6,3,2,3,2,1,1,1,0
"Aug 10, 2019 5:00 PM",32,11,21,,,,,,,,,,12,8,4,12,,,,6,6,0,6,15,11,4,7,26,3,1,3,1,2,2,2,0
"Aug 10, 2019 6:00 PM",27,12,15,,,,,,,,,,8,4,4,9,,,,13,10,3,7,5,8,0,8,10,0,2,2,1,1,2,0,2
"Aug 10, 2019 7:00 PM",22,11,11,,,,,,,,,,3,1,2,4,,,,10,10,0,6,11,7,3,4,9,1,0,6,2,4,2,2,0
"Aug 10, 2019 8:00 PM",20,6,14,,,,,,,,,,3,3,0,6,,,,2,2,0,3,15,7,1,6,9,1,0,2,1,1,0,0,0
"Aug 10, 2019 9:00 PM",20,7,13,,,,,,,,,,0,0,0,1,,,,6,6,0,1,6,7,3,4,6,2,0,0,0,0,0,0,0
"Aug 10, 2019 10:00 PM",6,2,4,,,,,,,,,,0,0,0,1,,,,8,8,0,3,7,0,0,0,6,0,0,1,0,1,1,0,1
"Aug 10, 2019 11:00 PM",6,3,3,,,,,,,,,,0,0,0,0,,,,2,2,0,2,4,0,0,0,4,0,0,1,1,0,1,0,1
"Aug 11, 2019 12:00 AM",3,3,0,,,,,,,,,,2,2,0,1,,,,1,1,0,5,1,1,1,0,1,0,0,1,1,0,0,0,0
"Aug 11, 2019 1:00 AM",5,0,5,,,,,,,,,,0,0,0,1,,,,1,1,0,2,1,2,1,1,2,0,0,0,0,0,0,0,0
"Aug 11, 2019 2:00 AM",2,0,2,,,,,,,,,,0,0,0,1,,,,1,1,0,1,3,0,0,0,2,0,2,0,0,0,0,0,0
"Aug 11, 2019 3:00 AM",2,0,2,,,,,,,,,,0,0,0,1,,,,1,1,0,2,1,0,0,0,0,0,2,0,0,0,0,0,0
"Aug 11, 2019 4:00 AM",3,0,3,,,,,,,,,,0,0,0,0,,,,2,2,0,0,2,0,0,0,0,0,0,0,0,0,0,0,0
"Aug 11, 2019 5:00 AM",3,0,3,,,,,,,,,,0,0,0,1,,,,0,0,0,1,1,1,1,0,0,0,0,0,0,0,0,0,0
"Aug 11, 2019 6:00 AM",6,4,2,,,,,,,,,,0,0,0,0,,,,4,4,0,3,5,0,0,0,10,1,0,0,0,0,0,0,0
"Aug 11, 2019 7:00 AM",17,9,8,,,,,,,,,,0,0,0,1,,,,2,2,0,5,15,4,1,3,6,2,4,0,0,0,1,1,0
"Aug 11, 2019 8:00 AM",23,9,14,,,,,,,,,,5,4,1,6,,,,4,3,1,5,10,10,3,7,14,0,9,1,0,1,0,0,0
"Aug 11, 2019 9:00 AM",31,14,17,,,,,,,,,,7,0,7,6,,,,15,12,3,10,13,8,4,4,16,2,14,0,0,0,0,0,0
"Aug 11, 2019 10:00 AM",31,19,12,,,,,,,,,,11,4,7,12,,,,7,4,3,13,14,18,6,12,20,2,9,3,1,2,2,2,0
"Aug 11, 2019 11:00 AM",34,23,11,,,,,,,,,,19,6,13,10,,,,10,7,3,13,20,36,11,25,26,7,4,7,5,2,0,0,0
"Aug 11, 2019 12:00 PM",36,8,28,,,,,,,,,,29,11,18,11,,,,12,12,0,15,22,25,13,12,23,18,5,4,3,1,1,0,1
"Aug 11, 2019 1:00 PM",42,21,21,,,,,,,,,,63,30,33,18,,,,21,21,0,18,27,28,12,16,21,12,3,6,3,3,0,0,0
"Aug 11, 2019 2:00 PM",36,17,19,,,,,,,,,,33,12,21,18,,,,20,14,6,8,30,27,13,14,26,5,4,1,1,0,1,1,0
"Aug 11, 2019 3:00 PM",39,18,21,,,,,,,,,,34,13,21,8,,,,16,14,2,24,20,14,3,11,28,11,6,10,9,1,2,0,2
"Aug 11, 2019 4:00 PM",36,24,12,,,,,,,,,,23,13,10,14,,,,14,14,0,14,13,30,10,20,34,5,5,2,0,2,0,0,0
"Aug 11, 2019 5:00 PM",41,18,23,,,,,,,,,,17,14,3,14,,,,16,13,3,12,20,25,12,13,19,6,4,6,4,2,0,0,0
"Aug 11, 2019 6:00 PM",43,15,28,,,,,,,,,,30,22,8,31,,,,19,19,0,10,18,24,9,15,29,4,2,5,4,1,2,2,0
"Aug 11, 2019 7:00 PM",35,10,25,,,,,,,,,,14,8,6,11,,,,10,8,2,10,11,11,4,7,16,3,1,1,1,0,0,0,0
"Aug 11, 2019 8:00 PM",23,8,15,,,,,,,,,,9,6,3,7,,,,10,9,1,16,11,14,9,5,10,3,0,1,0,1,1,1,0
"Aug 11, 2019 9:00 PM",17,5,12,,,,,,,,,,7,4,3,2,,,,7,6,1,6,6,6,5,1,7,2,1,0,0,0,1,1,0
"Aug 11, 2019 10:00 PM",7,3,4,,,,,,,,,,6,3,3,1,,,,5,3,2,5,9,2,1,1,10,0,0,0,0,0,0,0,0
"Aug 11, 2019 11:00 PM",8,3,5,,,,,,,,,,2,1,1,1,,,,3,3,0,2,3,1,1,0,4,0,0,2,1,1,0,0,0
"Aug 12, 2019 12:00 AM",3,2,1,,,,,,,,,,1,1,0,0,,,,3,3,0,1,1,0,0,0,1,0,0,0,0,0,0,0,0
"Aug 12, 2019 1:00 AM",1,0,1,,,,,,,,,,0,0,0,0,,,,2,2,0,1,4,1,1,0,2,0,1,0,0,0,0,0,0
"Aug 12, 2019 2:00 AM",2,0,2,,,,,,,,,,0,0,0,0,,,,1,1,0,0,1,0,0,0,0,1,0,0,0,0,0,0,0
"Aug 12, 2019 3:00 AM",1,0,1,,,,,,,,,,3,1,2,1,,,,0,0,0,0,0,0,0,0,0,0,0,0,0,0,0,0,0
"Aug 12, 2019 4:00 AM",1,0,1,,,,,,,,,,0,0,0,0,,,,1,1,0,1,2,0,0,0,1,0,0,0,0,0,0,0,0
"Aug 12, 2019 5:00 AM",6,4,2,,,,,,,,,,0,0,0,4,,,,2,2,0,5,3,2,2,0,14,2,0,0,0,0,0,0,0
"Aug 12, 2019 6:00 AM",47,25,22,,,,,,,,,,3,0,3,6,,,,2,2,0,37,15,8,5,3,56,1,1,2,0,2,1,0,1
"Aug 12, 2019 7:00 AM",164,127,37,,,,,,,,,,8,1,7,10,,,,34,28,6,118,35,35,23,12,155,2,8,8,6,2,1,0,1
"Aug 12, 2019 8:00 AM",348,269,79,,,,,,,,,,21,2,19,22,,,,38,25,13,239,63,83,65,18,309,4,5,6,4,2,0,0,0
"Aug 12, 2019 9:00 AM",153,120,33,,,,,,,,,,20,9,11,3,,,,23,16,7,86,32,49,29,20,88,9,7,10,7,3,3,0,3
"Aug 12, 2019 10:00 AM",58,38,20,,,,,,,,,,12,3,9,4,,,,8,8,0,30,13,26,13,13,28,3,3,6,3,3,1,1,0
"Aug 12, 2019 11:00 AM",34,19,15,,,,,,,,,,18,8,10,12,,,,13,9,4,21,16,21,8,13,32,3,4,6,4,2,0,0,0
"Aug 12, 2019 12:00 PM",42,18,24,,,,,,,,,,32,12,20,14,,,,10,9,1,24,15,15,9,6,25,4,2,4,2,2,0,0,0
"Aug 12, 2019 1:00 PM",63,28,35,,,,,,,,,,29,18,11,18,,,,16,13,3,15,29,22,12,10,24,4,0,7,3,4,0,0,0
"Aug 12, 2019 2:00 PM",51,26,25,,,,,,,,,,15,8,7,21,,,,21,20,1,12,26,25,6,19,14,2,3,4,1,3,2,1,1
"Aug 12, 2019 3:00 PM",47,27,20,,,,,,,,,,20,11,9,7,,,,30,27,3,9,24,14,5,9,19,4,3,8,6,2,1,0,1
"Aug 12, 2019 4:00 PM",101,32,69,,,,,,,,,,9,6,3,19,,,,50,48,2,23,61,26,4,22,33,3,1,2,2,0,2,2,0
"Aug 12, 2019 5:00 PM",233,39,194,,,,,,,,,,25,21,4,23,,,,119,116,3,32,167,62,11,51,57,7,2,8,6,2,1,1,0
"Aug 12, 2019 6:00 PM",294,38,256,,,,,,,,,,28,19,9,21,,,,172,169,3,39,201,69,10,59,66,6,4,3,1,2,3,2,1
"Aug 12, 2019 7:00 PM",110,30,80,,,,,,,,,,10,7,3,11,,,,60,60,0,18,75,37,2,35,16,4,4,5,4,1,0,0,0
"Aug 12, 2019 8:00 PM",73,19,54,,,,,,,,,,13,9,4,12,,,,45,44,1,11,33,14,3,11,14,4,4,6,2,4,0,0,0
"Aug 12, 2019 9:00 PM",43,12,31,,,,,,,,,,6,5,1,9,,,,18,18,0,14,19,8,3,5,14,2,0,2,1,1,3,3,0
"Aug 12, 2019 10:00 PM",14,1,13,,,,,,,,,,2,1,1,3,,,,10,10,0,4,9,8,1,7,5,1,1,0,0,0,0,0,0
"Aug 12, 2019 11:00 PM",10,3,7,,,,,,,,,,2,2,0,4,,,,8,7,1,4,3,4,1,3,3,1,0,1,0,1,1,1,0
"Aug 13, 2019 12:00 AM",6,0,6,,,,,,,,,,1,1,0,0,,,,4,4,0,2,3,0,0,0,4,0,1,1,1,0,0,0,0
"Aug 13, 2019 1:00 AM",6,1,5,,,,,,,,,,3,2,1,0,,,,0,0,0,0,0,2,1,1,0,0,0,0,0,0,0,0,0
"Aug 13, 2019 2:00 AM",0,0,0,,,,,,,,,,0,0,0,0,,,,1,1,0,0,1,0,0,0,0,0,0,0,0,0,0,0,0
"Aug 13, 2019 3:00 AM",1,1,0,,,,,,,,,,0,0,0,0,,,,0,0,0,0,0,0,0,0,1,1,0,0,0,0,0,0,0
"Aug 13, 2019 4:00 AM",2,1,1,,,,,,,,,,0,0,0,1,,,,0,0,0,1,0,0,0,0,0,0,0,0,0,0,0,0,0
"Aug 13, 2019 5:00 AM",9,7,2,,,,,,,,,,3,2,1,4,,,,3,3,0,8,3,0,0,0,11,1,0,0,0,0,0,0,0
"Aug 13, 2019 6:00 AM",57,40,17,,,,,,,,,,4,1,3,4,,,,6,5,1,34,15,5,1,4,63,1,4,3,1,2,0,0,0
"Aug 13, 2019 7:00 AM",180,129,51,,,,,,,,,,13,3,10,18,,,,40,30,10,139,45,36,29,7,176,1,6,4,3,1,0,0,0
"Aug 13, 2019 8:00 AM",335,251,84,,,,,,,,,,28,4,24,24,,,,50,32,18,242,58,87,61,26,278,6,13,6,4,2,1,1,0
"Aug 13, 2019 9:00 AM",161,129,32,,,,,,,,,,38,11,27,4,,,,25,18,7,84,37,42,28,14,97,5,4,8,7,1,4,1,3
"Aug 13, 2019 10:00 AM",55,38,17,,,,,,,,,,19,6,13,3,,,,13,11,2,31,13,18,11,7,27,3,1,1,0,1,0,0,0
"Aug 13, 2019 11:00 AM",41,31,10,,,,,,,,,,22,12,10,21,,,,3,3,0,28,18,14,6,8,24,1,2,1,0,1,0,0,0
"Aug 13, 2019 12:00 PM",42,20,22,,,,,,,,,,24,11,13,8,,,,14,13,1,18,19,25,8,17,33,6,2,2,1,1,0,0,0
"Aug 13, 2019 1:00 PM",55,15,40,,,,,,,,,,24,14,10,6,,,,21,16,5,9,26,18,11,7,33,4,4,5,3,2,1,1,0
"Aug 13, 2019 2:00 PM",49,33,16,,,,,,,,,,23,18,5,29,,,,11,9,2,11,18,21,7,14,19,7,0,6,4,2,4,4,0
"Aug 13, 2019 3:00 PM",54,18,36,,,,,,,,,,15,8,7,7,,,,27,23,4,17,25,21,7,14,16,5,2,11,6,5,4,1,3
"Aug 13, 2019 4:00 PM",109,29,80,,,,,,,,,,23,16,7,10,,,,48,46,2,25,64,28,10,18,39,6,3,7,3,4,2,2,0
"Aug 13, 2019 5:00 PM",266,55,211,,,,,,,,,,17,12,5,22,,,,130,125,5,36,179,69,8,61,66,5,2,3,2,1,0,0,0
"Aug 13, 2019 6:00 PM",290,50,240,,,,,,,,,,20,14,6,20,,,,191,187,4,35,174,74,8,66,45,6,4,4,3,1,0,0,0
"Aug 13, 2019 7:00 PM",141,46,95,,,,,,,,,,5,5,0,18,,,,75,71,4,17,91,30,2,28,28,3,6,5,2,3,2,2,0
"Aug 13, 2019 8:00 PM",78,23,55,,,,,,,,,,10,7,3,22,,,,42,42,0,14,34,19,7,12,24,3,5,6,3,3,1,1,0
"Aug 13, 2019 9:00 PM",43,9,34,,,,,,,,,,5,4,1,7,,,,26,26,0,12,27,8,1,7,15,4,2,3,3,0,0,0,0
"Aug 13, 2019 10:00 PM",22,6,16,,,,,,,,,,1,1,0,3,,,,15,14,1,5,6,2,1,1,8,2,0,0,0,0,1,0,1
"Aug 13, 2019 11:00 PM",6,2,4,,,,,,,,,,1,1,0,3,,,,8,8,0,6,4,4,2,2,5,0,0,0,0,0,0,0,0
"Aug 14, 2019 12:00 AM",1,1,0,,,,,,,,,,0,0,0,1,,,,1,1,0,2,2,2,0,2,3,0,1,1,1,0,0,0,0
"Aug 14, 2019 1:00 AM",0,0,0,,,,,,,,,,0,0,0,0,,,,2,2,0,0,1,0,0,0,0,0,0,0,0,0,0,0,0
"Aug 14, 2019 2:00 AM",5,3,2,,,,,,,,,,0,0,0,0,,,,2,2,0,0,1,0,0,0,0,0,0,0,0,0,0,0,0
"Aug 14, 2019 3:00 AM",1,1,0,,,,,,,,,,0,0,0,0,,,,0,0,0,0,1,0,0,0,0,1,0,1,0,1,0,0,0
"Aug 14, 2019 4:00 AM",3,2,1,,,,,,,,,,1,0,1,0,,,,2,2,0,1,0,0,0,0,1,0,0,0,0,0,0,0,0
"Aug 14, 2019 5:00 AM",5,5,0,,,,,,,,,,1,0,1,4,,,,1,1,0,6,3,0,0,0,10,2,0,0,0,0,0,0,0
"Aug 14, 2019 6:00 AM",48,32,16,,,,,,,,,,3,2,1,4,,,,11,7,4,31,14,1,1,0,44,0,3,2,1,1,1,1,0
"Aug 14, 2019 7:00 AM",134,100,34,,,,,,,,,,9,3,6,18,,,,24,19,5,93,32,16,11,5,122,0,3,2,2,0,1,0,1
"Aug 14, 2019 8:00 AM",280,234,46,,,,,,,,,,8,0,8,12,,,,31,20,11,193,50,54,40,14,216,4,6,7,2,5,0,0,0
"Aug 14, 2019 9:00 AM",169,137,32,,,,,,,,,,6,1,5,5,,,,19,11,8,82,24,26,13,13,77,1,2,4,1,3,0,0,0
"Aug 14, 2019 10:00 AM",38,24,14,,,,,,,,,,9,1,8,6,,,,15,13,2,26,14,16,5,11,28,3,4,4,3,1,1,0,1
"Aug 14, 2019 11:00 AM",28,12,16,,,,,,,,,,9,3,6,13,,,,6,5,1,25,13,15,6,9,19,0,1,0,0,0,0,0,0
"Aug 14, 2019 12:00 PM",37,25,12,,,,,,,,,,8,5,3,13,,,,16,13,3,15,20,15,7,8,18,5,2,2,1,1,0,0,0
"Aug 14, 2019 1:00 PM",56,21,35,,,,,,,,,,8,0,8,21,,,,23,17,6,21,22,13,2,11,25,1,3,3,2,1,1,1,0
"Aug 14, 2019 2:00 PM",41,20,21,,,,,,,,,,18,8,10,11,,,,12,10,2,13,18,13,8,5,20,1,6,3,1,2,1,0,1
"Aug 14, 2019 3:00 PM",64,22,42,,,,,,,,,,20,9,11,13,,,,12,11,1,9,13,22,9,13,19,8,1,5,4,1,1,0,1
"Aug 14, 2019 4:00 PM",106,24,82,,,,,,,,,,13,8,5,13,,,,41,38,3,15,56,21,5,16,37,9,6,2,1,1,1,1,0
"Aug 14, 2019 5:00 PM",207,36,171,,,,,,,,,,22,14,8,20,,,,125,120,5,24,136,42,7,35,60,5,3,6,6,0,2,0,2
"Aug 14, 2019 6:00 PM",250,54,196,,,,,,,,,,16,13,3,18,,,,153,151,2,31,141,71,6,65,41,5,7,6,3,3,0,0,0
"Aug 14, 2019 7:00 PM",104,29,75,,,,,,,,,,10,4,6,11,,,,57,55,2,17,57,24,4,20,23,3,0,5,1,4,1,0,1
"Aug 14, 2019 8:00 PM",49,17,32,,,,,,,,,,12,6,6,14,,,,35,33,2,10,29,23,8,15,21,6,4,7,3,4,0,0,0
"Aug 14, 2019 9:00 PM",36,16,20,,,,,,,,,,4,2,2,2,,,,18,17,1,14,13,6,1,5,17,2,1,0,0,0,0,0,0
"Aug 14, 2019 10:00 PM",28,8,20,,,,,,,,,,5,5,0,3,,,,15,14,1,6,12,3,0,3,8,1,0,1,0,1,0,0,0
"Aug 14, 2019 11:00 PM",9,3,6,,,,,,,,,,4,1,3,5,,,,9,9,0,8,6,4,4,0,1,1,1,1,0,1,0,0,0
"Aug 15, 2019 12:00 AM",3,0,3,,,,,,,,,,1,0,1,0,,,,2,2,0,1,3,2,0,2,3,0,1,1,1,0,0,0,0
"Aug 15, 2019 1:00 AM",4,2,2,,,,,,,,,,1,0,1,1,,,,7,7,0,0,2,0,0,0,0,0,1,0,0,0,0,0,0
"Aug 15, 2019 2:00 AM",3,2,1,,,,,,,,,,0,0,0,0,,,,0,0,0,0,0,0,0,0,0,1,0,1,0,1,0,0,0
"Aug 15, 2019 3:00 AM",1,1,0,,,,,,,,,,0,0,0,0,,,,0,0,0,1,0,1,1,0,0,1,0,0,0,0,0,0,0
"Aug 15, 2019 4:00 AM",3,2,1,,,,,,,,,,0,0,0,0,,,,2,2,0,1,0,0,0,0,1,0,0,0,0,0,0,0,0
"Aug 15, 2019 5:00 AM",6,4,2,,,,,,,,,,1,0,1,3,,,,1,1,0,12,3,2,1,1,12,2,0,0,0,0,0,0,0
"Aug 15, 2019 6:00 AM",43,27,16,,,,,,,,,,6,2,4,6,,,,9,7,2,25,19,7,3,4,60,0,2,3,1,2,2,0,2
"Aug 15, 2019 7:00 AM",166,124,42,,,,,,,,,,13,2,11,12,,,,27,22,5,128,39,38,28,10,145,3,6,6,4,2,1,1,0
"Aug 15, 2019 8:00 AM",348,278,70,,,,,,,,,,18,2,16,25,,,,32,23,9,205,64,65,44,21,261,2,8,4,3,1,1,0,1
"Aug 15, 2019 9:00 AM",143,114,29,,,,,,,,,,18,8,10,13,,,,15,7,8,91,16,43,24,19,87,0,8,2,1,1,0,0,0
"Aug 15, 2019 10:00 AM",55,35,20,,,,,,,,,,7,1,6,6,,,,15,12,3,30,15,20,7,13,23,9,4,2,2,0,0,0,0
"Aug 15, 2019 11:00 AM",33,19,14,,,,,,,,,,20,11,9,8,,,,7,7,0,28,14,14,4,10,27,1,3,3,2,1,0,0,0
"Aug 15, 2019 12:00 PM",63,29,34,,,,,,,,,,17,10,7,17,,,,15,15,0,18,14,22,13,9,27,6,3,1,1,0,2,0,2
"Aug 15, 2019 1:00 PM",69,32,37,,,,,,,,,,14,10,4,9,,,,21,17,4,21,18,17,9,8,30,7,2,6,4,2,0,0,0
"Aug 15, 2019 2:00 PM",52,26,26,,,,,,,,,,12,5,7,14,,,,16,14,2,17,17,16,7,9,25,3,5,4,2,2,2,0,2
"Aug 15, 2019 3:00 PM",57,25,32,,,,,,,,,,27,9,18,8,,,,24,22,2,11,22,35,9,26,23,5,5,7,6,1,0,0,0
"Aug 15, 2019 4:00 PM",108,35,73,,,,,,,,,,28,21,7,15,,,,43,42,1,22,82,39,10,29,42,8,6,8,6,2,0,0,0
"Aug 15, 2019 5:00 PM",263,57,206,,,,,,,,,,31,17,14,25,,,,143,141,2,32,184,74,17,57,71,7,8,7,5,2,0,0,0
"Aug 15, 2019 6:00 PM",286,56,230,,,,,,,,,,28,19,9,31,,,,141,138,3,40,137,78,15,63,63,7,5,5,3,2,0,0,0
"Aug 15, 2019 7:00 PM",121,32,89,,,,,,,,,,18,7,11,13,,,,70,69,1,17,77,45,4,41,35,2,2,0,0,0,1,1,0
"Aug 15, 2019 8:00 PM",74,17,57,,,,,,,,,,9,7,2,11,,,,41,39,2,25,44,31,9,22,22,5,1,7,3,4,2,2,0
"Aug 15, 2019 9:00 PM",58,8,50,,,,,,,,,,17,12,5,9,,,,31,28,3,12,23,16,5,11,19,1,3,8,3,5,1,0,1
"Aug 15, 2019 10:00 PM",31,9,22,,,,,,,,,,4,3,1,3,,,,23,21,2,7,11,4,1,3,16,3,1,0,0,0,1,1,0
"Aug 15, 2019 11:00 PM",23,3,20,,,,,,,,,,5,3,2,2,,,,9,8,1,6,10,3,2,1,5,0,0,1,0,1,0,0,0
"Aug 16, 2019 12:00 AM",10,4,6,,,,,,,,,,0,0,0,1,,,,3,3,0,3,7,2,0,2,6,0,1,1,0,1,1,1,0
"Aug 16, 2019 1:00 AM",8,1,7,,,,,,,,,,1,1,0,0,,,,2,2,0,1,3,2,0,2,2,0,0,0,0,0,0,0,0
"Aug 16, 2019 2:00 AM",4,1,3,,,,,,,,,,0,0,0,0,,,,4,3,1,0,4,1,1,0,2,0,0,0,0,0,0,0,0
"Aug 16, 2019 3:00 AM",2,1,1,,,,,,,,,,0,0,0,0,,,,2,2,0,4,0,0,0,0,0,0,0,0,0,0,0,0,0
"Aug 16, 2019 4:00 AM",5,2,3,,,,,,,,,,1,1,0,0,,,,1,1,0,0,0,0,0,0,0,0,0,0,0,0,0,0,0
"Aug 16, 2019 5:00 AM",7,5,2,,,,,,,,,,0,0,0,3,,,,0,0,0,7,2,0,0,0,8,1,0,0,0,0,0,0,0
"Aug 16, 2019 6:00 AM",23,14,9,,,,,,,,,,2,1,1,5,,,,8,6,2,20,9,4,3,1,28,1,1,2,1,1,0,0,0
"Aug 16, 2019 7:00 AM",82,62,20,,,,,,,,,,4,2,2,8,,,,16,11,5,66,26,10,7,3,80,2,1,4,3,1,0,0,0
"Aug 16, 2019 8:00 AM",180,142,38,,,,,,,,,,8,2,6,10,,,,23,20,3,105,40,36,23,13,142,3,3,6,3,3,2,1,1
"Aug 16, 2019 9:00 AM",89,73,16,,,,,,,,,,12,6,6,6,,,,15,9,6,54,12,15,9,6,50,0,3,2,2,0,3,1,2
"Aug 16, 2019 10:00 AM",42,22,20,,,,,,,,,,11,3,8,5,,,,12,9,3,22,10,5,3,2,25,0,0,3,0,3,0,0,0
"Aug 16, 2019 11:00 AM",32,19,13,,,,,,,,,,2,1,1,1,,,,5,4,1,13,6,25,9,16,18,0,2,3,0,3,0,0,0
"Aug 16, 2019 12:00 PM",38,18,20,,,,,,,,,,8,5,3,5,,,,9,9,0,23,24,11,3,8,15,4,3,2,1,1,0,0,0
"Aug 16, 2019 1:00 PM",73,32,41,,,,,,,,,,6,3,3,3,,,,12,9,3,20,15,14,8,6,18,2,1,4,4,0,2,0,2
"Aug 16, 2019 2:00 PM",49,28,21,,,,,,,,,,11,3,8,15,,,,13,12,1,16,15,16,5,11,13,4,1,8,3,5,2,2,0
"Aug 16, 2019 3:00 PM",63,23,40,,,,,,,,,,5,4,1,7,,,,21,20,1,14,18,15,5,10,18,6,2,6,2,4,0,0,0
"Aug 16, 2019 4:00 PM",95,28,67,,,,,,,,,,14,12,2,16,,,,46,46,0,21,55,20,6,14,23,2,5,2,1,1,1,0,1
"Aug 16, 2019 5:00 PM",141,29,112,,,,,,,,,,16,13,3,18,,,,84,80,4,20,95,34,11,23,46,1,5,2,1,1,0,0,0
"Aug 16, 2019 6:00 PM",132,32,100,,,,,,,,,,12,8,4,11,,,,75,73,2,21,79,34,5,29,24,3,4,7,6,1,3,2,1
"Aug 16, 2019 7:00 PM",70,15,55,,,,,,,,,,11,6,5,8,,,,28,28,0,13,43,17,4,13,10,2,2,3,2,1,0,0,0
"Aug 16, 2019 8:00 PM",43,13,30,,,,,,,,,,7,6,1,10,,,,21,19,2,13,17,14,3,11,17,0,3,3,1,2,4,3,1
"Aug 16, 2019 9:00 PM",39,14,25,,,,,,,,,,9,8,1,5,,,,18,16,2,8,8,14,4,10,13,0,1,2,1,1,0,0,0
"Aug 16, 2019 10:00 PM",13,3,10,,,,,,,,,,3,1,2,2,,,,10,10,0,3,10,2,0,2,16,1,1,1,1,0,0,0,0
"Aug 16, 2019 11:00 PM",17,4,13,,,,,,,,,,3,3,0,4,,,,11,10,1,5,6,9,8,1,5,1,1,0,0,0,0,0,0
"Aug 17, 2019 12:00 AM",11,5,6,,,,,,,,,,2,0,2,0,,,,3,3,0,3,3,0,0,0,6,0,0,0,0,0,0,0,0
"Aug 17, 2019 1:00 AM",6,2,4,,,,,,,,,,1,1,0,3,,,,2,1,1,1,2,1,0,1,3,0,1,0,0,0,0,0,0
"Aug 17, 2019 2:00 AM",1,0,1,,,,,,,,,,0,0,0,0,,,,3,3,0,1,3,1,0,1,1,1,2,1,1,0,2,1,1
"Aug 17, 2019 3:00 AM",4,1,3,,,,,,,,,,0,0,0,0,,,,3,3,0,0,2,1,1,0,1,1,0,0,0,0,0,0,0
"Aug 17, 2019 4:00 AM",3,1,2,,,,,,,,,,0,0,0,0,,,,0,0,0,0,0,1,0,1,0,0,0,1,1,0,0,0,0
"Aug 17, 2019 5:00 AM",3,1,2,,,,,,,,,,0,0,0,2,,,,0,0,0,2,4,0,0,0,3,0,2,1,0,1,1,1,0
"Aug 17, 2019 6:00 AM",11,4,7,,,,,,,,,,2,2,0,1,,,,1,1,0,4,6,2,0,2,15,3,1,1,1,0,0,0,0
"Aug 17, 2019 7:00 AM",17,7,10,,,,,,,,,,1,0,1,4,,,,6,4,2,11,20,2,0,2,13,3,8,1,0,1,0,0,0
"Aug 17, 2019 8:00 AM",30,13,17,,,,,,,,,,9,4,5,7,,,,13,10,3,13,11,14,6,8,22,1,12,2,1,1,0,0,0
"Aug 17, 2019 9:00 AM",28,15,13,,,,,,,,,,17,7,10,8,,,,10,7,3,8,23,9,4,5,25,3,9,1,0,1,0,0,0
"Aug 17, 2019 10:00 AM",30,21,9,,,,,,,,,,35,13,22,12,,,,16,15,1,18,27,25,7,18,28,7,13,8,6,2,2,2,0
"Aug 17, 2019 11:00 AM",39,23,16,,,,,,,,,,11,5,6,15,,,,17,15,2,12,25,29,12,17,26,8,6,12,6,6,1,0,1
"Aug 17, 2019 12:00 PM",39,18,21,,,,,,,,,,16,9,7,16,,,,13,11,2,15,32,35,8,27,21,5,3,11,5,6,1,0,1
"Aug 17, 2019 1:00 PM",47,29,18,,,,,,,,,,13,7,6,12,,,,11,9,2,16,30,26,3,23,18,7,2,10,7,3,4,4,0
"Aug 17, 2019 2:00 PM",42,23,19,,,,,,,,,,16,7,9,15,,,,21,18,3,26,18,38,9,29,28,4,3,4,3,1,2,0,2
"Aug 17, 2019 3:00 PM",26,11,15,,,,,,,,,,23,12,11,14,,,,13,11,2,19,23,35,15,20,29,3,4,4,0,4,3,3,0
"Aug 17, 2019 4:00 PM",32,19,13,,,,,,,,,,36,23,13,22,,,,17,15,2,19,20,29,15,14,24,8,1,3,3,0,1,0,1
"Aug 17, 2019 5:00 PM",42,20,22,,,,,,,,,,28,21,7,16,,,,13,12,1,11,18,36,20,16,27,5,6,2,1,1,1,1,0
"Aug 17, 2019 6:00 PM",41,17,24,,,,,,,,,,17,12,5,26,,,,12,12,0,10,22,24,16,8,20,6,2,4,3,1,0,0,0
"Aug 17, 2019 7:00 PM",26,16,10,,,,,,,,,,21,15,6,13,,,,9,8,1,11,12,20,9,11,16,1,1,5,3,2,0,0,0
"Aug 17, 2019 8:00 PM",28,10,18,,,,,,,,,,6,5,1,12,,,,11,11,0,11,12,5,0,5,17,3,2,3,2,1,3,2,1
"Aug 17, 2019 9:00 PM",17,6,11,,,,,,,,,,8,4,4,2,,,,4,4,0,6,5,6,4,2,4,0,0,1,0,1,1,1,0
"Aug 17, 2019 10:00 PM",14,5,9,,,,,,,,,,3,2,1,7,,,,4,4,0,7,6,0,0,0,7,0,0,1,0,1,1,0,1
"Aug 17, 2019 11:00 PM",5,2,3,,,,,,,,,,2,2,0,2,,,,6,6,0,1,5,4,1,3,5,0,0,0,0,0,1,1,0
"Aug 18, 2019 12:00 AM",16,2,14,,,,,,,,,,1,1,0,2,,,,0,0,0,0,3,4,3,1,1,1,0,2,1,1,0,0,0
"Aug 18, 2019 1:00 AM",2,1,1,,,,,,,,,,3,1,2,0,,,,1,1,0,2,1,0,0,0,7,0,1,1,1,0,0,0,0
"Aug 18, 2019 2:00 AM",6,1,5,,,,,,,,,,0,0,0,1,,,,4,4,0,1,4,1,0,1,3,0,2,0,0,0,0,0,0
"Aug 18, 2019 3:00 AM",3,2,1,,,,,,,,,,0,0,0,0,,,,1,1,0,0,1,0,0,0,0,1,0,0,0,0,0,0,0
"Aug 18, 2019 4:00 AM",6,1,5,,,,,,,,,,0,0,0,0,,,,4,4,0,0,0,1,0,1,0,0,0,0,0,0,0,0,0
"Aug 18, 2019 5:00 AM",3,1,2,,,,,,,,,,0,0,0,0,,,,1,1,0,0,0,0,0,0,2,2,0,3,2,1,0,0,0
"Aug 18, 2019 6:00 AM",5,2,3,,,,,,,,,,0,0,0,0,,,,3,3,0,3,7,0,0,0,5,1,1,0,0,0,0,0,0
"Aug 18, 2019 7:00 AM",8,4,4,,,,,,,,,,2,1,1,2,,,,4,3,1,7,15,4,1,3,15,1,0,1,1,0,0,0,0
"Aug 18, 2019 8:00 AM",18,8,10,,,,,,,,,,20,8,12,6,,,,4,3,1,4,9,10,8,2,14,1,11,1,0,1,1,1,0
"Aug 18, 2019 9:00 AM",18,11,7,,,,,,,,,,7,3,4,7,,,,8,7,1,13,17,23,11,12,22,3,18,4,2,2,3,2,1
"Aug 18, 2019 10:00 AM",22,11,11,,,,,,,,,,15,8,7,10,,,,8,6,2,10,23,39,9,30,28,5,12,6,4,2,0,0,0
"Aug 18, 2019 11:00 AM",37,18,19,,,,,,,,,,34,19,15,10,,,,10,10,0,11,29,11,5,6,24,5,9,6,5,1,1,0,1
"Aug 18, 2019 12:00 PM",39,20,19,,,,,,,,,,52,27,25,11,,,,9,5,4,12,18,27,11,16,27,12,7,5,2,3,1,1,0
"Aug 18, 2019 1:00 PM",34,21,13,,,,,,,,,,36,18,18,8,,,,10,9,1,15,23,27,13,14,21,5,2,4,3,1,0,0,0
"Aug 18, 2019 2:00 PM",27,8,19,,,,,,,,,,30,11,19,6,,,,8,8,0,8,12,22,8,14,17,5,2,4,2,2,2,2,0
"Aug 18, 2019 3:00 PM",36,24,12,,,,,,,,,,19,13,6,14,,,,13,10,3,9,15,10,5,5,26,2,2,3,1,2,0,0,0
"Aug 18, 2019 4:00 PM",22,8,14,,,,,,,,,,15,10,5,7,,,,7,5,2,7,10,15,6,9,12,2,2,3,0,3,0,0,0
"Aug 18, 2019 5:00 PM",33,15,18,,,,,,,,,,9,7,2,16,,,,11,9,2,12,12,10,6,4,18,2,0,4,3,1,2,1,1
"Aug 18, 2019 6:00 PM",29,8,21,,,,,,,,,,14,11,3,6,,,,10,10,0,10,7,8,4,4,11,1,2,4,2,2,3,2,1
"Aug 18, 2019 7:00 PM",20,11,9,,,,,,,,,,9,5,4,12,,,,10,9,1,5,16,10,5,5,17,1,1,9,4,5,0,0,0
"Aug 18, 2019 8:00 PM",21,11,10,,,,,,,,,,5,3,2,8,,,,7,7,0,14,6,7,2,5,16,3,0,2,0,2,1,1,0
"Aug 18, 2019 9:00 PM",12,5,7,,,,,,,,,,4,1,3,5,,,,4,3,1,3,8,8,4,4,4,2,0,1,1,0,0,0,0
"Aug 18, 2019 10:00 PM",7,3,4,,,,,,,,,,3,2,1,5,,,,2,2,0,0,6,1,0,1,5,0,0,0,0,0,0,0,0
"Aug 18, 2019 11:00 PM",5,1,4,,,,,,,,,,0,0,0,0,,,,6,6,0,2,1,0,0,0,3,0,0,0,0,0,0,0,0
"Aug 19, 2019 12:00 AM",5,0,5,,,,,,,,,,0,0,0,0,,,,2,2,0,1,3,0,0,0,0,0,0,1,0,1,0,0,0
"Aug 19, 2019 1:00 AM",4,0,4,,,,,,,,,,0,0,0,0,,,,2,2,0,0,1,1,1,0,0,1,1,0,0,0,0,0,0
"Aug 19, 2019 2:00 AM",1,1,0,,,,,,,,,,0,0,0,0,,,,0,0,0,0,1,0,0,0,0,0,0,0,0,0,0,0,0
"Aug 19, 2019 3:00 AM",1,0,1,,,,,,,,,,0,0,0,0,,,,0,0,0,0,1,0,0,0,0,0,0,0,0,0,0,0,0
"Aug 19, 2019 4:00 AM",0,0,0,,,,,,,,,,0,0,0,0,,,,0,0,0,1,0,0,0,0,0,0,0,0,0,0,0,0,0
"Aug 19, 2019 5:00 AM",7,5,2,,,,,,,,,,1,0,1,1,,,,1,1,0,7,2,1,0,1,14,2,0,0,0,0,0,0,0
"Aug 19, 2019 6:00 AM",47,31,16,,,,,,,,,,5,0,5,3,,,,8,7,1,31,21,10,5,5,54,0,1,2,1,1,1,0,1
"Aug 19, 2019 7:00 AM",145,109,36,,,,,,,,,,9,4,5,9,,,,29,25,4,123,31,32,22,10,158,6,6,6,5,1,0,0,0
"Aug 19, 2019 8:00 AM",337,274,63,,,,,,,,,,29,4,25,25,,,,40,30,10,244,55,97,73,24,314,4,7,7,3,4,2,1,1
"Aug 19, 2019 9:00 AM",163,137,26,,,,,,,,,,28,11,17,4,,,,23,10,13,96,26,42,29,13,94,4,9,5,4,1,1,1,0
"Aug 19, 2019 10:00 AM",53,43,10,,,,,,,,,,16,4,12,6,,,,14,12,2,25,10,26,9,17,26,4,3,4,1,3,0,0,0
"Aug 19, 2019 11:00 AM",41,21,20,,,,,,,,,,23,16,7,8,,,,10,8,2,13,12,17,5,12,27,4,3,1,0,1,0,0,0
"Aug 19, 2019 12:00 PM",55,33,22,,,,,,,,,,47,19,28,30,,,,12,11,1,13,10,26,8,18,15,4,0,1,1,0,0,0,0
"Aug 19, 2019 1:00 PM",41,15,26,,,,,,,,,,25,18,7,12,,,,16,12,4,15,17,35,23,12,24,7,3,4,2,2,2,0,2
"Aug 19, 2019 2:00 PM",44,18,26,,,,,,,,,,23,12,11,13,,,,18,15,3,13,15,13,5,8,20,5,8,2,1,1,0,0,0
"Aug 19, 2019 3:00 PM",45,13,32,,,,,,,,,,26,16,10,22,,,,23,21,2,15,26,15,3,12,24,2,3,5,3,2,0,0,0
"Aug 19, 2019 4:00 PM",102,24,78,,,,,,,,,,19,15,4,21,,,,43,40,3,17,77,30,4,26,51,8,5,7,4,3,2,2,0
"Aug 19, 2019 5:00 PM",295,62,233,,,,,,,,,,27,16,11,31,,,,167,165,2,40,171,82,14,68,76,6,0,4,1,3,0,0,0
"Aug 19, 2019 6:00 PM",278,59,219,,,,,,,,,,17,8,9,19,,,,169,168,1,35,191,84,6,78,60,8,5,10,6,4,3,2,1
"Aug 19, 2019 7:00 PM",138,32,106,,,,,,,,,,22,17,5,11,,,,68,64,4,22,85,44,14,30,39,3,2,10,5,5,4,1,3
"Aug 19, 2019 8:00 PM",66,21,45,,,,,,,,,,7,4,3,5,,,,35,34,1,10,40,23,2,21,21,4,2,6,3,3,1,1,0
"Aug 19, 2019 9:00 PM",41,13,28,,,,,,,,,,4,2,2,9,,,,20,17,3,10,17,16,10,6,18,0,0,0,0,0,1,1,0
"Aug 19, 2019 10:00 PM",23,6,17,,,,,,,,,,3,2,1,1,,,,11,10,1,5,14,7,1,6,7,4,1,6,5,1,1,1,0
"Aug 19, 2019 11:00 PM",15,4,11,,,,,,,,,,7,7,0,0,,,,5,5,0,2,5,0,0,0,2,0,0,0,0,0,0,0,0
"Aug 20, 2019 12:00 AM",5,0,5,,,,,,,,,,1,1,0,0,,,,1,1,0,1,3,1,0,1,2,0,0,0,0,0,0,0,0
"Aug 20, 2019 1:00 AM",3,1,2,,,,,,,,,,0,0,0,0,,,,1,1,0,0,3,1,0,1,2,0,1,0,0,0,0,0,0
"Aug 20, 2019 2:00 AM",2,1,1,,,,,,,,,,0,0,0,0,,,,2,2,0,0,3,2,0,2,0,0,0,0,0,0,0,0,0
"Aug 20, 2019 3:00 AM",2,1,1,,,,,,,,,,0,0,0,0,,,,0,0,0,0,0,0,0,0,1,0,0,0,0,0,0,0,0
"Aug 20, 2019 4:00 AM",4,1,3,,,,,,,,,,0,0,0,0,,,,0,0,0,1,1,0,0,0,2,0,0,0,0,0,0,0,0
"Aug 20, 2019 5:00 AM",6,3,3,,,,,,,,,,3,1,2,2,,,,0,0,0,7,6,0,0,0,17,3,1,1,0,1,0,0,0
"Aug 20, 2019 6:00 AM",49,31,18,,,,,,,,,,3,3,0,3,,,,9,9,0,32,23,18,12,6,54,0,5,5,1,4,0,0,0
"Aug 20, 2019 7:00 AM",189,143,46,,,,,,,,,,11,5,6,10,,,,33,26,7,138,39,39,29,10,204,3,5,6,3,3,2,1,1
"Aug 20, 2019 8:00 AM",403,320,83,,,,,,,,,,21,3,18,22,,,,39,29,10,257,64,91,66,25,301,4,11,6,2,4,3,3,0
"Aug 20, 2019 9:00 AM",149,118,31,,,,,,,,,,19,5,14,13,,,,20,14,6,95,21,37,27,10,94,6,5,7,6,1,0,0,0
"Aug 20, 2019 10:00 AM",62,42,20,,,,,,,,,,7,2,5,4,,,,10,7,3,34,13,20,11,9,24,8,5,3,1,2,1,0,1
"Aug 20, 2019 11:00 AM",52,33,19,,,,,,,,,,15,6,9,12,,,,7,5,2,18,10,22,8,14,24,4,6,1,1,0,0,0,0
"Aug 20, 2019 12:00 PM",39,20,19,,,,,,,,,,11,9,2,16,,,,19,16,3,16,14,17,6,11,32,8,0,4,2,2,2,1,1
"Aug 20, 2019 1:00 PM",49,21,28,,,,,,,,,,11,6,5,30,,,,15,14,1,15,16,6,1,5,14,2,1,4,2,2,3,2,1
"Aug 20, 2019 2:00 PM",43,16,27,,,,,,,,,,11,7,4,15,,,,16,16,0,10,25,4,1,3,10,0,1,1,1,0,1,0,1
"Aug 20, 2019 3:00 PM",46,21,25,,,,,,,,,,11,8,3,9,,,,28,26,2,11,20,11,5,6,15,5,1,5,5,0,3,1,2
"Aug 20, 2019 4:00 PM",91,19,72,,,,,,,,,,9,5,4,7,,,,42,38,4,14,47,21,4,17,30,2,2,4,2,2,0,0,0
"Aug 20, 2019 5:00 PM",275,57,218,,,,,,,,,,12,7,5,22,,,,142,137,5,34,166,83,15,68,68,4,0,2,2,0,3,3,0
"Aug 20, 2019 6:00 PM",258,53,205,,,,,,,,,,15,12,3,17,,,,183,182,1,35,171,79,5,74,52,10,0,9,8,1,2,2,0
"Aug 20, 2019 7:00 PM",134,31,103,,,,,,,,,,7,6,1,16,,,,75,71,4,13,99,27,3,24,25,0,2,1,1,0,1,1,0
"Aug 20, 2019 8:00 PM",73,22,51,,,,,,,,,,7,5,2,11,,,,37,34,3,19,45,17,3,14,29,3,3,0,0,0,0,0,0
"Aug 20, 2019 9:00 PM",59,16,43,,,,,,,,,,7,4,3,4,,,,22,21,1,5,22,3,1,2,20,3,0,3,3,0,1,1,0
"Aug 20, 2019 10:00 PM",22,5,17,,,,,,,,,,2,2,0,1,,,,19,17,2,9,13,4,1,3,6,0,0,1,1,0,0,0,0
"Aug 20, 2019 11:00 PM",16,2,14,,,,,,,,,,1,0,1,1,,,,7,7,0,2,4,1,0,1,1,0,0,1,1,0,1,1,0
"Aug 21, 2019 12:00 AM",9,2,7,,,,,,,,,,0,0,0,1,,,,2,2,0,2,5,2,0,2,2,0,2,0,0,0,1,1,0
"Aug 21, 2019 1:00 AM",2,0,2,,,,,,,,,,0,0,0,0,,,,5,4,1,1,0,0,0,0,2,0,0,0,0,0,0,0,0
"Aug 21, 2019 2:00 AM",3,1,2,,,,,,,,,,2,2,0,2,,,,1,1,0,0,3,0,0,0,2,1,0,1,0,1,0,0,0
"Aug 21, 2019 3:00 AM",1,1,0,,,,,,,,,,0,0,0,0,,,,1,1,0,0,0,1,0,1,0,1,0,1,0,1,0,0,0
"Aug 21, 2019 4:00 AM",6,2,4,,,,,,,,,,0,0,0,0,,,,3,3,0,1,0,0,0,0,2,0,0,0,0,0,0,0,0
"Aug 21, 2019 5:00 AM",6,4,2,,,,,,,,,,1,0,1,4,,,,0,0,0,12,5,1,1,0,15,1,0,0,0,0,0,0,0
"Aug 21, 2019 6:00 AM",45,30,15,,,,,,,,,,2,1,1,5,,,,13,10,3,34,18,14,10,4,48,0,1,3,1,2,0,0,0
"Aug 21, 2019 7:00 AM",166,129,37,,,,,,,,,,7,2,5,14,,,,28,25,3,109,38,32,20,12,176,5,4,7,5,2,0,0,0
"Aug 21, 2019 8:00 AM",345,281,64,,,,,,,,,,17,3,14,20,,,,36,27,9,226,65,82,57,25,278,0,8,3,2,1,1,0,1
"Aug 21, 2019 9:00 AM",149,124,25,,,,,,,,,,20,7,13,4,,,,18,12,6,91,24,45,30,15,85,6,7,10,9,1,1,0,1
"Aug 21, 2019 10:00 AM",47,31,16,,,,,,,,,,11,3,8,6,,,,19,14,5,26,19,20,10,10,26,1,5,3,1,2,0,0,0
"Aug 21, 2019 11:00 AM",42,27,15,,,,,,,,,,10,5,5,7,,,,6,5,1,15,13,11,5,6,25,2,3,5,3,2,1,1,0
"Aug 21, 2019 12:00 PM",45,23,22,,,,,,,,,,15,8,7,12,,,,14,14,0,21,10,14,5,9,25,4,3,4,3,1,1,0,1
"Aug 21, 2019 1:00 PM",46,19,27,,,,,,,,,,13,5,8,8,,,,20,16,4,9,22,4,1,3,24,5,4,5,2,3,0,0,0
"Aug 21, 2019 2:00 PM",42,23,19,,,,,,,,,,15,11,4,8,,,,16,16,0,12,15,14,4,10,20,4,5,4,1,3,2,1,1
"Aug 21, 2019 3:00 PM",48,21,27,,,,,,,,,,6,3,3,2,,,,16,16,0,16,13,10,3,7,20,7,2,10,8,2,0,0,0
"Aug 21, 2019 4:00 PM",89,27,62,,,,,,,,,,12,6,6,6,,,,51,48,3,18,49,32,7,25,36,5,1,6,3,3,1,1,0
"Aug 21, 2019 5:00 PM",243,41,202,,,,,,,,,,18,12,6,22,,,,133,129,4,33,142,66,13,53,60,3,2,5,5,0,2,1,1
"Aug 21, 2019 6:00 PM",253,55,198,,,,,,,,,,24,15,9,29,,,,150,145,5,32,156,75,12,63,49,5,3,5,2,3,1,1,0
"Aug 21, 2019 7:00 PM",127,25,102,,,,,,,,,,14,8,6,7,,,,62,59,3,17,66,33,3,30,30,0,1,3,1,2,1,1,0
"Aug 21, 2019 8:00 PM",65,24,41,,,,,,,,,,8,5,3,7,,,,40,39,1,15,35,21,1,20,15,1,1,1,0,1,2,2,0
"Aug 21, 2019 9:00 PM",38,10,28,,,,,,,,,,1,1,0,3,,,,12,12,0,5,18,9,2,7,16,0,0,1,0,1,0,0,0
"Aug 21, 2019 10:00 PM",16,6,10,,,,,,,,,,4,3,1,6,,,,21,18,3,8,12,3,1,2,3,0,0,0,0,0,0,0,0
"Aug 21, 2019 11:00 PM",32,5,27,,,,,,,,,,3,2,1,1,,,,16,16,0,4,11,3,1,2,1,0,0,0,0,0,0,0,0
"Aug 22, 2019 12:00 AM",7,2,5,,,,,,,,,,0,0,0,1,,,,8,8,0,1,2,1,0,1,3,1,0,0,0,0,0,0,0
"Aug 22, 2019 1:00 AM",2,0,2,,,,,,,,,,0,0,0,2,,,,1,1,0,0,1,0,0,0,2,0,0,0,0,0,0,0,0
"Aug 22, 2019 2:00 AM",4,1,3,,,,,,,,,,1,1,0,0,,,,1,1,0,0,4,0,0,0,0,1,0,0,0,0,0,0,0
"Aug 22, 2019 3:00 AM",2,1,1,,,,,,,,,,0,0,0,0,,,,1,1,0,0,0,0,0,0,0,0,0,0,0,0,0,0,0
"Aug 22, 2019 4:00 AM",3,2,1,,,,,,,,,,0,0,0,0,,,,1,1,0,1,0,0,0,0,2,0,1,0,0,0,0,0,0
"Aug 22, 2019 5:00 AM",8,6,2,,,,,,,,,,0,0,0,2,,,,1,0,1,8,3,2,1,1,10,2,0,0,0,0,0,0,0
"Aug 22, 2019 6:00 AM",54,40,14,,,,,,,,,,4,0,4,3,,,,7,6,1,27,24,6,4,2,52,0,3,2,1,1,0,0,0
"Aug 22, 2019 7:00 AM",127,99,28,,,,,,,,,,5,2,3,8,,,,29,22,7,124,32,22,16,6,148,6,3,7,5,2,2,1,1
"Aug 22, 2019 8:00 AM",319,248,71,,,,,,,,,,24,2,22,24,,,,36,26,10,192,45,74,54,20,273,3,10,9,5,4,2,2,0
"Aug 22, 2019 9:00 AM",146,118,28,,,,,,,,,,19,5,14,4,,,,16,8,8,93,27,40,24,16,73,3,4,5,3,2,0,0,0
"Aug 22, 2019 10:00 AM",47,33,14,,,,,,,,,,12,3,9,6,,,,12,11,1,27,17,10,5,5,30,3,4,1,0,1,2,0,2
"Aug 22, 2019 11:00 AM",36,19,17,,,,,,,,,,7,2,5,5,,,,3,2,1,19,15,7,6,1,24,4,3,2,1,1,0,0,0
"Aug 22, 2019 12:00 PM",53,34,19,,,,,,,,,,12,7,5,10,,,,17,14,3,14,11,9,4,5,31,0,2,3,3,0,1,0,1
"Aug 22, 2019 1:00 PM",56,24,32,,,,,,,,,,16,6,10,14,,,,23,19,4,14,18,21,9,12,20,2,1,5,3,2,0,0,0
"Aug 22, 2019 2:00 PM",53,22,31,,,,,,,,,,20,10,10,13,,,,12,11,1,15,25,13,5,8,31,2,2,4,3,1,1,0,1
"Aug 22, 2019 3:00 PM",62,19,43,,,,,,,,,,15,8,7,21,,,,23,20,3,17,25,17,4,13,22,8,3,10,7,3,4,4,0
"Aug 22, 2019 4:00 PM",113,33,80,,,,,,,,,,19,11,8,18,,,,41,38,3,33,58,21,4,17,35,4,4,4,2,2,1,1,0
"Aug 22, 2019 5:00 PM",243,38,205,,,,,,,,,,28,17,11,27,,,,140,137,3,43,152,96,19,77,59,8,5,3,2,1,3,3,0
"Aug 22, 2019 6:00 PM",250,48,202,,,,,,,,,,31,22,9,27,,,,146,143,3,35,162,58,9,49,57,10,5,5,3,2,0,0,0
"Aug 22, 2019 7:00 PM",129,38,91,,,,,,,,,,16,6,10,13,,,,71,68,3,25,73,40,8,32,36,0,0,1,0,1,0,0,0
"Aug 22, 2019 8:00 PM",94,27,67,,,,,,,,,,15,9,6,24,,,,42,39,3,19,34,32,10,22,39,6,1,2,0,2,3,1,2
"Aug 22, 2019 9:00 PM",48,14,34,,,,,,,,,,11,6,5,12,,,,27,24,3,9,32,11,5,6,14,1,1,5,3,2,0,0,0
"Aug 22, 2019 10:00 PM",31,10,21,,,,,,,,,,5,5,0,3,,,,20,18,2,5,21,10,6,4,10,1,0,1,1,0,0,0,0
"Aug 22, 2019 11:00 PM",22,4,18,,,,,,,,,,1,0,1,1,,,,16,14,2,1,13,5,2,3,2,0,0,2,2,0,1,1,0
"Aug 23, 2019 12:00 AM",10,1,9,,,,,,,,,,3,1,2,5,,,,8,7,1,6,9,3,1,2,5,1,0,0,0,0,0,0,0
"Aug 23, 2019 1:00 AM",7,0,7,,,,,,,,,,2,2,0,0,,,,2,2,0,2,1,5,5,0,2,0,0,0,0,0,0,0,0
"Aug 23, 2019 2:00 AM",4,1,3,,,,,,,,,,0,0,0,0,,,,2,2,0,0,3,0,0,0,0,1,0,0,0,0,0,0,0
"Aug 23, 2019 3:00 AM",1,1,0,,,,,,,,,,0,0,0,0,,,,1,1,0,0,0,0,0,0,1,1,0,0,0,0,0,0,0
"Aug 23, 2019 4:00 AM",4,2,2,,,,,,,,,,0,0,0,0,,,,0,0,0,1,0,0,0,0,1,0,0,0,0,0,0,0,0
"Aug 23, 2019 5:00 AM",11,10,1,,,,,,,,,,0,0,0,2,,,,1,0,1,9,4,4,0,4,10,2,1,0,0,0,0,0,0
"Aug 23, 2019 6:00 AM",43,27,16,,,,,,,,,,4,2,2,8,,,,10,8,2,22,19,8,6,2,30,2,6,1,0,1,0,0,0
"Aug 23, 2019 7:00 AM",133,102,31,,,,,,,,,,5,1,4,9,,,,24,16,8,90,31,25,19,6,112,1,5,4,2,2,1,0,1
"Aug 23, 2019 8:00 AM",283,221,62,,,,,,,,,,20,3,17,19,,,,31,25,6,195,60,61,40,21,237,3,7,4,1,3,2,1,1
"Aug 23, 2019 9:00 AM",136,111,25,,,,,,,,,,21,5,16,9,,,,13,7,6,83,25,41,24,17,88,5,3,5,2,3,1,0,1
"Aug 23, 2019 10:00 AM",55,42,13,,,,,,,,,,10,4,6,10,,,,11,8,3,23,15,21,8,13,34,4,1,2,1,1,3,3,0
"Aug 23, 2019 11:00 AM",47,26,21,,,,,,,,,,20,9,11,6,,,,6,6,0,20,18,29,15,14,35,1,7,4,3,1,0,0,0
"Aug 23, 2019 12:00 PM",54,27,27,,,,,,,,,,15,8,7,8,,,,19,13,6,28,19,33,16,17,26,3,5,3,2,1,0,0,0
"Aug 23, 2019 1:00 PM",72,20,52,,,,,,,,,,21,15,6,16,,,,20,18,2,20,42,20,9,11,39,3,3,4,3,1,0,0,0
"Aug 23, 2019 2:00 PM",56,25,31,,,,,,,,,,17,13,4,10,,,,17,17,0,21,46,41,13,28,31,6,3,5,4,1,1,1,0
"Aug 23, 2019 3:00 PM",84,36,48,,,,,,,,,,27,9,18,20,,,,34,30,4,25,34,35,9,26,37,9,3,6,5,1,0,0,0
"Aug 23, 2019 4:00 PM",122,32,90,,,,,,,,,,31,15,16,20,,,,53,53,0,32,73,60,13,47,45,8,1,6,2,4,1,1,0
"Aug 23, 2019 5:00 PM",255,68,187,,,,,,,,,,28,19,9,27,,,,149,144,5,31,171,115,25,90,47,7,4,3,3,0,3,2,1
"Aug 23, 2019 6:00 PM",167,39,128,,,,,,,,,,32,15,17,30,,,,115,112,3,26,106,96,28,68,44,5,6,9,6,3,2,1,1
"Aug 23, 2019 7:00 PM",88,26,62,,,,,,,,,,24,16,8,11,,,,44,38,6,18,56,40,17,23,42,3,3,4,3,1,0,0,0
"Aug 23, 2019 8:00 PM",53,24,29,,,,,,,,,,16,12,4,11,,,,23,22,1,12,29,22,12,10,35,2,2,6,1,5,1,1,0
"Aug 23, 2019 9:00 PM",37,12,25,,,,,,,,,,6,5,1,4,,,,17,16,1,4,14,15,2,13,14,1,2,0,0,0,0,0,0
"Aug 23, 2019 10:00 PM",22,6,16,,,,,,,,,,0,0,0,2,,,,16,15,1,6,7,8,3,5,16,3,2,0,0,0,0,0,0
"Aug 23, 2019 11:00 PM",13,2,11,,,,,,,,,,7,3,4,5,,,,12,12,0,6,8,3,1,2,6,0,1,3,0,3,1,1,0
"Aug 24, 2019 12:00 AM",16,3,13,,,,,,,,,,6,4,2,0,,,,6,5,1,1,7,1,1,0,3,2,2,0,0,0,0,0,0
"Aug 24, 2019 1:00 AM",7,2,5,,,,,,,,,,1,1,0,0,,,,4,4,0,1,2,2,1,1,6,0,1,0,0,0,1,1,0
"Aug 24, 2019 2:00 AM",2,0,2,,,,,,,,,,3,2,1,0,,,,3,3,0,0,2,0,0,0,0,0,1,1,0,1,2,2,0
"Aug 24, 2019 3:00 AM",3,1,2,,,,,,,,,,0,0,0,0,,,,3,3,0,0,0,2,2,0,1,1,1,1,0,1,0,0,0
"Aug 24, 2019 4:00 AM",7,3,4,,,,,,,,,,4,2,2,0,,,,2,2,0,0,5,2,0,2,1,0,0,0,0,0,0,0,0
"Aug 24, 2019 5:00 AM",4,1,3,,,,,,,,,,0,0,0,2,,,,2,2,0,1,2,1,0,1,4,0,0,0,0,0,0,0,0
"Aug 24, 2019 6:00 AM",9,2,7,,,,,,,,,,1,1,0,1,,,,2,2,0,6,9,2,0,2,9,4,1,2,2,0,0,0,0
"Aug 24, 2019 7:00 AM",20,9,11,,,,,,,,,,4,0,4,5,,,,4,4,0,11,27,9,3,6,17,2,1,1,0,1,1,0,1
"Aug 24, 2019 8:00 AM",28,20,8,,,,,,,,,,16,6,10,3,,,,22,7,15,20,24,19,4,15,23,2,7,1,0,1,1,0,1
"Aug 24, 2019 9:00 AM",40,30,10,,,,,,,,,,23,7,16,4,,,,18,15,3,21,36,31,10,21,37,8,13,4,3,1,0,0,0
"Aug 24, 2019 10:00 AM",39,21,18,,,,,,,,,,15,5,10,4,,,,14,12,2,21,33,39,16,23,31,7,11,2,2,0,2,2,0
"Aug 24, 2019 11:00 AM",47,26,21,,,,,,,,,,33,19,14,20,,,,14,10,4,19,42,36,12,24,32,6,13,4,2,2,1,0,1
"Aug 24, 2019 12:00 PM",59,29,30,,,,,,,,,,29,12,17,14,,,,20,16,4,20,55,51,21,30,22,10,10,7,5,2,1,0,1
"Aug 24, 2019 1:00 PM",59,29,30,,,,,,,,,,27,16,11,16,,,,18,17,1,20,43,45,24,21,49,11,3,5,5,0,0,0,0
"Aug 24, 2019 2:00 PM",63,28,35,,,,,,,,,,39,23,16,17,,,,14,12,2,25,35,42,14,28,50,5,4,7,5,2,2,0,2
"Aug 24, 2019 3:00 PM",42,18,24,,,,,,,,,,34,19,15,21,,,,18,18,0,9,37,57,17,40,36,6,10,10,6,4,1,0,1
"Aug 24, 2019 4:00 PM",51,27,24,,,,,,,,,,42,25,17,19,,,,19,17,2,9,22,43,19,24,46,9,2,6,3,3,0,0,0
"Aug 24, 2019 5:00 PM",58,23,35,,,,,,,,,,35,22,13,29,,,,21,19,2,17,26,29,16,13,40,6,3,4,3,1,1,1,0
"Aug 24, 2019 6:00 PM",52,24,28,,,,,,,,,,28,17,11,16,,,,22,21,1,15,22,38,17,21,31,1,2,2,0,2,1,0,1
"Aug 24, 2019 7:00 PM",39,24,15,,,,,,,,,,23,13,10,18,,,,10,8,2,6,9,23,19,4,30,3,2,2,1,1,0,0,0
"Aug 24, 2019 8:00 PM",35,14,21,,,,,,,,,,16,13,3,15,,,,4,4,0,5,13,13,9,4,19,2,0,4,3,1,0,0,0
"Aug 24, 2019 9:00 PM",22,9,13,,,,,,,,,,13,7,6,4,,,,4,4,0,6,7,6,2,4,8,0,1,0,0,0,1,0,1
"Aug 24, 2019 10:00 PM",23,11,12,,,,,,,,,,7,6,1,2,,,,6,4,2,7,7,5,2,3,13,2,1,0,0,0,1,1,0
"Aug 24, 2019 11:00 PM",8,3,5,,,,,,,,,,14,4,10,0,,,,8,8,0,2,4,4,3,1,2,0,0,0,0,0,0,0,0
"Aug 25, 2019 12:00 AM",6,0,6,,,,,,,,,,0,0,0,0,,,,2,2,0,6,4,3,2,1,3,0,0,0,0,0,0,0,0
"Aug 25, 2019 1:00 AM",7,2,5,,,,,,,,,,2,2,0,0,,,,4,3,1,1,3,2,2,0,3,0,1,0,0,0,0,0,0
"Aug 25, 2019 2:00 AM",3,1,2,,,,,,,,,,1,1,0,0,,,,2,2,0,1,3,1,0,1,2,0,1,0,0,0,0,0,0
"Aug 25, 2019 3:00 AM",4,0,4,,,,,,,,,,0,0,0,0,,,,1,1,0,0,1,0,0,0,1,0,1,0,0,0,0,0,0
"Aug 25, 2019 4:00 AM",3,1,2,,,,,,,,,,2,1,1,0,,,,3,2,1,1,2,1,0,1,0,0,0,0,0,0,0,0,0
"Aug 25, 2019 5:00 AM",5,3,2,,,,,,,,,,0,0,0,0,,,,3,3,0,1,6,3,0,3,4,1,0,0,0,0,0,0,0
"Aug 25, 2019 6:00 AM",9,2,7,,,,,,,,,,1,1,0,0,,,,2,2,0,3,31,3,0,3,11,0,1,0,0,0,0,0,0
"Aug 25, 2019 7:00 AM",13,7,6,,,,,,,,,,3,2,1,2,,,,9,6,3,3,23,18,9,9,12,3,1,0,0,0,0,0,0
"Aug 25, 2019 8:00 AM",23,13,10,,,,,,,,,,6,4,2,8,,,,2,0,2,8,26,19,9,10,23,3,0,1,0,1,0,0,0
"Aug 25, 2019 9:00 AM",36,23,13,,,,,,,,,,17,1,16,3,,,,11,9,2,17,32,25,16,9,72,5,2,3,3,0,1,0,1
"Aug 25, 2019 10:00 AM",30,16,14,,,,,,,,,,31,13,18,4,,,,14,11,3,16,36,40,12,28,37,4,4,6,3,3,3,0,3
"Aug 25, 2019 11:00 AM",50,25,25,,,,,,,,,,37,20,17,16,,,,12,10,2,26,45,30,13,17,33,7,9,8,4,4,1,1,0
"Aug 25, 2019 12:00 PM",43,14,29,,,,,,,,,,82,34,48,25,,,,17,16,1,21,57,35,14,21,34,6,3,6,3,3,2,2,0
"Aug 25, 2019 1:00 PM",51,24,27,,,,,,,,,,81,59,22,18,,,,29,27,2,17,45,51,15,36,44,11,5,6,5,1,1,0,1
"Aug 25, 2019 2:00 PM",46,25,21,,,,,,,,,,70,44,26,20,,,,24,23,1,19,40,48,10,38,50,6,4,3,2,1,2,2,0
"Aug 25, 2019 3:00 PM",39,22,17,,,,,,,,,,60,32,28,13,,,,19,18,1,16,24,23,10,13,34,10,8,7,5,2,5,1,4
"Aug 25, 2019 4:00 PM",30,15,15,,,,,,,,,,52,34,18,21,,,,20,18,2,8,21,36,24,12,32,12,7,2,1,1,0,0,0
"Aug 25, 2019 5:00 PM",47,24,23,,,,,,,,,,49,23,26,16,,,,11,9,2,12,21,59,41,18,35,10,4,12,6,6,1,0,1
"Aug 25, 2019 6:00 PM",38,13,25,,,,,,,,,,35,20,15,11,,,,9,8,1,12,25,50,23,27,41,4,3,3,1,2,0,0,0
"Aug 25, 2019 7:00 PM",37,14,23,,,,,,,,,,26,15,11,30,,,,10,10,0,10,18,35,21,14,31,7,2,5,2,3,2,2,0
"Aug 25, 2019 8:00 PM",28,15,13,,,,,,,,,,9,7,2,11,,,,11,9,2,12,9,17,13,4,25,0,1,2,0,2,2,2,0
"Aug 25, 2019 9:00 PM",18,3,15,,,,,,,,,,4,4,0,9,,,,7,7,0,9,6,5,5,0,8,1,1,0,0,0,0,0,0
"Aug 25, 2019 10:00 PM",21,7,14,,,,,,,,,,8,4,4,6,,,,4,4,0,4,4,5,2,3,5,1,0,4,1,3,0,0,0
"Aug 25, 2019 11:00 PM",12,6,6,,,,,,,,,,5,3,2,2,,,,4,3,1,1,1,2,2,0,3,0,0,2,1,1,0,0,0
"Aug 26, 2019 12:00 AM",5,1,4,,,,,,,,,,3,1,2,0,,,,2,2,0,2,2,0,0,0,2,0,0,0,0,0,0,0,0
"Aug 26, 2019 1:00 AM",2,0,2,,,,,,,,,,0,0,0,0,,,,2,2,0,1,2,0,0,0,1,1,1,0,0,0,0,0,0
"Aug 26, 2019 2:00 AM",2,0,2,,,,,,,,,,0,0,0,0,,,,1,1,0,0,2,0,0,0,1,1,1,0,0,0,0,0,0
"Aug 26, 2019 3:00 AM",0,0,0,,,,,,,,,,2,0,2,0,,,,1,1,0,0,1,1,0,1,0,0,0,0,0,0,0,0,0
"Aug 26, 2019 4:00 AM",0,0,0,,,,,,,,,,0,0,0,0,,,,0,0,0,2,1,0,0,0,1,0,0,0,0,0,0,0,0
"Aug 26, 2019 5:00 AM",9,5,4,,,,,,,,,,0,0,0,0,,,,2,1,1,4,6,0,0,0,13,2,0,0,0,0,0,0,0
"Aug 26, 2019 6:00 AM",54,36,18,,,,,,,,,,7,1,6,7,,,,10,8,2,36,23,11,8,3,55,0,0,1,1,0,0,0,0
"Aug 26, 2019 7:00 AM",188,146,42,,,,,,,,,,9,2,7,10,,,,28,21,7,140,44,39,28,11,164,2,5,5,3,2,1,1,0
"Aug 26, 2019 8:00 AM",367,298,69,,,,,,,,,,22,3,19,27,,,,52,34,18,262,62,94,71,23,327,9,8,11,6,5,2,2,0
"Aug 26, 2019 9:00 AM",180,142,38,,,,,,,,,,31,10,21,11,,,,20,15,5,99,24,40,20,20,117,2,3,3,3,0,2,1,1
"Aug 26, 2019 10:00 AM",50,38,12,,,,,,,,,,22,5,17,9,,,,8,7,1,42,24,22,8,14,34,5,4,5,4,1,4,1,3
"Aug 26, 2019 11:00 AM",40,24,16,,,,,,,,,,12,7,5,9,,,,16,15,1,20,9,18,11,7,26,3,2,3,3,0,0,0,0
"Aug 26, 2019 12:00 PM",44,20,24,,,,,,,,,,25,11,14,15,,,,16,10,6,19,24,41,14,27,31,3,6,3,3,0,1,1,0
"Aug 26, 2019 1:00 PM",64,33,31,,,,,,,,,,15,10,5,14,,,,20,15,5,21,26,24,12,12,30,5,9,4,3,1,0,0,0
"Aug 26, 2019 2:00 PM",61,30,31,,,,,,,,,,24,19,5,18,,,,27,26,1,13,19,24,7,17,33,9,2,4,3,1,2,0,2
"Aug 26, 2019 3:00 PM",73,30,43,,,,,,,,,,21,9,12,15,,,,35,33,2,17,43,32,16,16,31,8,4,6,4,2,1,0,1
"Aug 26, 2019 4:00 PM",141,33,108,,,,,,,,,,27,12,15,16,,,,51,46,5,29,80,57,15,42,47,4,2,4,3,1,2,1,1
"Aug 26, 2019 5:00 PM",334,73,261,,,,,,,,,,25,19,6,18,,,,166,163,3,48,201,99,18,81,83,9,2,13,8,5,8,6,2
"Aug 26, 2019 6:00 PM",340,66,274,,,,,,,,,,31,17,14,33,,,,187,177,10,39,203,127,14,113,61,4,7,9,7,2,3,3,0
"Aug 26, 2019 7:00 PM",158,39,119,,,,,,,,,,26,12,14,35,,,,91,86,5,26,88,89,21,68,48,7,5,3,1,2,3,0,3
"Aug 26, 2019 8:00 PM",69,17,52,,,,,,,,,,15,10,5,19,,,,44,43,1,21,35,42,20,22,44,5,7,2,1,1,0,0,0
"Aug 26, 2019 9:00 PM",39,10,29,,,,,,,,,,13,8,5,7,,,,22,20,2,18,22,22,13,9,19,1,0,3,2,1,1,1,0
"Aug 26, 2019 10:00 PM",30,11,19,,,,,,,,,,0,0,0,7,,,,11,9,2,5,9,2,0,2,12,1,0,2,1,1,0,0,0
"Aug 26, 2019 11:00 PM",19,6,13,,,,,,,,,,2,1,1,3,,,,5,4,1,6,5,2,1,1,1,0,2,3,1,2,0,0,0
"Aug 27, 2019 12:00 AM",9,2,7,,,,,,,,,,0,0,0,0,,,,4,3,1,1,4,4,3,1,3,0,0,1,1,0,1,0,1
"Aug 27, 2019 1:00 AM",1,0,1,,,,,,,,,,0,0,0,1,,,,2,2,0,0,0,1,0,1,0,1,1,1,1,0,2,2,0
"Aug 27, 2019 2:00 AM",2,0,2,,,,,,,,,,0,0,0,0,,,,3,3,0,1,2,0,0,0,0,0,0,1,1,0,0,0,0
"Aug 27, 2019 3:00 AM",1,1,0,,,,,,,,,,0,0,0,0,,,,0,0,0,0,0,0,0,0,1,0,0,2,1,1,0,0,0
"Aug 27, 2019 4:00 AM",1,0,1,,,,,,,,,,0,0,0,0,,,,0,0,0,1,0,0,0,0,0,0,0,0,0,0,0,0,0
"Aug 27, 2019 5:00 AM",7,5,2,,,,,,,,,,0,0,0,4,,,,3,1,2,9,5,0,0,0,13,2,0,0,0,0,0,0,0
"Aug 27, 2019 6:00 AM",62,41,21,,,,,,,,,,6,1,5,5,,,,6,4,2,31,25,10,7,3,59,0,6,0,0,0,0,0,0
"Aug 27, 2019 7:00 AM",250,192,58,,,,,,,,,,16,6,10,25,,,,43,31,12,189,48,48,33,15,217,3,3,3,3,0,2,1,1
"Aug 27, 2019 8:00 AM",396,305,91,,,,,,,,,,22,5,17,35,,,,57,47,10,284,65,124,95,29,374,4,8,6,5,1,4,1,3
"Aug 27, 2019 9:00 AM",193,155,38,,,,,,,,,,13,3,10,14,,,,23,15,8,100,42,49,33,16,92,5,5,11,8,3,5,1,4
"Aug 27, 2019 10:00 AM",59,40,19,,,,,,,,,,17,7,10,10,,,,19,12,7,39,26,18,7,11,30,2,4,5,4,1,0,0,0
"Aug 27, 2019 11:00 AM",56,38,18,,,,,,,,,,15,6,9,14,,,,6,4,2,29,19,28,20,8,25,2,2,3,1,2,0,0,0
"Aug 27, 2019 12:00 PM",51,25,26,,,,,,,,,,24,13,11,13,,,,16,15,1,27,19,20,14,6,35,5,1,7,5,2,1,1,0
"Aug 27, 2019 1:00 PM",74,33,41,,,,,,,,,,19,16,3,16,,,,24,20,4,19,25,26,15,11,29,4,2,8,5,3,3,3,0
"Aug 27, 2019 2:00 PM",53,23,30,,,,,,,,,,14,10,4,10,,,,26,24,2,20,20,15,5,10,29,4,3,4,2,2,1,0,1
"Aug 27, 2019 3:00 PM",74,33,41,,,,,,,,,,21,14,7,18,,,,34,30,4,19,33,25,7,18,31,7,3,4,3,1,1,1,0
"Aug 27, 2019 4:00 PM",146,40,106,,,,,,,,,,14,9,5,18,,,,51,48,3,32,81,47,7,40,41,5,5,5,3,2,1,0,1
"Aug 27, 2019 5:00 PM",337,66,271,,,,,,,,,,36,21,15,17,,,,197,190,7,41,208,92,22,70,87,6,3,1,0,1,0,0,0
"Aug 27, 2019 6:00 PM",338,78,260,,,,,,,,,,36,21,15,35,,,,220,215,5,43,232,103,14,89,58,3,6,9,6,3,5,3,2
"Aug 27, 2019 7:00 PM",176,29,147,,,,,,,,,,12,8,4,22,,,,85,80,5,30,79,54,7,47,41,4,1,1,1,0,0,0,0
"Aug 27, 2019 8:00 PM",97,30,67,,,,,,,,,,13,11,2,11,,,,47,45,2,15,52,23,5,18,21,1,1,8,2,6,0,0,0
"Aug 27, 2019 9:00 PM",56,16,40,,,,,,,,,,9,7,2,8,,,,23,23,0,10,24,11,3,8,20,2,0,1,1,0,0,0,0
"Aug 27, 2019 10:00 PM",28,4,24,,,,,,,,,,3,3,0,4,,,,16,15,1,8,13,6,4,2,11,1,0,1,0,1,0,0,0
"Aug 27, 2019 11:00 PM",19,4,15,,,,,,,,,,0,0,0,4,,,,7,6,1,4,5,3,2,1,5,0,0,1,1,0,1,0,1
"Aug 28, 2019 12:00 AM",13,5,8,,,,,,,,,,1,1,0,2,,,,1,1,0,1,6,0,0,0,1,1,0,1,1,0,1,0,1
"Aug 28, 2019 1:00 AM",4,0,4,,,,,,,,,,0,0,0,1,,,,1,1,0,0,1,0,0,0,2,0,1,0,0,0,0,0,0
"Aug 28, 2019 2:00 AM",2,1,1,,,,,,,,,,0,0,0,0,,,,1,1,0,0,2,0,0,0,1,0,0,0,0,0,0,0,0
"Aug 28, 2019 3:00 AM",1,0,1,,,,,,,,,,0,0,0,0,,,,1,1,0,0,0,0,0,0,1,1,0,1,0,1,0,0,0
"Aug 28, 2019 4:00 AM",3,2,1,,,,,,,,,,0,0,0,0,,,,2,2,0,1,0,0,0,0,0,0,0,0,0,0,1,0,1
"Aug 28, 2019 5:00 AM",8,6,2,,,,,,,,,,0,0,0,3,,,,2,1,1,5,5,0,0,0,11,3,0,0,0,0,0,0,0
"Aug 28, 2019 6:00 AM",53,43,10,,,,,,,,,,4,1,3,6,,,,13,8,5,35,25,6,5,1,58,1,1,1,1,0,1,0,1
"Aug 28, 2019 7:00 AM",207,160,47,,,,,,,,,,13,5,8,22,,,,35,26,9,158,31,37,30,7,190,5,3,6,3,3,3,0,3
"Aug 28, 2019 8:00 AM",419,335,84,,,,,,,,,,18,7,11,26,,,,53,39,14,273,65,80,58,22,333,7,10,8,6,2,2,1,1
"Aug 28, 2019 9:00 AM",164,139,25,,,,,,,,,,21,6,15,6,,,,28,17,11,101,28,50,27,23,102,5,4,11,8,3,2,0,2
"Aug 28, 2019 10:00 AM",66,54,12,,,,,,,,,,10,5,5,19,,,,10,9,1,28,16,22,8,14,38,1,4,3,1,2,1,0,1
"Aug 28, 2019 11:00 AM",44,28,16,,,,,,,,,,14,3,11,7,,,,15,13,2,22,16,23,6,17,23,2,1,5,2,3,0,0,0
"Aug 28, 2019 12:00 PM",56,25,31,,,,,,,,,,24,19,5,15,,,,13,10,3,16,26,22,9,13,33,7,3,3,3,0,0,0,0
"Aug 28, 2019 1:00 PM",78,35,43,,,,,,,,,,13,8,5,19,,,,27,19,8,18,16,24,9,15,30,3,5,0,0,0,1,0,1
"Aug 28, 2019 2:00 PM",71,29,42,,,,,,,,,,21,13,8,12,,,,25,21,4,19,20,18,8,10,32,7,3,5,4,1,1,1,0
"Aug 28, 2019 3:00 PM",68,27,41,,,,,,,,,,17,12,5,25,,,,32,27,5,23,40,30,9,21,29,4,2,2,1,1,0,0,0
"Aug 28, 2019 4:00 PM",137,30,107,,,,,,,,,,20,11,9,19,,,,42,41,1,19,74,42,8,34,51,3,2,5,3,2,1,1,0
"Aug 28, 2019 5:00 PM",325,69,256,,,,,,,,,,35,23,12,37,,,,155,151,4,34,199,93,20,73,78,12,5,8,3,5,2,1,1
"Aug 28, 2019 6:00 PM",303,55,248,,,,,,,,,,24,14,10,33,,,,214,209,5,47,187,110,20,90,68,3,4,8,6,2,8,6,2
"Aug 28, 2019 7:00 PM",147,44,103,,,,,,,,,,16,10,6,27,,,,80,76,4,34,81,52,14,38,32,4,3,12,3,9,3,0,3
"Aug 28, 2019 8:00 PM",115,27,88,,,,,,,,,,10,7,3,21,,,,42,40,2,15,50,32,9,23,43,4,8,1,1,0,0,0,0
"Aug 28, 2019 9:00 PM",60,18,42,,,,,,,,,,9,6,3,6,,,,22,20,2,10,30,13,5,8,25,4,2,6,3,3,1,0,1
"Aug 28, 2019 10:00 PM",31,9,22,,,,,,,,,,4,3,1,1,,,,17,16,1,5,13,7,3,4,5,2,0,0,0,0,0,0,0
"Aug 28, 2019 11:00 PM",17,6,11,,,,,,,,,,1,1,0,1,,,,11,11,0,4,10,1,1,0,2,1,0,1,0,1,0,0,0
"Aug 29, 2019 12:00 AM",4,0,4,,,,,,,,,,2,0,2,0,,,,7,7,0,3,4,1,1,0,3,0,1,0,0,0,0,0,0
"Aug 29, 2019 1:00 AM",3,1,2,,,,,,,,,,0,0,0,2,,,,2,2,0,0,1,0,0,0,2,0,0,0,0,0,0,0,0
"Aug 29, 2019 2:00 AM",1,0,1,,,,,,,,,,1,1,0,0,,,,1,1,0,0,3,0,0,0,0,1,0,0,0,0,0,0,0
"Aug 29, 2019 3:00 AM",2,1,1,,,,,,,,,,0,0,0,1,,,,2,2,0,0,1,0,0,0,1,0,0,0,0,0,0,0,0
"Aug 29, 2019 4:00 AM",3,3,0,,,,,,,,,,0,0,0,0,,,,1,1,0,1,0,0,0,0,0,1,0,0,0,0,1,0,1
"Aug 29, 2019 5:00 AM",5,3,2,,,,,,,,,,1,1,0,4,,,,2,1,1,8,5,0,0,0,13,3,0,0,0,0,1,1,0
"Aug 29, 2019 6:00 AM",41,28,13,,,,,,,,,,5,0,5,7,,,,11,6,5,33,22,10,7,3,56,3,3,0,0,0,0,0,0
"Aug 29, 2019 7:00 AM",198,142,56,,,,,,,,,,14,2,12,23,,,,28,21,7,138,40,50,32,18,161,1,2,6,4,2,1,0,1
"Aug 29, 2019 8:00 AM",387,294,93,,,,,,,,,,33,8,25,40,,,,62,48,14,239,70,84,63,21,329,4,11,6,4,2,5,4,1
"Aug 29, 2019 9:00 AM",165,133,32,,,,,,,,,,19,8,11,8,,,,24,11,13,112,23,46,29,17,99,6,5,8,7,1,5,0,5
"Aug 29, 2019 10:00 AM",63,44,19,,,,,,,,,,10,4,6,11,,,,6,6,0,31,18,30,16,14,31,2,7,7,5,2,3,2,1
"Aug 29, 2019 11:00 AM",39,26,13,,,,,,,,,,12,5,7,14,,,,7,5,2,14,20,8,4,4,24,3,1,4,3,1,1,1,0
"Aug 29, 2019 12:00 PM",44,13,31,,,,,,,,,,17,5,12,13,,,,12,10,2,26,18,8,5,3,29,6,1,4,4,0,1,0,1
"Aug 29, 2019 1:00 PM",87,34,53,,,,,,,,,,9,6,3,7,,,,15,14,1,18,23,23,8,15,28,5,1,7,6,1,2,1,1
"Aug 29, 2019 2:00 PM",65,26,39,,,,,,,,,,14,11,3,8,,,,25,21,4,14,25,21,11,10,16,3,7,1,1,0,1,1,0
"Aug 29, 2019 3:00 PM",64,20,44,,,,,,,,,,14,10,4,9,,,,34,30,4,22,37,29,5,24,31,9,2,3,2,1,1,1,0
"Aug 29, 2019 4:00 PM",133,32,101,,,,,,,,,,18,7,11,25,,,,48,47,1,37,73,31,10,21,46,5,1,3,2,1,3,3,0
"Aug 29, 2019 5:00 PM",279,75,204,,,,,,,,,,15,10,5,21,,,,147,142,5,48,198,93,16,77,68,3,3,7,3,4,1,1,0
"Aug 29, 2019 6:00 PM",272,66,206,,,,,,,,,,22,12,10,28,,,,172,170,2,40,184,71,8,63,61,7,4,9,5,4,3,0,3
"Aug 29, 2019 7:00 PM",131,37,94,,,,,,,,,,18,11,7,12,,,,70,65,5,14,77,34,2,32,27,2,3,8,6,2,0,0,0
"Aug 29, 2019 8:00 PM",84,18,66,,,,,,,,,,11,3,8,18,,,,37,34,3,15,39,26,11,15,26,4,1,9,5,4,0,0,0
"Aug 29, 2019 9:00 PM",53,11,42,,,,,,,,,,11,7,4,11,,,,24,23,1,8,24,10,1,9,10,1,1,3,3,0,1,1,0
"Aug 29, 2019 10:00 PM",36,10,26,,,,,,,,,,7,6,1,6,,,,12,11,1,6,15,7,4,3,11,2,0,1,1,0,1,0,1
"Aug 29, 2019 11:00 PM",22,3,19,,,,,,,,,,3,3,0,2,,,,11,11,0,4,8,6,5,1,7,1,0,1,1,0,2,1,1
"Aug 30, 2019 12:00 AM",9,3,6,,,,,,,,,,0,0,0,2,,,,3,3,0,3,5,2,0,2,8,0,0,0,0,0,1,0,1
"Aug 30, 2019 1:00 AM",5,1,4,,,,,,,,,,0,0,0,0,,,,2,2,0,0,4,0,0,0,2,0,0,0,0,0,0,0,0
"Aug 30, 2019 2:00 AM",3,0,3,,,,,,,,,,1,1,0,0,,,,2,2,0,0,5,1,0,1,2,1,0,0,0,0,0,0,0
"Aug 30, 2019 3:00 AM",5,0,5,,,,,,,,,,2,2,0,0,,,,1,1,0,0,0,0,0,0,2,0,0,1,0,1,0,0,0
"Aug 30, 2019 4:00 AM",3,2,1,,,,,,,,,,0,0,0,0,,,,1,1,0,1,1,1,0,1,0,0,0,0,0,0,1,0,1
"Aug 30, 2019 5:00 AM",7,5,2,,,,,,,,,,0,0,0,2,,,,2,2,0,6,3,2,0,2,12,3,0,0,0,0,0,0,0
"Aug 30, 2019 6:00 AM",36,26,10,,,,,,,,,,3,0,3,8,,,,12,10,2,30,15,10,6,4,44,2,3,1,1,0,0,0,0
"Aug 30, 2019 7:00 AM",139,106,33,,,,,,,,,,11,6,5,12,,,,24,17,7,115,31,28,20,8,113,1,1,12,9,3,1,0,1
"Aug 30, 2019 8:00 AM",320,244,76,,,,,,,,,,27,2,25,27,,,,37,27,10,191,49,67,50,17,240,8,3,15,12,3,4,2,2
"Aug 30, 2019 9:00 AM",133,113,20,,,,,,,,,,16,9,7,5,,,,15,9,6,90,20,30,15,15,75,3,4,6,4,2,2,0,2
"Aug 30, 2019 10:00 AM",53,35,18,,,,,,,,,,5,2,3,1,,,,7,4,3,18,12,10,5,5,21,4,5,6,4,2,1,1,0
"Aug 30, 2019 11:00 AM",31,19,12,,,,,,,,,,4,1,3,8,,,,4,3,1,16,10,14,6,8,17,3,4,3,0,3,0,0,0
"Aug 30, 2019 12:00 PM",48,19,29,,,,,,,,,,13,9,4,5,,,,14,13,1,22,18,10,3,7,27,7,3,4,4,0,0,0,0
"Aug 30, 2019 1:00 PM",93,30,63,,,,,,,,,,9,4,5,11,,,,22,20,2,15,26,18,3,15,27,6,2,2,2,0,2,1,1
"Aug 30, 2019 2:00 PM",70,31,39,,,,,,,,,,23,15,8,10,,,,12,12,0,16,17,15,7,8,16,6,0,1,1,0,2,1,1
"Aug 30, 2019 3:00 PM",75,21,54,,,,,,,,,,10,4,6,20,,,,23,23,0,19,27,12,4,8,36,3,1,11,4,7,2,2,0
"Aug 30, 2019 4:00 PM",104,25,79,,,,,,,,,,22,14,8,20,,,,52,48,4,26,58,48,14,34,35,3,6,2,1,1,1,1,0
"Aug 30, 2019 5:00 PM",228,47,181,,,,,,,,,,20,12,8,45,,,,114,110,4,26,131,70,12,58,43,3,7,3,2,1,2,2,0
"Aug 30, 2019 6:00 PM",177,32,145,,,,,,,,,,21,16,5,18,,,,135,132,3,22,119,62,12,50,36,1,1,4,2,2,1,1,0
"Aug 30, 2019 7:00 PM",98,26,72,,,,,,,,,,10,7,3,11,,,,43,42,1,13,51,23,4,19,23,3,2,7,5,2,1,1,0
"Aug 30, 2019 8:00 PM",52,14,38,,,,,,,,,,9,8,1,9,,,,19,18,1,10,24,17,7,10,13,4,1,2,1,1,0,0,0
"Aug 30, 2019 9:00 PM",40,13,27,,,,,,,,,,5,2,3,6,,,,13,12,1,1,14,10,5,5,9,1,0,2,1,1,1,1,0
"Aug 30, 2019 10:00 PM",22,4,18,,,,,,,,,,6,5,1,6,,,,14,13,1,2,12,2,0,2,12,1,5,2,1,1,1,1,0
"Aug 30, 2019 11:00 PM",17,2,15,,,,,,,,,,3,3,0,4,,,,5,5,0,5,5,9,7,2,4,1,2,0,0,0,0,0,0
"Aug 31, 2019 12:00 AM",7,3,4,,,,,,,,,,1,0,1,1,,,,7,7,0,2,4,2,1,1,5,1,0,0,0,0,0,0,0
"Aug 31, 2019 1:00 AM",9,3,6,,,,,,,,,,0,0,0,2,,,,3,3,0,0,2,2,1,1,4,0,1,0,0,0,0,0,0
"Aug 31, 2019 2:00 AM",2,0,2,,,,,,,,,,4,4,0,0,,,,2,2,0,0,6,1,0,1,4,0,0,0,0,0,0,0,0
"Aug 31, 2019 3:00 AM",5,2,3,,,,,,,,,,0,0,0,1,,,,3,3,0,0,1,0,0,0,1,0,1,0,0,0,3,3,0
"Aug 31, 2019 4:00 AM",3,2,1,,,,,,,,,,0,0,0,0,,,,2,1,1,0,1,1,0,1,0,0,0,0,0,0,0,0,0
"Aug 31, 2019 5:00 AM",1,0,1,,,,,,,,,,0,0,0,0,,,,2,2,0,0,1,2,0,2,1,0,0,0,0,0,0,0,0
"Aug 31, 2019 6:00 AM",9,3,6,,,,,,,,,,0,0,0,1,,,,4,4,0,4,7,1,0,1,5,1,0,0,0,0,0,0,0
"Aug 31, 2019 7:00 AM",13,5,8,,,,,,,,,,2,0,2,1,,,,5,3,2,6,8,2,0,2,10,1,2,3,3,0,0,0,0
"Aug 31, 2019 8:00 AM",31,21,10,,,,,,,,,,8,4,4,8,,,,6,6,0,18,14,11,5,6,17,1,3,1,0,1,0,0,0
"Aug 31, 2019 9:00 AM",32,20,12,,,,,,,,,,13,5,8,5,,,,8,5,3,17,23,17,5,12,27,3,5,1,1,0,0,0,0
"Aug 31, 2019 10:00 AM",37,22,15,,,,,,,,,,12,4,8,6,,,,16,12,4,16,23,21,14,7,23,4,1,3,3,0,3,2,1
"Aug 31, 2019 11:00 AM",44,24,20,,,,,,,,,,26,9,17,10,,,,11,8,3,11,36,34,8,26,32,3,4,4,1,3,1,0,1
"Aug 31, 2019 12:00 PM",59,30,29,,,,,,,,,,26,17,9,28,,,,8,7,1,11,25,33,4,29,21,3,7,5,2,3,0,0,0
"Aug 31, 2019 1:00 PM",54,26,28,,,,,,,,,,17,9,8,25,,,,12,11,1,27,27,34,13,21,18,2,1,4,2,2,0,0,0
"Aug 31, 2019 2:00 PM",47,29,18,,,,,,,,,,19,9,10,13,,,,10,9,1,18,23,41,27,14,17,5,4,2,1,1,0,0,0
"Aug 31, 2019 3:00 PM",44,23,21,,,,,,,,,,9,6,3,16,,,,15,12,3,15,12,18,9,9,21,8,3,3,1,2,1,1,0
"Aug 31, 2019 4:00 PM",31,17,14,,,,,,,,,,20,13,7,12,,,,18,17,1,19,20,29,16,13,22,4,2,4,2,2,0,0,0
"Aug 31, 2019 5:00 PM",44,22,22,,,,,,,,,,21,7,14,23,,,,19,17,2,16,22,19,13,6,20,3,1,0,0,0,0,0,0
"Aug 31, 2019 6:00 PM",51,23,28,,,,,,,,,,20,12,8,5,,,,17,17,0,13,12,15,9,6,25,1,3,4,1,3,0,0,0
"Aug 31, 2019 7:00 PM",38,20,18,,,,,,,,,,10,4,6,5,,,,9,8,1,4,17,9,3,6,20,0,2,2,0,2,1,1,0
"Aug 31, 2019 8:00 PM",35,19,16,,,,,,,,,,5,3,2,9,,,,13,10,3,7,18,3,2,1,13,2,0,6,5,1,0,0,0
"Aug 31, 2019 9:00 PM",17,9,8,,,,,,,,,,7,6,1,3,,,,4,4,0,7,5,5,3,2,8,0,1,0,0,0,0,0,0
"Aug 31, 2019 10:00 PM",18,5,13,,,,,,,,,,1,1,0,1,,,,11,9,2,8,5,1,0,1,9,0,3,0,0,0,0,0,0
"Aug 31, 2019 11:00 PM",5,0,5,,,,,,,,,,2,2,0,2,,,,2,2,0,6,2,3,3,0,6,1,0,0,0,0,0,0,0
"Sep 1, 2019 12:00 AM",12,3,9,,,,,,,,,,0,0,0,11,,,,5,5,0,5,7,1,0,1,3,0,0,0,0,0,0,0,0
"Sep 1, 2019 1:00 AM",3,0,3,,,,,,,,,,0,0,0,0,,,,1,1,0,0,2,0,0,0,1,0,2,0,0,0,0,0,0
"Sep 1, 2019 2:00 AM",9,2,7,,,,,,,,,,0,0,0,3,,,,3,3,0,0,5,2,2,0,2,0,0,0,0,0,0,0,0
"Sep 1, 2019 3:00 AM",1,1,0,,,,,,,,,,0,0,0,0,,,,2,2,0,0,2,0,0,0,0,0,1,0,0,0,0,0,0
"Sep 1, 2019 4:00 AM",7,1,6,,,,,,,,,,0,0,0,0,,,,3,3,0,0,0,1,1,0,0,0,0,0,0,0,0,0,0
"Sep 1, 2019 5:00 AM",1,0,1,,,,,,,,,,0,0,0,0,,,,0,0,0,1,3,0,0,0,3,0,0,0,0,0,0,0,0
"Sep 1, 2019 6:00 AM",6,2,4,,,,,,,,,,0,0,0,1,,,,3,3,0,3,3,0,0,0,12,2,1,2,2,0,0,0,0
"Sep 1, 2019 7:00 AM",12,7,5,,,,,,,,,,1,1,0,0,,,,10,6,4,3,14,6,3,3,11,1,2,1,1,0,0,0,0
"Sep 1, 2019 8:00 AM",24,5,19,,,,,,,,,,10,3,7,4,,,,10,7,3,13,13,11,6,5,15,2,10,1,0,1,0,0,0
"Sep 1, 2019 9:00 AM",35,26,9,,,,,,,,,,10,1,9,4,,,,10,9,1,17,33,35,11,24,25,4,8,6,4,2,5,3,2
"Sep 1, 2019 10:00 AM",58,38,20,,,,,,,,,,25,8,17,17,,,,18,16,2,22,29,27,13,14,45,5,15,10,2,8,3,0,3
"Sep 1, 2019 11:00 AM",48,30,18,,,,,,,,,,43,23,20,18,,,,7,6,1,28,35,40,14,26,40,8,9,7,2,5,2,2,0
"Sep 1, 2019 12:00 PM",47,22,25,,,,,,,,,,35,21,14,36,,,,21,17,4,17,37,51,17,34,39,13,5,8,1,7,7,7,0
"Sep 1, 2019 1:00 PM",48,24,24,,,,,,,,,,32,19,13,14,,,,18,16,2,23,34,32,15,17,34,12,6,8,7,1,0,0,0
"Sep 1, 2019 2:00 PM",46,22,24,,,,,,,,,,46,25,21,18,,,,15,13,2,20,35,40,24,16,35,5,1,2,1,1,0,0,0
"Sep 1, 2019 3:00 PM",40,20,20,,,,,,,,,,31,20,11,15,,,,21,18,3,6,18,41,19,22,28,4,4,4,2,2,4,1,3
"Sep 1, 2019 4:00 PM",31,20,11,,,,,,,,,,45,25,20,13,,,,15,12,3,12,19,37,24,13,21,3,1,7,4,3,1,0,1
"Sep 1, 2019 5:00 PM",43,23,20,,,,,,,,,,32,21,11,12,,,,11,11,0,14,28,29,17,12,21,5,1,6,3,3,1,0,1
"Sep 1, 2019 6:00 PM",36,16,20,,,,,,,,,,41,20,21,9,,,,16,14,2,10,18,22,7,15,31,1,2,4,4,0,1,1,0
"Sep 1, 2019 7:00 PM",35,17,18,,,,,,,,,,21,11,10,6,,,,4,2,2,10,16,14,13,1,21,1,1,5,3,2,2,1,1
"Sep 1, 2019 8:00 PM",29,9,20,,,,,,,,,,10,6,4,6,,,,10,10,0,14,9,10,3,7,15,5,2,1,1,0,0,0,0
"Sep 1, 2019 9:00 PM",14,7,7,,,,,,,,,,3,1,2,1,,,,8,6,2,6,10,5,3,2,7,2,3,0,0,0,0,0,0
"Sep 1, 2019 10:00 PM",12,6,6,,,,,,,,,,1,0,1,4,,,,7,7,0,2,3,1,1,0,9,2,0,1,1,0,0,0,0
"Sep 1, 2019 11:00 PM",8,0,8,,,,,,,,,,4,4,0,0,,,,2,2,0,4,1,1,0,1,4,1,0,0,0,0,0,0,0
"Sep 2, 2019 12:00 AM",2,0,2,,,,,,,,,,1,1,0,1,,,,2,2,0,2,1,1,0,1,0,0,1,0,0,0,0,0,0
"Sep 2, 2019 1:00 AM",1,1,0,,,,,,,,,,0,0,0,1,,,,2,2,0,0,2,0,0,0,1,1,0,0,0,0,0,0,0
"Sep 2, 2019 2:00 AM",1,1,0,,,,,,,,,,0,0,0,2,,,,1,1,0,0,4,1,1,0,1,0,0,1,0,1,0,0,0
"Sep 2, 2019 3:00 AM",0,0,0,,,,,,,,,,0,0,0,0,,,,0,0,0,0,0,1,0,1,1,0,0,0,0,0,0,0,0
"Sep 2, 2019 4:00 AM",1,0,1,,,,,,,,,,0,0,0,0,,,,0,0,0,1,0,0,0,0,0,0,0,0,0,0,0,0,0
"Sep 2, 2019 5:00 AM",11,8,3,,,,,,,,,,0,0,0,5,,,,0,0,0,7,3,0,0,0,9,2,0,0,0,0,0,0,0
"Sep 2, 2019 6:00 AM",51,33,18,,,,,,,,,,8,0,8,10,,,,7,6,1,47,12,9,5,4,56,1,1,3,3,0,1,0,1
"Sep 2, 2019 7:00 AM",229,178,51,,,,,,,,,,16,4,12,19,,,,40,29,11,137,46,49,35,14,178,4,4,11,10,1,8,1,7
"Sep 2, 2019 8:00 AM",435,341,94,,,,,,,,,,38,6,32,36,,,,42,33,9,278,56,112,88,24,393,7,8,14,11,3,8,1,7
"Sep 2, 2019 9:00 AM",186,146,40,,,,,,,,,,14,5,9,13,,,,23,11,12,122,30,48,29,19,115,2,3,5,3,2,0,0,0
"Sep 2, 2019 10:00 AM",77,54,23,,,,,,,,,,10,3,7,6,,,,7,4,3,38,10,17,6,11,24,3,3,3,1,2,0,0,0
"Sep 2, 2019 11:00 AM",37,18,19,,,,,,,,,,13,5,8,9,,,,10,8,2,19,16,14,5,9,24,4,1,0,0,0,0,0,0
"Sep 2, 2019 12:00 PM",51,21,30,,,,,,,,,,23,13,10,3,,,,21,17,4,11,14,15,7,8,26,2,0,4,4,0,0,0,0
"Sep 2, 2019 1:00 PM",57,24,33,,,,,,,,,,6,3,3,6,,,,14,14,0,12,14,11,3,8,11,3,4,6,2,4,1,0,1
"Sep 2, 2019 2:00 PM",46,19,27,,,,,,,,,,13,9,4,5,,,,14,14,0,8,16,16,8,8,9,4,0,3,2,1,6,6,0
"Sep 2, 2019 3:00 PM",62,24,38,,,,,,,,,,6,3,3,9,,,,21,21,0,19,27,14,3,11,29,7,3,4,4,0,4,2,2
"Sep 2, 2019 4:00 PM",138,38,100,,,,,,,,,,11,6,5,11,,,,70,65,5,22,71,30,5,25,37,3,4,5,1,4,5,5,0
"Sep 2, 2019 5:00 PM",329,56,273,,,,,,,,,,16,9,7,30,,,,174,170,4,39,227,92,16,76,71,4,2,7,4,3,3,0,3
"Sep 2, 2019 6:00 PM",276,50,226,,,,,,,,,,27,19,8,26,,,,195,189,6,35,205,95,9,86,48,10,3,12,7,5,6,2,4
"Sep 2, 2019 7:00 PM",137,32,105,,,,,,,,,,12,9,3,21,,,,84,82,2,20,77,38,8,30,25,8,3,6,2,4,1,1,0
"Sep 2, 2019 8:00 PM",70,15,55,,,,,,,,,,8,4,4,6,,,,39,36,3,14,31,14,4,10,15,1,4,9,2,7,3,3,0
"Sep 2, 2019 9:00 PM",42,8,34,,,,,,,,,,2,2,0,7,,,,23,22,1,8,15,5,0,5,14,2,1,6,2,4,2,2,0
"Sep 2, 2019 10:00 PM",21,4,17,,,,,,,,,,1,1,0,2,,,,9,8,1,2,15,1,0,1,9,1,0,1,1,0,1,0,1
"Sep 2, 2019 11:00 PM",13,4,9,,,,,,,,,,0,0,0,0,,,,6,6,0,3,5,1,0,1,3,2,1,1,0,1,0,0,0
"Sep 3, 2019 12:00 AM",9,2,7,,,,,,,,,,0,0,0,1,,,,4,4,0,2,3,1,0,1,1,0,1,0,0,0,0,0,0
"Sep 3, 2019 1:00 AM",3,0,3,,,,,,,,,,0,0,0,0,,,,2,2,0,0,0,1,0,1,1,0,0,0,0,0,0,0,0
"Sep 3, 2019 2:00 AM",1,1,0,,,,,,,,,,0,0,0,0,,,,1,1,0,0,1,0,0,0,0,0,0,0,0,0,0,0,0
"Sep 3, 2019 3:00 AM",1,1,0,,,,,,,,,,0,0,0,0,,,,0,0,0,1,1,0,0,0,1,0,0,0,0,0,0,0,0
"Sep 3, 2019 4:00 AM",3,2,1,,,,,,,,,,0,0,0,0,,,,0,0,0,1,1,0,0,0,0,0,0,0,0,0,0,0,0
"Sep 3, 2019 5:00 AM",10,10,0,,,,,,,,,,0,0,0,4,,,,0,0,0,5,4,0,0,0,14,1,0,0,0,0,0,0,0
"Sep 3, 2019 6:00 AM",51,39,12,,,,,,,,,,8,2,6,5,,,,10,9,1,41,24,11,8,3,48,1,4,2,2,0,2,0,2
"Sep 3, 2019 7:00 AM",218,164,54,,,,,,,,,,16,5,11,23,,,,32,27,5,165,38,43,32,11,224,3,3,6,5,1,0,0,0
"Sep 3, 2019 8:00 AM",455,367,88,,,,,,,,,,43,10,33,47,,,,63,48,15,322,69,112,85,27,368,9,10,21,18,3,1,0,1
"Sep 3, 2019 9:00 AM",187,154,33,,,,,,,,,,13,3,10,11,,,,32,18,14,109,27,36,24,12,115,4,5,6,5,1,2,1,1
"Sep 3, 2019 10:00 AM",54,39,15,,,,,,,,,,8,4,4,10,,,,10,7,3,30,20,21,10,11,39,3,7,2,1,1,1,1,0
"Sep 3, 2019 11:00 AM",43,28,15,,,,,,,,,,10,2,8,8,,,,16,14,2,28,15,19,8,11,23,2,1,3,3,0,0,0,0
"Sep 3, 2019 12:00 PM",50,25,25,,,,,,,,,,24,12,12,15,,,,11,10,1,21,27,26,12,14,25,2,3,5,4,1,1,0,1
"Sep 3, 2019 1:00 PM",73,37,36,,,,,,,,,,19,10,9,15,,,,30,27,3,17,27,26,10,16,25,1,2,4,2,2,0,0,0
"Sep 3, 2019 2:00 PM",71,34,37,,,,,,,,,,20,6,14,20,,,,17,16,1,7,17,27,12,15,21,3,4,4,2,2,2,2,0
"Sep 3, 2019 3:00 PM",72,21,51,,,,,,,,,,8,5,3,11,,,,32,29,3,19,26,17,8,9,33,9,1,8,4,4,0,0,0
"Sep 3, 2019 4:00 PM",144,39,105,,,,,,,,,,15,9,6,14,,,,68,67,1,31,91,45,13,32,37,5,4,4,1,3,2,2,0
"Sep 3, 2019 5:00 PM",332,71,261,,,,,,,,,,23,15,8,32,,,,213,206,7,43,235,95,10,85,73,8,6,11,9,2,1,0,1
"Sep 3, 2019 6:00 PM",334,54,280,,,,,,,,,,33,20,13,21,,,,210,204,6,51,207,91,9,82,58,5,4,12,9,3,4,1,3
"Sep 3, 2019 7:00 PM",152,26,126,,,,,,,,,,12,9,3,15,,,,97,93,4,17,83,32,5,27,31,7,1,9,4,5,3,3,0
"Sep 3, 2019 8:00 PM",102,33,69,,,,,,,,,,9,3,6,15,,,,43,41,2,17,46,21,4,17,20,3,2,7,2,5,3,3,0
"Sep 3, 2019 9:00 PM",41,14,27,,,,,,,,,,2,1,1,6,,,,28,27,1,8,17,10,1,9,14,1,1,1,0,1,1,1,0
"Sep 3, 2019 10:00 PM",35,8,27,,,,,,,,,,3,2,1,6,,,,13,11,2,5,13,6,1,5,7,1,1,1,1,0,0,0,0
"Sep 3, 2019 11:00 PM",7,2,5,,,,,,,,,,1,1,0,0,,,,9,9,0,4,6,4,0,4,4,0,0,0,0,0,0,0,0
"Sep 4, 2019 12:00 AM",4,1,3,,,,,,,,,,1,1,0,4,,,,5,4,1,1,5,1,0,1,6,0,0,0,0,0,0,0,0
"Sep 4, 2019 1:00 AM",3,1,2,,,,,,,,,,0,0,0,0,,,,1,1,0,1,2,0,0,0,1,0,1,0,0,0,0,0,0
"Sep 4, 2019 2:00 AM",1,0,1,,,,,,,,,,0,0,0,0,,,,1,1,0,0,3,0,0,0,0,0,0,0,0,0,0,0,0
"Sep 4, 2019 3:00 AM",2,2,0,,,,,,,,,,0,0,0,0,,,,0,0,0,0,0,0,0,0,1,2,0,0,0,0,0,0,0
"Sep 4, 2019 4:00 AM",2,1,1,,,,,,,,,,0,0,0,0,,,,0,0,0,1,0,0,0,0,1,0,0,0,0,0,0,0,0
"Sep 4, 2019 5:00 AM",8,6,2,,,,,,,,,,0,0,0,4,,,,1,1,0,11,5,0,0,0,17,3,0,0,0,0,0,0,0
"Sep 4, 2019 6:00 AM",58,47,11,,,,,,,,,,6,1,5,7,,,,10,7,3,32,21,8,5,3,54,1,3,2,2,0,1,0,1
"Sep 4, 2019 7:00 AM",217,163,54,,,,,,,,,,9,3,6,15,,,,34,30,4,166,44,35,27,8,191,0,4,9,7,2,3,1,2
"Sep 4, 2019 8:00 AM",459,374,85,,,,,,,,,,36,5,31,30,,,,61,42,19,284,69,106,83,23,363,12,8,18,15,3,4,2,2
"Sep 4, 2019 9:00 AM",224,185,39,,,,,,,,,,22,11,11,15,,,,25,15,10,128,34,48,26,22,93,2,3,6,1,5,0,0,0
"Sep 4, 2019 10:00 AM",61,45,16,,,,,,,,,,8,3,5,4,,,,10,8,2,34,12,14,6,8,33,3,1,5,2,3,2,2,0
"Sep 4, 2019 11:00 AM",50,29,21,,,,,,,,,,13,5,8,6,,,,9,9,0,14,10,8,4,4,16,1,2,2,2,0,2,1,1
"Sep 4, 2019 12:00 PM",69,30,39,,,,,,,,,,11,8,3,9,,,,17,16,1,13,21,5,2,3,25,3,3,5,4,1,0,0,0
"Sep 4, 2019 1:00 PM",74,31,43,,,,,,,,,,17,13,4,9,,,,18,17,1,27,30,12,3,9,21,0,0,2,0,2,2,2,0
"Sep 4, 2019 2:00 PM",68,23,45,,,,,,,,,,11,8,3,13,,,,20,18,2,9,19,8,1,7,17,5,2,2,2,0,0,0,0
"Sep 4, 2019 3:00 PM",84,21,63,,,,,,,,,,14,11,3,10,,,,42,39,3,34,29,14,4,10,24,4,2,6,2,4,0,0,0
"Sep 4, 2019 4:00 PM",146,37,109,,,,,,,,,,13,11,2,21,,,,72,66,6,23,82,30,3,27,31,9,3,3,0,3,4,4,0
"Sep 4, 2019 5:00 PM",315,65,250,,,,,,,,,,17,11,6,16,,,,156,152,4,39,198,79,8,71,81,7,2,4,3,1,1,1,0
"Sep 4, 2019 6:00 PM",284,60,224,,,,,,,,,,13,11,2,22,,,,181,178,3,40,166,80,10,70,45,5,6,6,4,2,1,0,1
"Sep 4, 2019 7:00 PM",143,39,104,,,,,,,,,,11,8,3,12,,,,87,86,1,30,54,32,3,29,32,5,3,3,1,2,1,1,0
"Sep 4, 2019 8:00 PM",77,10,67,,,,,,,,,,5,3,2,12,,,,44,41,3,14,44,21,3,18,20,5,4,4,1,3,2,2,0
"Sep 4, 2019 9:00 PM",60,12,48,,,,,,,,,,2,2,0,9,,,,27,27,0,11,19,6,0,6,14,2,0,0,0,0,0,0,0
"Sep 4, 2019 10:00 PM",32,9,23,,,,,,,,,,1,1,0,1,,,,24,22,2,6,17,7,3,4,10,2,0,1,1,0,0,0,0
"Sep 4, 2019 11:00 PM",20,3,17,,,,,,,,,,2,1,1,4,,,,12,10,2,4,3,3,2,1,2,2,0,1,0,1,0,0,0
"Sep 5, 2019 12:00 AM",7,4,3,,,,,,,,,,0,0,0,3,,,,3,3,0,2,9,0,0,0,3,0,0,0,0,0,0,0,0
"Sep 5, 2019 1:00 AM",3,0,3,,,,,,,,,,2,2,0,1,,,,1,1,0,1,3,0,0,0,1,1,0,1,0,1,0,0,0
"Sep 5, 2019 2:00 AM",4,0,4,,,,,,,,,,1,1,0,0,,,,3,3,0,1,2,0,0,0,0,0,0,0,0,0,0,0,0
"Sep 5, 2019 3:00 AM",2,1,1,,,,,,,,,,0,0,0,0,,,,1,1,0,0,3,0,0,0,0,1,0,0,0,0,0,0,0
"Sep 5, 2019 4:00 AM",3,2,1,,,,,,,,,,0,0,0,0,,,,3,3,0,1,0,0,0,0,0,0,0,1,1,0,0,0,0
"Sep 5, 2019 5:00 AM",5,3,2,,,,,,,,,,1,1,0,7,,,,0,0,0,12,3,0,0,0,14,1,0,0,0,0,0,0,0
"Sep 5, 2019 6:00 AM",57,45,12,,,,,,,,,,6,1,5,7,,,,9,7,2,32,16,7,5,2,53,3,4,4,4,0,1,0,1
"Sep 5, 2019 7:00 AM",210,166,44,,,,,,,,,,9,4,5,14,,,,31,23,8,162,34,42,28,14,175,1,6,11,6,5,5,0,5
"Sep 5, 2019 8:00 AM",409,335,74,,,,,,,,,,33,3,30,31,,,,53,32,21,264,58,84,61,23,323,10,5,15,14,1,5,2,3
"Sep 5, 2019 9:00 AM",171,150,21,,,,,,,,,,15,6,9,8,,,,22,16,6,131,38,42,24,18,111,3,4,6,4,2,3,1,2
"Sep 5, 2019 10:00 AM",76,54,22,,,,,,,,,,12,4,8,4,,,,9,8,1,38,15,10,6,4,41,4,4,4,2,2,2,1,1
"Sep 5, 2019 11:00 AM",47,28,19,,,,,,,,,,9,5,4,7,,,,9,9,0,18,13,9,4,5,18,2,4,1,1,0,0,0,0
"Sep 5, 2019 12:00 PM",53,19,34,,,,,,,,,,12,6,6,7,,,,13,12,1,21,18,17,3,14,27,5,1,1,1,0,0,0,0
"Sep 5, 2019 1:00 PM",75,32,43,,,,,,,,,,14,8,6,11,,,,38,32,6,22,31,9,3,6,23,6,1,4,2,2,3,1,2
"Sep 5, 2019 2:00 PM",65,22,43,,,,,,,,,,17,10,7,28,,,,25,22,3,14,26,19,2,17,32,3,3,4,3,1,0,0,0
"Sep 5, 2019 3:00 PM",80,22,58,,,,,,,,,,15,9,6,17,,,,46,40,6,23,40,33,12,21,35,9,3,4,2,2,2,2,0
"Sep 5, 2019 4:00 PM",160,39,121,,,,,,,,,,19,9,10,16,,,,64,62,2,35,91,39,8,31,46,4,3,6,1,5,5,4,1
"Sep 5, 2019 5:00 PM",316,75,241,,,,,,,,,,21,8,13,29,,,,169,165,4,52,189,96,17,79,79,8,3,7,6,1,1,1,0
"Sep 5, 2019 6:00 PM",289,73,216,,,,,,,,,,23,14,9,25,,,,177,171,6,42,155,94,18,76,63,4,3,8,4,4,1,1,0
"Sep 5, 2019 7:00 PM",157,35,122,,,,,,,,,,16,13,3,24,,,,86,84,2,17,73,44,10,34,42,2,4,7,4,3,4,1,3
"Sep 5, 2019 8:00 PM",85,17,68,,,,,,,,,,7,6,1,11,,,,39,37,2,16,26,13,7,6,19,1,3,3,0,3,4,4,0
"Sep 5, 2019 9:00 PM",49,12,37,,,,,,,,,,4,2,2,8,,,,22,20,2,8,24,8,3,5,12,1,2,4,2,2,0,0,0
"Sep 5, 2019 10:00 PM",59,9,50,,,,,,,,,,7,5,2,3,,,,17,17,0,4,24,9,3,6,13,3,0,2,2,0,1,0,1
"Sep 5, 2019 11:00 PM",23,2,21,,,,,,,,,,3,2,1,1,,,,8,8,0,6,8,0,0,0,4,0,1,0,0,0,1,1,0
"Sep 6, 2019 12:00 AM",13,3,10,,,,,,,,,,0,0,0,1,,,,9,9,0,6,7,0,0,0,5,0,1,0,0,0,1,1,0
"Sep 6, 2019 1:00 AM",3,0,3,,,,,,,,,,0,0,0,0,,,,1,1,0,2,2,6,0,6,1,0,1,0,0,0,0,0,0
"Sep 6, 2019 2:00 AM",5,0,5,,,,,,,,,,0,0,0,0,,,,1,1,0,1,5,0,0,0,1,1,0,0,0,0,0,0,0
"Sep 6, 2019 3:00 AM",4,0,4,,,,,,,,,,0,0,0,0,,,,2,2,0,0,4,0,0,0,1,0,0,1,0,1,0,0,0
"Sep 6, 2019 4:00 AM",2,1,1,,,,,,,,,,0,0,0,0,,,,3,2,1,1,0,0,0,0,1,0,0,0,0,0,0,0,0
"Sep 6, 2019 5:00 AM",12,10,2,,,,,,,,,,0,0,0,2,,,,3,2,1,6,6,1,0,1,10,2,0,0,0,0,0,0,0
"Sep 6, 2019 6:00 AM",34,29,5,,,,,,,,,,6,1,5,8,,,,11,9,2,33,11,5,4,1,37,3,2,1,1,0,1,0,1
"Sep 6, 2019 7:00 AM",162,123,39,,,,,,,,,,14,5,9,9,,,,25,19,6,98,35,25,21,4,137,1,4,6,5,1,2,0,2
"Sep 6, 2019 8:00 AM",327,260,67,,,,,,,,,,25,5,20,25,,,,38,29,9,217,49,88,63,25,245,10,11,19,16,3,2,1,1
"Sep 6, 2019 9:00 AM",139,120,19,,,,,,,,,,12,6,6,7,,,,14,12,2,92,21,35,24,11,73,2,10,6,1,5,1,0,1
"Sep 6, 2019 10:00 AM",71,43,28,,,,,,,,,,5,1,4,10,,,,11,8,3,20,8,3,1,2,27,4,3,5,3,2,2,1,1
"Sep 6, 2019 11:00 AM",57,38,19,,,,,,,,,,7,2,5,3,,,,12,10,2,20,7,5,1,4,26,1,2,4,2,2,3,0,3
"Sep 6, 2019 12:00 PM",57,23,34,,,,,,,,,,7,5,2,6,,,,16,15,1,19,18,16,7,9,32,1,2,5,3,2,0,0,0
"Sep 6, 2019 1:00 PM",105,41,64,,,,,,,,,,14,8,6,9,,,,23,20,3,28,26,17,5,12,17,6,7,2,2,0,3,0,3
"Sep 6, 2019 2:00 PM",64,33,31,,,,,,,,,,20,13,7,28,,,,29,26,3,19,34,16,4,12,20,5,3,4,4,0,1,0,1
"Sep 6, 2019 3:00 PM",87,36,51,,,,,,,,,,11,9,2,3,,,,31,29,2,32,38,22,5,17,27,4,3,4,1,3,2,2,0
"Sep 6, 2019 4:00 PM",140,40,100,,,,,,,,,,12,8,4,12,,,,55,49,6,32,76,42,8,34,39,5,3,2,2,0,2,2,0
"Sep 6, 2019 5:00 PM",267,56,211,,,,,,,,,,10,6,4,21,,,,154,152,2,25,167,64,7,57,57,10,7,7,3,4,2,2,0
"Sep 6, 2019 6:00 PM",205,49,156,,,,,,,,,,14,10,4,22,,,,135,132,3,25,121,57,12,45,43,7,1,5,4,1,2,1,1
"Sep 6, 2019 7:00 PM",120,30,90,,,,,,,,,,12,10,2,24,,,,41,39,2,19,35,15,5,10,14,2,3,1,0,1,0,0,0
"Sep 6, 2019 8:00 PM",64,10,54,,,,,,,,,,9,4,5,11,,,,29,27,2,6,24,16,3,13,16,8,2,1,1,0,1,0,1
"Sep 6, 2019 9:00 PM",29,12,17,,,,,,,,,,2,2,0,6,,,,17,16,1,5,10,6,1,5,9,2,1,3,1,2,1,1,0
"Sep 6, 2019 10:00 PM",20,3,17,,,,,,,,,,3,3,0,2,,,,15,14,1,11,11,1,1,0,4,2,1,1,1,0,1,0,1
"Sep 6, 2019 11:00 PM",29,12,17,,,,,,,,,,2,1,1,6,,,,7,7,0,3,6,2,1,1,1,0,0,0,0,0,0,0,0
"Sep 7, 2019 12:00 AM",13,1,12,,,,,,,,,,0,0,0,1,,,,5,4,1,3,2,4,2,2,8,1,0,0,0,0,0,0,0
"Sep 7, 2019 1:00 AM",10,3,7,,,,,,,,,,0,0,0,0,,,,5,4,1,2,6,1,0,1,3,0,2,0,0,0,0,0,0
"Sep 7, 2019 2:00 AM",4,0,4,,,,,,,,,,0,0,0,0,,,,3,3,0,0,2,2,2,0,1,1,2,0,0,0,0,0,0
"Sep 7, 2019 3:00 AM",7,3,4,,,,,,,,,,0,0,0,0,,,,1,1,0,1,0,1,0,1,0,0,0,1,0,1,0,0,0
"Sep 7, 2019 4:00 AM",6,2,4,,,,,,,,,,0,0,0,0,,,,0,0,0,0,1,2,2,0,5,0,0,0,0,0,0,0,0
"Sep 7, 2019 5:00 AM",3,2,1,,,,,,,,,,0,0,0,2,,,,3,3,0,2,4,0,0,0,3,0,0,0,0,0,0,0,0
"Sep 7, 2019 6:00 AM",9,5,4,,,,,,,,,,1,1,0,0,,,,3,3,0,5,2,3,1,2,7,2,3,1,0,1,0,0,0
"Sep 7, 2019 7:00 AM",18,8,10,,,,,,,,,,2,2,0,0,,,,4,4,0,8,20,10,2,8,13,1,1,0,0,0,1,1,0
"Sep 7, 2019 8:00 AM",39,19,20,,,,,,,,,,12,2,10,8,,,,6,3,3,25,20,9,2,7,29,0,6,1,0,1,0,0,0
"Sep 7, 2019 9:00 AM",37,24,13,,,,,,,,,,16,4,12,15,,,,9,8,1,10,18,16,11,5,35,4,5,4,3,1,2,0,2
"Sep 7, 2019 10:00 AM",59,42,17,,,,,,,,,,24,14,10,18,,,,15,12,3,20,37,17,5,12,28,4,4,3,1,2,1,1,0
"Sep 7, 2019 11:00 AM",61,38,23,,,,,,,,,,37,19,18,15,,,,19,14,5,24,26,20,9,11,39,4,6,4,3,1,0,0,0
"Sep 7, 2019 12:00 PM",79,45,34,,,,,,,,,,27,15,12,10,,,,13,10,3,19,29,22,9,13,29,3,0,3,2,1,2,2,0
"Sep 7, 2019 1:00 PM",57,28,29,,,,,,,,,,31,16,15,12,,,,25,23,2,29,27,22,7,15,36,4,2,3,2,1,0,0,0
"Sep 7, 2019 2:00 PM",52,28,24,,,,,,,,,,22,11,11,13,,,,17,14,3,20,20,21,9,12,18,4,3,0,0,0,0,0,0
"Sep 7, 2019 3:00 PM",49,23,26,,,,,,,,,,16,9,7,20,,,,11,9,2,12,18,29,14,15,21,4,3,8,5,3,4,0,4
"Sep 7, 2019 4:00 PM",59,22,37,,,,,,,,,,27,14,13,24,,,,19,19,0,21,28,21,8,13,23,6,1,6,4,2,1,1,0
"Sep 7, 2019 5:00 PM",59,25,34,,,,,,,,,,24,15,9,45,,,,26,22,4,15,16,34,22,12,29,3,4,5,4,1,0,0,0
"Sep 7, 2019 6:00 PM",45,20,25,,,,,,,,,,31,17,14,17,,,,20,20,0,4,17,18,8,10,19,3,4,0,0,0,0,0,0
"Sep 7, 2019 7:00 PM",37,16,21,,,,,,,,,,13,6,7,13,,,,12,12,0,18,17,10,7,3,16,3,0,3,1,2,2,2,0
"Sep 7, 2019 8:00 PM",28,15,13,,,,,,,,,,8,4,4,11,,,,19,15,4,10,15,6,3,3,20,2,1,0,0,0,0,0,0
"Sep 7, 2019 9:00 PM",13,3,10,,,,,,,,,,6,1,5,2,,,,5,5,0,4,5,4,3,1,10,2,0,0,0,0,0,0,0
"Sep 7, 2019 10:00 PM",6,1,5,,,,,,,,,,4,3,1,1,,,,5,4,1,4,5,4,1,3,7,0,1,0,0,0,0,0,0
"Sep 7, 2019 11:00 PM",16,6,10,,,,,,,,,,9,7,2,1,,,,5,3,2,5,4,2,2,0,9,0,2,0,0,0,0,0,0
"Sep 8, 2019 12:00 AM",10,3,7,,,,,,,,,,3,2,1,0,,,,7,7,0,1,6,4,1,3,4,0,0,0,0,0,0,0,0
"Sep 8, 2019 1:00 AM",3,1,2,,,,,,,,,,1,1,0,1,,,,6,6,0,1,6,1,0,1,2,0,1,0,0,0,0,0,0
"Sep 8, 2019 2:00 AM",7,2,5,,,,,,,,,,0,0,0,0,,,,3,3,0,0,4,3,2,1,2,0,0,0,0,0,0,0,0
"Sep 8, 2019 3:00 AM",2,1,1,,,,,,,,,,0,0,0,0,,,,1,1,0,0,2,0,0,0,1,1,1,0,0,0,0,0,0
"Sep 8, 2019 4:00 AM",2,0,2,,,,,,,,,,1,1,0,1,,,,2,1,1,0,0,0,0,0,0,0,0,1,0,1,0,0,0
"Sep 8, 2019 5:00 AM",1,0,1,,,,,,,,,,0,0,0,1,,,,1,1,0,0,1,0,0,0,2,0,0,0,0,0,0,0,0
"Sep 8, 2019 6:00 AM",10,3,7,,,,,,,,,,0,0,0,0,,,,4,3,1,4,8,2,0,2,6,2,0,0,0,0,0,0,0
"Sep 8, 2019 7:00 AM",15,9,6,,,,,,,,,,3,3,0,0,,,,5,4,1,8,12,8,3,5,17,0,1,1,1,0,2,1,1
"Sep 8, 2019 8:00 AM",22,13,9,,,,,,,,,,8,4,4,10,,,,6,4,2,10,16,11,5,6,16,1,10,0,0,0,1,1,0
"Sep 8, 2019 9:00 AM",45,24,21,,,,,,,,,,13,3,10,3,,,,10,7,3,23,28,26,11,15,34,3,2,1,1,0,0,0,0
"Sep 8, 2019 10:00 AM",48,31,17,,,,,,,,,,18,8,10,13,,,,22,17,5,21,25,38,8,30,90,5,8,5,3,2,5,2,3
"Sep 8, 2019 11:00 AM",62,32,30,,,,,,,,,,28,12,16,9,,,,27,25,2,37,36,54,34,20,34,4,4,6,5,1,7,1,6
"Sep 8, 2019 12:00 PM",66,38,28,,,,,,,,,,38,12,26,21,,,,22,20,2,23,52,32,5,27,26,4,8,6,3,3,2,1,1
"Sep 8, 2019 1:00 PM",58,24,34,,,,,,,,,,45,22,23,15,,,,21,20,1,19,52,40,25,15,29,11,2,4,4,0,0,0,0
"Sep 8, 2019 2:00 PM",42,25,17,,,,,,,,,,42,24,18,34,,,,14,13,1,22,31,36,15,21,28,5,4,6,5,1,3,0,3
"Sep 8, 2019 3:00 PM",66,36,30,,,,,,,,,,38,27,11,22,,,,10,9,1,20,27,29,12,17,24,4,0,5,2,3,3,2,1
"Sep 8, 2019 4:00 PM",42,19,23,,,,,,,,,,24,17,7,13,,,,15,13,2,16,20,42,17,25,36,1,4,6,4,2,8,2,6
"Sep 8, 2019 5:00 PM",58,25,33,,,,,,,,,,29,18,11,12,,,,30,27,3,16,23,35,23,12,30,4,2,7,5,2,0,0,0
"Sep 8, 2019 6:00 PM",51,25,26,,,,,,,,,,24,19,5,9,,,,22,21,1,11,23,20,6,14,29,3,7,2,2,0,3,3,0
"Sep 8, 2019 7:00 PM",39,17,22,,,,,,,,,,7,3,4,16,,,,10,8,2,11,14,26,16,10,29,9,1,4,2,2,1,0,1
"Sep 8, 2019 8:00 PM",34,14,20,,,,,,,,,,2,1,1,5,,,,15,12,3,12,9,7,6,1,8,1,1,2,1,1,0,0,0
"Sep 8, 2019 9:00 PM",24,9,15,,,,,,,,,,2,1,1,3,,,,4,4,0,6,6,1,1,0,12,0,0,0,0,0,1,0,1
"Sep 8, 2019 10:00 PM",15,5,10,,,,,,,,,,0,0,0,0,,,,7,6,1,2,6,3,0,3,7,1,1,0,0,0,0,0,0
"Sep 8, 2019 11:00 PM",8,1,7,,,,,,,,,,0,0,0,1,,,,2,1,1,1,2,2,1,1,2,0,2,0,0,0,0,0,0
"Sep 9, 2019 12:00 AM",6,1,5,,,,,,,,,,0,0,0,0,,,,2,2,0,0,1,1,0,1,3,0,1,0,0,0,0,0,0
"Sep 9, 2019 1:00 AM",2,0,2,,,,,,,,,,0,0,0,0,,,,1,1,0,0,0,0,0,0,1,0,0,0,0,0,0,0,0
"Sep 9, 2019 2:00 AM",0,0,0,,,,,,,,,,0,0,0,0,,,,2,2,0,0,2,0,0,0,0,0,0,1,0,1,0,0,0
"Sep 9, 2019 3:00 AM",1,0,1,,,,,,,,,,0,0,0,0,,,,0,0,0,0,0,1,0,1,0,0,0,0,0,0,0,0,0
"Sep 9, 2019 4:00 AM",2,1,1,,,,,,,,,,0,0,0,0,,,,0,0,0,2,0,0,0,0,0,0,0,0,0,0,0,0,0
"Sep 9, 2019 5:00 AM",9,5,4,,,,,,,,,,0,0,0,4,,,,2,1,1,8,4,0,0,0,12,1,0,0,0,0,0,0,0
"Sep 9, 2019 6:00 AM",42,27,15,,,,,,,,,,0,0,0,5,,,,6,4,2,22,9,7,5,2,42,0,2,2,1,1,2,0,2
"Sep 9, 2019 7:00 AM",177,141,36,,,,,,,,,,2,1,1,18,,,,22,14,8,107,25,21,15,6,136,1,3,7,6,1,2,0,2
"Sep 9, 2019 8:00 AM",516,445,71,,,,,,,,,,18,5,13,30,,,,58,32,26,294,66,74,57,17,287,7,5,12,11,1,2,0,2
"Sep 9, 2019 9:00 AM",238,204,34,,,,,,,,,,15,8,7,8,,,,33,18,15,125,31,38,28,10,99,3,3,5,4,1,2,1,1
"Sep 9, 2019 10:00 AM",87,72,15,,,,,,,,,,4,3,1,4,,,,13,7,6,54,10,13,4,9,25,1,0,1,0,1,1,0,1
"Sep 9, 2019 11:00 AM",60,29,31,,,,,,,,,,5,2,3,5,,,,15,10,5,30,13,8,5,3,16,3,1,2,1,1,1,1,0
"Sep 9, 2019 12:00 PM",83,40,43,,,,,,,,,,14,10,4,9,,,,20,18,2,27,17,9,4,5,22,2,0,2,2,0,1,0,1
"Sep 9, 2019 1:00 PM",100,40,60,,,,,,,,,,12,7,5,8,,,,29,26,3,24,15,10,5,5,22,6,0,2,2,0,1,0,1
"Sep 9, 2019 2:00 PM",94,38,56,,,,,,,,,,11,3,8,2,,,,35,31,4,14,13,16,3,13,11,3,2,4,1,3,0,0,0
"Sep 9, 2019 3:00 PM",85,19,66,,,,,,,,,,6,5,1,14,,,,56,52,4,25,36,10,2,8,29,7,2,6,5,1,1,1,0
"Sep 9, 2019 4:00 PM",188,47,141,,,,,,,,,,11,10,1,13,,,,82,77,5,29,67,36,9,27,31,5,1,10,2,8,2,2,0
"Sep 9, 2019 5:00 PM",349,52,297,,,,,,,,,,14,8,6,16,,,,162,156,6,35,164,58,5,53,78,6,0,8,4,4,2,1,1
"Sep 9, 2019 6:00 PM",318,50,268,,,,,,,,,,12,7,5,25,,,,196,191,5,40,155,85,7,78,59,5,4,8,5,3,0,0,0
"Sep 9, 2019 7:00 PM",154,36,118,,,,,,,,,,11,7,4,18,,,,91,88,3,24,72,40,14,26,38,4,2,4,2,2,2,1,1
"Sep 9, 2019 8:00 PM",112,19,93,,,,,,,,,,5,3,2,7,,,,48,45,3,21,36,30,7,23,22,6,4,5,2,3,4,3,1
"Sep 9, 2019 9:00 PM",50,12,38,,,,,,,,,,2,2,0,6,,,,17,14,3,13,21,4,2,2,14,2,0,3,0,3,4,4,0
"Sep 9, 2019 10:00 PM",20,5,15,,,,,,,,,,0,0,0,4,,,,23,22,1,7,10,3,1,2,12,2,0,1,0,1,0,0,0
"Sep 9, 2019 11:00 PM",19,5,14,,,,,,,,,,1,1,0,2,,,,6,6,0,4,2,1,0,1,3,2,1,0,0,0,1,1,0
"Sep 10, 2019 12:00 AM",6,2,4,,,,,,,,,,1,1,0,0,,,,1,1,0,1,0,3,0,3,2,0,2,0,0,0,0,0,0
"Sep 10, 2019 1:00 AM",7,2,5,,,,,,,,,,0,0,0,0,,,,4,4,0,0,2,0,0,0,1,0,0,0,0,0,0,0,0
"Sep 10, 2019 2:00 AM",1,0,1,,,,,,,,,,0,0,0,0,,,,1,1,0,0,2,2,0,2,1,0,0,0,0,0,0,0,0
"Sep 10, 2019 3:00 AM",8,2,6,,,,,,,,,,0,0,0,0,,,,2,2,0,1,0,0,0,0,0,0,0,2,1,1,0,0,0
"Sep 10, 2019 4:00 AM",3,3,0,,,,,,,,,,0,0,0,0,,,,0,0,0,3,1,0,0,0,0,1,0,0,0,0,0,0,0
"Sep 10, 2019 5:00 AM",7,4,3,,,,,,,,,,0,0,0,2,,,,3,1,2,10,4,0,0,0,15,2,0,0,0,0,0,0,0
"Sep 10, 2019 6:00 AM",67,51,16,,,,,,,,,,4,1,3,9,,,,12,10,2,34,15,10,8,2,60,1,1,3,2,1,1,0,1
"Sep 10, 2019 7:00 AM",254,197,57,,,,,,,,,,11,3,8,15,,,,34,27,7,170,39,49,36,13,230,3,2,8,6,2,1,0,1
"Sep 10, 2019 8:00 AM",567,472,95,,,,,,,,,,35,3,32,39,,,,67,41,26,376,74,111,89,22,392,6,9,18,15,3,6,1,5
"Sep 10, 2019 9:00 AM",259,219,40,,,,,,,,,,17,7,10,13,,,,37,19,18,150,44,49,37,12,125,8,5,5,2,3,0,0,0
"Sep 10, 2019 10:00 AM",117,91,26,,,,,,,,,,10,4,6,4,,,,26,17,9,54,16,18,9,9,32,3,6,3,3,0,1,1,0
"Sep 10, 2019 11:00 AM",79,44,35,,,,,,,,,,9,3,6,9,,,,25,21,4,26,8,26,10,16,30,1,0,2,0,2,0,0,0
"Sep 10, 2019 12:00 PM",98,49,49,,,,,,,,,,24,13,11,15,,,,24,19,5,36,21,27,10,17,27,4,1,2,1,1,0,0,0
"Sep 10, 2019 1:00 PM",105,49,56,,,,,,,,,,18,16,2,7,,,,33,28,5,25,28,27,12,15,31,4,3,5,3,2,1,1,0
"Sep 10, 2019 2:00 PM",91,35,56,,,,,,,,,,13,6,7,10,,,,58,50,8,33,29,31,10,21,26,3,3,5,2,3,2,1,1
"Sep 10, 2019 3:00 PM",131,35,96,,,,,,,,,,10,6,4,14,,,,57,52,5,34,35,23,12,11,19,5,4,8,8,0,3,1,2
"Sep 10, 2019 4:00 PM",226,46,180,,,,,,,,,,20,12,8,13,,,,108,102,6,39,90,38,5,33,35,3,3,8,2,6,2,2,0
"Sep 10, 2019 5:00 PM",406,78,328,,,,,,,,,,17,12,5,31,,,,193,187,6,45,210,88,8,80,76,10,7,4,2,2,2,1,1
"Sep 10, 2019 6:00 PM",379,79,300,,,,,,,,,,28,18,10,43,,,,241,233,8,58,203,92,12,80,57,5,1,6,4,2,2,1,1
"Sep 10, 2019 7:00 PM",194,49,145,,,,,,,,,,12,8,4,19,,,,92,89,3,26,86,50,7,43,26,4,3,8,2,6,2,2,0
"Sep 10, 2019 8:00 PM",117,31,86,,,,,,,,,,4,4,0,5,,,,66,61,5,18,50,23,6,17,26,3,1,5,4,1,4,3,1
"Sep 10, 2019 9:00 PM",78,20,58,,,,,,,,,,4,3,1,6,,,,37,33,4,11,31,11,2,9,17,2,2,3,2,1,0,0,0
"Sep 10, 2019 10:00 PM",46,10,36,,,,,,,,,,0,0,0,4,,,,24,24,0,10,17,5,3,2,13,0,1,0,0,0,0,0,0
"Sep 10, 2019 11:00 PM",20,2,18,,,,,,,,,,1,0,1,3,,,,10,9,1,5,13,1,0,1,1,0,0,3,2,1,1,1,0
"Sep 11, 2019 12:00 AM",7,2,5,,,,,,,,,,0,0,0,0,,,,4,3,1,3,8,1,0,1,7,2,0,1,1,0,0,0,0
"Sep 11, 2019 1:00 AM",3,0,3,,,,,,,,,,0,0,0,0,,,,1,1,0,2,1,0,0,0,2,0,1,0,0,0,0,0,0
"Sep 11, 2019 2:00 AM",2,1,1,,,,,,,,,,0,0,0,1,,,,1,1,0,0,3,2,0,2,1,0,0,0,0,0,0,0,0
"Sep 11, 2019 3:00 AM",4,2,2,,,,,,,,,,0,0,0,0,,,,0,0,0,0,0,0,0,0,0,0,0,0,0,0,0,0,0
"Sep 11, 2019 4:00 AM",1,1,0,,,,,,,,,,0,0,0,0,,,,1,1,0,3,1,0,0,0,0,0,0,0,0,0,0,0,0
"Sep 11, 2019 5:00 AM",2,2,0,,,,,,,,,,0,0,0,4,,,,2,2,0,6,5,0,0,0,11,2,0,0,0,0,0,0,0
"Sep 11, 2019 6:00 AM",49,43,6,,,,,,,,,,3,0,3,11,,,,11,9,2,42,16,4,3,1,58,0,3,5,3,2,1,0,1
"Sep 11, 2019 7:00 AM",227,187,40,,,,,,,,,,9,1,8,14,,,,40,25,15,147,34,25,17,8,204,3,5,11,10,1,0,0,0
"Sep 11, 2019 8:00 AM",536,436,100,,,,,,,,,,34,9,25,38,,,,60,41,19,324,77,92,71,21,359,10,8,19,15,4,3,1,2
"Sep 11, 2019 9:00 AM",278,250,28,,,,,,,,,,13,2,11,7,,,,28,17,11,160,36,41,27,14,121,7,3,5,3,2,0,0,0
"Sep 11, 2019 10:00 AM",127,104,23,,,,,,,,,,11,5,6,11,,,,30,20,10,64,14,18,10,8,29,6,2,3,2,1,2,0,2
"Sep 11, 2019 11:00 AM",88,63,25,,,,,,,,,,16,7,9,12,,,,22,16,6,37,17,17,10,7,22,3,1,2,2,0,2,0,2
"Sep 11, 2019 12:00 PM",92,39,53,,,,,,,,,,17,13,4,13,,,,28,21,7,24,29,20,8,12,33,4,1,4,3,1,1,0,1
"Sep 11, 2019 1:00 PM",123,46,77,,,,,,,,,,13,8,5,12,,,,40,38,2,27,35,20,4,16,33,5,2,6,1,5,2,2,0
"Sep 11, 2019 2:00 PM",110,40,70,,,,,,,,,,19,10,9,12,,,,43,40,3,19,27,21,10,11,20,2,5,5,1,4,2,1,1
"Sep 11, 2019 3:00 PM",132,34,98,,,,,,,,,,15,10,5,9,,,,53,49,4,22,35,17,1,16,35,8,3,10,5,5,1,0,1
"Sep 11, 2019 4:00 PM",206,44,162,,,,,,,,,,14,8,6,13,,,,86,78,8,28,89,34,8,26,41,12,4,8,6,2,4,3,1
"Sep 11, 2019 5:00 PM",388,66,322,,,,,,,,,,21,13,8,33,,,,187,185,2,50,199,83,8,75,75,13,7,8,6,2,5,3,2
"Sep 11, 2019 6:00 PM",369,77,292,,,,,,,,,,26,15,11,31,,,,189,182,7,42,191,100,11,89,66,6,2,8,4,4,5,2,3
"Sep 11, 2019 7:00 PM",204,53,151,,,,,,,,,,22,14,8,29,,,,110,107,3,33,93,61,16,45,40,2,3,5,2,3,2,1,1
"Sep 11, 2019 8:00 PM",133,40,93,,,,,,,,,,5,3,2,8,,,,64,61,3,15,30,19,9,10,20,3,2,6,2,4,1,1,0
"Sep 11, 2019 9:00 PM",63,16,47,,,,,,,,,,1,1,0,6,,,,28,27,1,9,22,11,5,6,16,1,2,0,0,0,0,0,0
"Sep 11, 2019 10:00 PM",53,13,40,,,,,,,,,,5,1,4,5,,,,28,24,4,8,19,4,0,4,14,4,0,4,4,0,1,0,1
"Sep 11, 2019 11:00 PM",18,3,15,,,,,,,,,,1,1,0,1,,,,16,14,2,8,8,3,1,2,10,2,0,0,0,0,0,0,0
"Sep 12, 2019 12:00 AM",11,1,10,,,,,,,,,,1,1,0,0,,,,7,7,0,3,1,1,0,1,2,0,0,0,0,0,0,0,0
"Sep 12, 2019 1:00 AM",5,0,5,,,,,,,,,,0,0,0,0,,,,3,3,0,0,0,0,0,0,0,1,1,0,0,0,0,0,0
"Sep 12, 2019 2:00 AM",2,0,2,,,,,,,,,,0,0,0,0,,,,1,1,0,0,5,0,0,0,1,0,0,0,0,0,0,0,0
"Sep 12, 2019 3:00 AM",5,2,3,,,,,,,,,,0,0,0,0,,,,0,0,0,0,0,0,0,0,3,1,0,0,0,0,0,0,0
"Sep 12, 2019 4:00 AM",5,1,4,,,,,,,,,,0,0,0,0,,,,1,1,0,1,0,1,0,1,0,1,0,0,0,0,0,0,0
"Sep 12, 2019 5:00 AM",8,6,2,,,,,,,,,,0,0,0,4,,,,1,1,0,7,5,0,0,0,13,2,0,0,0,0,0,0,0
"Sep 12, 2019 6:00 AM",57,41,16,,,,,,,,,,3,0,3,8,,,,11,10,1,30,15,15,11,4,52,4,2,5,4,1,2,0,2
"Sep 12, 2019 7:00 AM",220,177,43,,,,,,,,,,13,4,9,8,,,,34,26,8,151,42,43,33,10,188,1,2,6,5,1,5,1,4
"Sep 12, 2019 8:00 AM",527,454,73,,,,,,,,,,29,6,23,28,,,,52,37,15,308,60,94,75,19,346,9,9,18,16,2,2,0,2
"Sep 12, 2019 9:00 AM",240,204,36,,,,,,,,,,15,7,8,7,,,,30,16,14,136,37,43,28,15,106,4,5,7,5,2,2,2,0
"Sep 12, 2019 10:00 AM",91,71,20,,,,,,,,,,7,1,6,6,,,,18,13,5,59,16,18,8,10,45,5,11,5,2,3,4,3,1
"Sep 12, 2019 11:00 AM",94,58,36,,,,,,,,,,10,4,6,9,,,,19,17,2,31,17,22,14,8,30,5,5,4,2,2,0,0,0
"Sep 12, 2019 12:00 PM",111,64,47,,,,,,,,,,18,10,8,2,,,,29,23,6,31,27,20,7,13,29,6,6,6,4,2,1,0,1
"Sep 12, 2019 1:00 PM",113,39,74,,,,,,,,,,16,11,5,5,,,,38,34,4,26,26,20,6,14,22,1,3,7,5,2,0,0,0
"Sep 12, 2019 2:00 PM",109,38,71,,,,,,,,,,17,9,8,13,,,,30,26,4,30,22,23,9,14,21,4,3,4,1,3,0,0,0
"Sep 12, 2019 3:00 PM",134,31,103,,,,,,,,,,12,9,3,11,,,,55,51,4,23,43,26,6,20,25,5,1,2,1,1,1,1,0
"Sep 12, 2019 4:00 PM",199,37,162,,,,,,,,,,13,9,4,18,,,,93,90,3,26,80,34,8,26,50,2,6,3,0,3,5,5,0
"Sep 12, 2019 5:00 PM",345,59,286,,,,,,,,,,23,18,5,32,,,,182,179,3,44,194,81,12,69,75,9,5,4,1,3,3,3,0
"Sep 12, 2019 6:00 PM",318,65,253,,,,,,,,,,29,18,11,23,,,,188,182,6,40,171,88,9,79,52,8,2,8,5,3,2,2,0
"Sep 12, 2019 7:00 PM",170,41,129,,,,,,,,,,11,8,3,14,,,,88,84,4,27,73,40,4,36,35,5,1,9,4,5,2,1,1
"Sep 12, 2019 8:00 PM",104,26,78,,,,,,,,,,16,10,6,7,,,,55,51,4,19,42,15,2,13,17,2,1,4,1,3,1,1,0
"Sep 12, 2019 9:00 PM",57,12,45,,,,,,,,,,4,3,1,8,,,,22,22,0,5,25,6,1,5,11,0,0,2,0,2,0,0,0
"Sep 12, 2019 10:00 PM",28,11,17,,,,,,,,,,12,7,5,3,,,,18,17,1,6,17,8,2,6,9,0,3,0,0,0,0,0,0
"Sep 12, 2019 11:00 PM",30,7,23,,,,,,,,,,2,2,0,0,,,,16,15,1,5,11,3,0,3,9,0,0,0,0,0,0,0,0
"Sep 13, 2019 12:00 AM",13,5,8,,,,,,,,,,2,2,0,1,,,,8,5,3,1,7,0,0,0,3,0,1,0,0,0,0,0,0
"Sep 13, 2019 1:00 AM",6,1,5,,,,,,,,,,0,0,0,0,,,,4,4,0,1,1,1,0,1,1,0,0,0,0,0,0,0,0
"Sep 13, 2019 2:00 AM",5,0,5,,,,,,,,,,0,0,0,2,,,,2,2,0,0,7,0,0,0,1,0,0,0,0,0,0,0,0
"Sep 13, 2019 3:00 AM",2,2,0,,,,,,,,,,0,0,0,0,,,,0,0,0,1,0,0,0,0,0,0,0,0,0,0,0,0,0
"Sep 13, 2019 4:00 AM",3,1,2,,,,,,,,,,0,0,0,0,,,,1,1,0,1,1,0,0,0,0,1,0,0,0,0,0,0,0
"Sep 13, 2019 5:00 AM",10,8,2,,,,,,,,,,2,2,0,3,,,,3,3,0,4,6,0,0,0,9,4,0,0,0,0,0,0,0
"Sep 13, 2019 6:00 AM",49,37,12,,,,,,,,,,1,0,1,9,,,,11,7,4,29,14,7,4,3,35,0,3,2,1,1,0,0,0
"Sep 13, 2019 7:00 AM",181,142,39,,,,,,,,,,11,2,9,12,,,,25,20,5,117,32,33,23,10,142,1,5,6,6,0,3,1,2
"Sep 13, 2019 8:00 AM",427,350,77,,,,,,,,,,31,10,21,28,,,,61,36,25,245,59,81,58,23,275,12,9,10,10,0,4,0,4
"Sep 13, 2019 9:00 AM",215,184,31,,,,,,,,,,22,9,13,17,,,,26,16,10,103,29,45,24,21,103,7,7,25,11,14,2,1,1
"Sep 13, 2019 10:00 AM",91,64,27,,,,,,,,,,11,5,6,15,,,,16,10,6,38,18,21,14,7,37,3,6,3,2,1,2,1,1
"Sep 13, 2019 11:00 AM",99,49,50,,,,,,,,,,11,5,6,10,,,,20,17,3,30,13,25,9,16,33,6,1,5,4,1,1,0,1
"Sep 13, 2019 12:00 PM",112,53,59,,,,,,,,,,21,15,6,6,,,,33,30,3,45,23,31,14,17,32,1,5,4,3,1,1,1,0
"Sep 13, 2019 1:00 PM",122,55,67,,,,,,,,,,17,8,9,8,,,,37,32,5,37,21,29,14,15,36,6,2,5,4,1,0,0,0
"Sep 13, 2019 2:00 PM",112,40,72,,,,,,,,,,15,6,9,16,,,,49,47,2,23,34,22,8,14,26,8,3,9,5,4,2,0,2
"Sep 13, 2019 3:00 PM",136,34,102,,,,,,,,,,16,14,2,19,,,,54,51,3,26,40,28,4,24,30,4,3,5,3,2,1,0,1
"Sep 13, 2019 4:00 PM",171,38,133,,,,,,,,,,9,8,1,21,,,,85,79,6,20,91,50,15,35,39,5,6,5,4,1,1,1,0
"Sep 13, 2019 5:00 PM",304,60,244,,,,,,,,,,30,21,9,39,,,,152,146,6,39,181,85,19,66,63,20,1,7,4,3,2,2,0
"Sep 13, 2019 6:00 PM",227,59,168,,,,,,,,,,23,13,10,19,,,,136,132,4,34,103,62,12,50,36,5,6,6,2,4,3,2,1
"Sep 13, 2019 7:00 PM",117,32,85,,,,,,,,,,35,19,16,17,,,,58,53,5,17,50,31,4,27,20,6,2,8,6,2,0,0,0
"Sep 13, 2019 8:00 PM",68,15,53,,,,,,,,,,10,5,5,5,,,,38,38,0,13,22,10,3,7,12,1,0,3,1,2,1,1,0
"Sep 13, 2019 9:00 PM",42,11,31,,,,,,,,,,0,0,0,8,,,,16,16,0,6,17,7,3,4,12,0,0,3,0,3,0,0,0
"Sep 13, 2019 10:00 PM",35,6,29,,,,,,,,,,3,0,3,4,,,,14,13,1,5,16,1,0,1,6,4,0,1,1,0,2,1,1
"Sep 13, 2019 11:00 PM",30,5,25,,,,,,,,,,7,3,4,4,,,,12,10,2,6,9,4,1,3,7,1,2,3,1,2,0,0,0
"Sep 14, 2019 12:00 AM",16,4,12,,,,,,,,,,3,2,1,1,,,,5,5,0,3,10,4,1,3,5,2,0,0,0,0,0,0,0
"Sep 14, 2019 1:00 AM",9,0,9,,,,,,,,,,0,0,0,0,,,,5,5,0,0,1,1,0,1,2,0,1,0,0,0,0,0,0
"Sep 14, 2019 2:00 AM",7,2,5,,,,,,,,,,2,2,0,2,,,,6,5,1,1,7,1,0,1,2,0,1,0,0,0,0,0,0
"Sep 14, 2019 3:00 AM",2,1,1,,,,,,,,,,0,0,0,0,,,,1,1,0,0,2,0,0,0,1,0,0,0,0,0,0,0,0
"Sep 14, 2019 4:00 AM",2,1,1,,,,,,,,,,0,0,0,0,,,,1,1,0,0,1,1,0,1,1,0,1,0,0,0,0,0,0
"Sep 14, 2019 5:00 AM",3,2,1,,,,,,,,,,0,0,0,1,,,,1,0,1,3,3,0,0,0,2,0,0,0,0,0,0,0,0
"Sep 14, 2019 6:00 AM",24,19,5,,,,,,,,,,1,1,0,1,,,,1,1,0,11,4,1,1,0,11,1,1,0,0,0,0,0,0
"Sep 14, 2019 7:00 AM",36,22,14,,,,,,,,,,2,2,0,1,,,,128,60,68,17,17,10,6,4,20,3,0,1,1,0,1,0,1
"Sep 14, 2019 8:00 AM",43,23,20,,,,,,,,,,7,2,5,10,,,,8,5,3,19,10,22,7,15,31,1,3,2,1,1,0,0,0
"Sep 14, 2019 9:00 AM",57,38,19,,,,,,,,,,11,4,7,6,,,,19,15,4,14,31,22,8,14,42,5,4,7,6,1,1,1,0
"Sep 14, 2019 10:00 AM",58,36,22,,,,,,,,,,27,13,14,14,,,,12,9,3,30,37,28,14,14,30,9,4,7,5,2,1,1,0
"Sep 14, 2019 11:00 AM",58,33,25,,,,,,,,,,21,8,13,31,,,,22,20,2,24,43,50,15,35,38,3,7,0,0,0,2,0,2
"Sep 14, 2019 12:00 PM",56,22,34,,,,,,,,,,32,23,9,18,,,,25,21,4,22,45,43,8,35,36,13,4,9,8,1,2,0,2
"Sep 14, 2019 1:00 PM",56,24,32,,,,,,,,,,29,20,9,22,,,,19,15,4,25,43,60,28,32,48,8,1,9,7,2,5,4,1
"Sep 14, 2019 2:00 PM",49,32,17,,,,,,,,,,43,14,29,19,,,,23,20,3,22,31,44,22,22,31,1,3,3,1,2,4,0,4
"Sep 14, 2019 3:00 PM",54,23,31,,,,,,,,,,21,12,9,22,,,,21,18,3,21,38,50,18,32,34,4,3,6,4,2,4,3,1
"Sep 14, 2019 4:00 PM",77,33,44,,,,,,,,,,29,23,6,15,,,,16,11,5,18,43,48,24,24,54,2,5,4,1,3,5,5,0
"Sep 14, 2019 5:00 PM",64,32,32,,,,,,,,,,22,12,10,27,,,,21,20,1,19,19,41,21,20,43,13,1,7,4,3,2,1,1
"Sep 14, 2019 6:00 PM",59,22,37,,,,,,,,,,20,13,7,10,,,,22,22,0,9,11,28,18,10,35,0,0,3,1,2,1,1,0
"Sep 14, 2019 7:00 PM",51,28,23,,,,,,,,,,7,5,2,7,,,,13,10,3,8,16,15,6,9,27,0,0,5,2,3,3,1,2
"Sep 14, 2019 8:00 PM",45,19,26,,,,,,,,,,11,4,7,3,,,,9,8,1,11,13,14,4,10,13,0,1,6,4,2,3,1,2
"Sep 14, 2019 9:00 PM",21,10,11,,,,,,,,,,1,1,0,6,,,,10,10,0,11,7,11,7,4,8,1,0,0,0,0,1,0,1
"Sep 14, 2019 10:00 PM",23,7,16,,,,,,,,,,1,0,1,2,,,,6,6,0,3,9,2,1,1,14,0,2,5,4,1,2,1,1
"Sep 14, 2019 11:00 PM",11,6,5,,,,,,,,,,3,3,0,0,,,,5,3,2,3,10,5,3,2,5,1,1,1,1,0,0,0,0
"Sep 15, 2019 12:00 AM",12,3,9,,,,,,,,,,0,0,0,0,,,,4,4,0,7,2,3,1,2,2,0,0,1,1,0,0,0,0
"Sep 15, 2019 1:00 AM",5,0,5,,,,,,,,,,1,1,0,2,,,,5,5,0,0,2,4,4,0,4,0,1,1,1,0,0,0,0
"Sep 15, 2019 2:00 AM",4,2,2,,,,,,,,,,1,0,1,2,,,,6,5,1,1,1,2,0,2,2,1,0,0,0,0,0,0,0
"Sep 15, 2019 3:00 AM",6,1,5,,,,,,,,,,0,0,0,0,,,,2,2,0,1,0,2,2,0,1,0,2,0,0,0,0,0,0
"Sep 15, 2019 4:00 AM",4,1,3,,,,,,,,,,1,1,0,1,,,,0,0,0,0,3,0,0,0,1,0,0,0,0,0,0,0,0
"Sep 15, 2019 5:00 AM",3,2,1,,,,,,,,,,0,0,0,1,,,,0,0,0,0,1,0,0,0,1,0,0,0,0,0,0,0,0
"Sep 15, 2019 6:00 AM",5,2,3,,,,,,,,,,0,0,0,0,,,,4,4,0,3,3,1,1,0,9,1,0,0,0,0,0,0,0
"Sep 15, 2019 7:00 AM",15,8,7,,,,,,,,,,1,1,0,3,,,,7,4,3,3,8,6,2,4,7,0,0,0,0,0,0,0,0
"Sep 15, 2019 8:00 AM",24,18,6,,,,,,,,,,5,3,2,3,,,,8,4,4,11,15,16,6,10,9,3,7,2,2,0,0,0,0
"Sep 15, 2019 9:00 AM",26,22,4,,,,,,,,,,4,2,2,10,,,,6,6,0,12,10,13,7,6,23,4,2,0,0,0,0,0,0
"Sep 15, 2019 10:00 AM",34,16,18,,,,,,,,,,5,4,1,2,,,,16,13,3,14,15,17,9,8,29,5,1,2,1,1,0,0,0
"Sep 15, 2019 11:00 AM",43,24,19,,,,,,,,,,13,7,6,3,,,,8,8,0,12,16,18,4,14,17,4,5,1,0,1,2,0,2
"Sep 15, 2019 12:00 PM",41,9,32,,,,,,,,,,18,9,9,11,,,,14,10,4,11,34,27,12,15,25,3,4,4,1,3,0,0,0
"Sep 15, 2019 1:00 PM",31,16,15,,,,,,,,,,40,25,15,7,,,,9,9,0,13,23,14,2,12,18,4,2,2,0,2,0,0,0
"Sep 15, 2019 2:00 PM",31,18,13,,,,,,,,,,12,7,5,9,,,,5,4,1,7,11,15,6,9,29,4,0,1,1,0,0,0,0
"Sep 15, 2019 3:00 PM",34,17,17,,,,,,,,,,10,6,4,4,,,,8,6,2,10,15,16,8,8,15,0,1,2,1,1,0,0,0
"Sep 15, 2019 4:00 PM",32,12,20,,,,,,,,,,7,4,3,5,,,,8,7,1,5,20,3,3,0,10,0,1,0,0,0,0,0,0
"Sep 15, 2019 5:00 PM",27,14,13,,,,,,,,,,3,2,1,6,,,,8,6,2,8,6,3,2,1,5,1,1,0,0,0,0,0,0
"Sep 15, 2019 6:00 PM",24,8,16,,,,,,,,,,2,2,0,5,,,,18,16,2,5,7,4,2,2,5,1,2,1,0,1,0,0,0
"Sep 15, 2019 7:00 PM",26,10,16,,,,,,,,,,2,1,1,1,,,,4,3,1,7,1,5,1,4,7,0,0,0,0,0,1,1,0
"Sep 15, 2019 8:00 PM",16,3,13,,,,,,,,,,1,1,0,2,,,,4,4,0,3,2,0,0,0,3,0,0,2,0,2,1,0,1
"Sep 15, 2019 9:00 PM",12,1,11,,,,,,,,,,2,1,1,4,,,,6,3,3,5,3,0,0,0,5,0,0,0,0,0,0,0,0
"Sep 15, 2019 10:00 PM",5,0,5,,,,,,,,,,0,0,0,0,,,,3,3,0,2,3,1,1,0,2,0,1,0,0,0,0,0,0
"Sep 15, 2019 11:00 PM",4,1,3,,,,,,,,,,0,0,0,0,,,,1,1,0,4,1,0,0,0,3,0,0,0,0,0,0,0,0
"Sep 16, 2019 12:00 AM",1,0,1,,,,,,,,,,0,0,0,1,,,,0,0,0,1,3,1,1,0,1,1,0,0,0,0,0,0,0
"Sep 16, 2019 1:00 AM",3,0,3,,,,,,,,,,0,0,0,0,,,,1,1,0,0,1,1,1,0,1,0,1,0,0,0,0,0,0
"Sep 16, 2019 2:00 AM",1,0,1,,,,,,,,,,0,0,0,0,,,,0,0,0,0,0,0,0,0,0,0,0,0,0,0,0,0,0
"Sep 16, 2019 3:00 AM",1,1,0,,,,,,,,,,0,0,0,0,,,,0,0,0,0,0,0,0,0,0,0,0,0,0,0,0,0,0
"Sep 16, 2019 4:00 AM",1,0,1,,,,,,,,,,0,0,0,0,,,,0,0,0,1,0,0,0,0,1,0,0,0,0,0,0,0,0
"Sep 16, 2019 5:00 AM",3,3,0,,,,,,,,,,1,0,1,4,,,,1,1,0,6,4,0,0,0,9,3,0,0,0,0,0,0,0
"Sep 16, 2019 6:00 AM",45,31,14,,,,,,,,,,3,1,2,4,,,,6,5,1,25,15,7,4,3,40,2,3,4,1,3,0,0,0
"Sep 16, 2019 7:00 AM",175,138,37,,,,,,,,,,4,1,3,11,,,,25,18,7,129,34,28,20,8,152,2,3,6,6,0,2,0,2
"Sep 16, 2019 8:00 AM",460,396,64,,,,,,,,,,21,8,13,24,,,,57,32,25,294,68,67,53,14,311,9,8,11,10,1,4,1,3
"Sep 16, 2019 9:00 AM",202,185,17,,,,,,,,,,14,7,7,7,,,,35,20,15,113,28,29,19,10,95,1,1,4,2,2,0,0,0
"Sep 16, 2019 10:00 AM",82,70,12,,,,,,,,,,10,3,7,4,,,,12,7,5,49,9,20,11,9,28,1,1,1,0,1,0,0,0
"Sep 16, 2019 11:00 AM",59,36,23,,,,,,,,,,7,2,5,3,,,,12,11,1,28,11,8,3,5,24,1,2,3,1,2,1,1,0
"Sep 16, 2019 12:00 PM",80,33,47,,,,,,,,,,13,10,3,6,,,,15,13,2,22,14,6,2,4,14,3,1,3,2,1,0,0,0
"Sep 16, 2019 1:00 PM",98,47,51,,,,,,,,,,13,10,3,5,,,,17,16,1,20,11,12,6,6,18,3,1,2,1,1,0,0,0
"Sep 16, 2019 2:00 PM",83,23,60,,,,,,,,,,10,5,5,9,,,,41,35,6,10,22,14,3,11,18,2,1,2,0,2,1,1,0
"Sep 16, 2019 3:00 PM",95,30,65,,,,,,,,,,15,12,3,16,,,,44,40,4,13,22,14,5,9,21,7,1,9,6,3,1,1,0
"Sep 16, 2019 4:00 PM",141,31,110,,,,,,,,,,12,8,4,15,,,,78,69,9,34,65,29,8,21,35,3,1,6,1,5,3,3,0
"Sep 16, 2019 5:00 PM",359,51,308,,,,,,,,,,20,15,5,24,,,,161,153,8,46,187,76,13,63,84,7,1,3,1,2,3,1,2
"Sep 16, 2019 6:00 PM",342,59,283,,,,,,,,,,18,8,10,24,,,,192,187,5,27,156,81,7,74,40,8,6,4,2,2,1,1,0
"Sep 16, 2019 7:00 PM",146,28,118,,,,,,,,,,14,11,3,12,,,,93,87,6,24,71,48,10,38,32,5,4,10,4,6,1,1,0
"Sep 16, 2019 8:00 PM",110,27,83,,,,,,,,,,7,4,3,4,,,,53,51,2,12,38,14,7,7,15,2,2,3,0,3,0,0,0
"Sep 16, 2019 9:00 PM",60,12,48,,,,,,,,,,2,1,1,4,,,,27,27,0,10,15,3,1,2,12,3,0,2,1,1,0,0,0
"Sep 16, 2019 10:00 PM",28,4,24,,,,,,,,,,1,1,0,3,,,,16,16,0,5,11,2,0,2,7,0,0,0,0,0,0,0,0
"Sep 16, 2019 11:00 PM",12,4,8,,,,,,,,,,1,0,1,2,,,,11,8,3,0,3,1,0,1,5,0,0,0,0,0,0,0,0
"Sep 17, 2019 12:00 AM",6,1,5,,,,,,,,,,1,1,0,2,,,,6,5,1,1,3,1,0,1,0,0,1,0,0,0,0,0,0
"Sep 17, 2019 1:00 AM",3,1,2,,,,,,,,,,2,2,0,0,,,,1,1,0,0,1,2,0,2,3,0,0,0,0,0,1,1,0
"Sep 17, 2019 2:00 AM",6,0,6,,,,,,,,,,0,0,0,0,,,,1,1,0,0,2,0,0,0,2,0,0,0,0,0,0,0,0
"Sep 17, 2019 3:00 AM",1,1,0,,,,,,,,,,0,0,0,0,,,,1,1,0,0,0,0,0,0,0,0,0,0,0,0,0,0,0
"Sep 17, 2019 4:00 AM",1,1,0,,,,,,,,,,0,0,0,1,,,,0,0,0,1,0,0,0,0,0,0,0,0,0,0,0,0,0
"Sep 17, 2019 5:00 AM",9,7,2,,,,,,,,,,0,0,0,3,,,,4,1,3,8,5,0,0,0,13,4,0,0,0,0,0,0,0
"Sep 17, 2019 6:00 AM",59,38,21,,,,,,,,,,5,0,5,4,,,,10,8,2,41,19,10,7,3,53,1,4,3,3,0,0,0,0
"Sep 17, 2019 7:00 AM",250,192,58,,,,,,,,,,18,2,16,19,,,,35,28,7,165,49,46,35,11,223,1,4,6,6,0,3,0,3
"Sep 17, 2019 8:00 AM",576,477,99,,,,,,,,,,36,11,25,43,,,,72,46,26,366,81,115,87,28,365,16,10,20,19,1,3,1,2
"Sep 17, 2019 9:00 AM",284,247,37,,,,,,,,,,27,5,22,12,,,,40,23,17,162,36,49,30,19,132,6,4,3,2,1,1,0,1
"Sep 17, 2019 10:00 AM",90,70,20,,,,,,,,,,3,1,2,5,,,,17,11,6,58,21,23,16,7,32,2,2,4,2,2,0,0,0
"Sep 17, 2019 11:00 AM",81,51,30,,,,,,,,,,11,8,3,4,,,,15,12,3,27,18,20,7,13,34,1,1,2,2,0,0,0,0
"Sep 17, 2019 12:00 PM",83,54,29,,,,,,,,,,30,18,12,11,,,,29,25,4,31,29,23,8,15,24,3,3,3,1,2,0,0,0
"Sep 17, 2019 1:00 PM",103,46,57,,,,,,,,,,21,13,8,10,,,,36,30,6,22,33,30,10,20,31,2,5,2,2,0,1,1,0
"Sep 17, 2019 2:00 PM",113,43,70,,,,,,,,,,20,17,3,8,,,,49,45,4,26,35,39,12,27,25,5,8,7,6,1,1,1,0
"Sep 17, 2019 3:00 PM",123,37,86,,,,,,,,,,21,8,13,17,,,,60,55,5,41,37,39,13,26,35,8,5,15,7,8,4,3,1
"Sep 17, 2019 4:00 PM",217,54,163,,,,,,,,,,17,13,4,16,,,,101,93,8,37,80,55,17,38,47,9,6,20,14,6,4,3,1
"Sep 17, 2019 5:00 PM",424,87,337,,,,,,,,,,31,20,11,22,,,,214,204,10,63,229,105,24,81,90,13,4,12,6,6,4,4,0
"Sep 17, 2019 6:00 PM",398,82,316,,,,,,,,,,41,28,13,35,,,,251,244,7,44,205,102,17,85,74,4,2,11,5,6,2,1,1
"Sep 17, 2019 7:00 PM",238,58,180,,,,,,,,,,17,13,4,33,,,,124,116,8,39,73,53,9,44,49,6,4,7,3,4,1,1,0
"Sep 17, 2019 8:00 PM",143,38,105,,,,,,,,,,7,5,2,16,,,,69,67,2,16,38,28,7,21,28,5,2,7,2,5,7,6,1
"Sep 17, 2019 9:00 PM",82,18,64,,,,,,,,,,7,4,3,6,,,,38,36,2,8,32,6,1,5,17,3,0,4,2,2,2,2,0
"Sep 17, 2019 10:00 PM",36,6,30,,,,,,,,,,3,2,1,2,,,,22,22,0,4,19,7,2,5,7,1,1,2,0,2,1,1,0
"Sep 17, 2019 11:00 PM",25,7,18,,,,,,,,,,1,1,0,0,,,,10,8,2,4,6,0,0,0,8,0,0,1,1,0,1,0,1
"Sep 18, 2019 12:00 AM",10,4,6,,,,,,,,,,0,0,0,0,,,,9,8,1,1,3,0,0,0,3,1,1,0,0,0,0,0,0
"Sep 18, 2019 1:00 AM",3,1,2,,,,,,,,,,0,0,0,1,,,,2,2,0,1,1,0,0,0,1,0,0,0,0,0,0,0,0
"Sep 18, 2019 2:00 AM",3,1,2,,,,,,,,,,2,2,0,0,,,,1,1,0,0,2,0,0,0,0,0,0,0,0,0,0,0,0
"Sep 18, 2019 3:00 AM",1,1,0,,,,,,,,,,0,0,0,0,,,,4,3,1,1,0,0,0,0,1,0,0,0,0,0,0,0,0
"Sep 18, 2019 4:00 AM",2,1,1,,,,,,,,,,0,0,0,0,,,,0,0,0,1,0,0,0,0,1,0,0,0,0,0,0,0,0
"Sep 18, 2019 5:00 AM",10,8,2,,,,,,,,,,0,0,0,3,,,,1,1,0,11,5,0,0,0,11,3,0,0,0,0,0,0,0
"Sep 18, 2019 6:00 AM",61,48,13,,,,,,,,,,4,2,2,8,,,,10,7,3,41,22,14,11,3,60,1,4,2,1,1,0,0,0
"Sep 18, 2019 7:00 AM",243,200,43,,,,,,,,,,12,7,5,25,,,,50,38,12,170,43,46,32,14,198,2,3,5,5,0,1,0,1
"Sep 18, 2019 8:00 AM",555,459,96,,,,,,,,,,36,8,28,37,,,,77,54,23,376,73,115,91,24,360,12,10,14,12,2,4,2,2
"Sep 18, 2019 9:00 AM",295,255,40,,,,,,,,,,23,5,18,8,,,,47,22,25,183,33,47,30,17,113,6,4,9,5,4,2,1,1
"Sep 18, 2019 10:00 AM",116,87,29,,,,,,,,,,9,3,6,9,,,,22,15,7,59,18,15,8,7,48,1,6,3,1,2,1,0,1
"Sep 18, 2019 11:00 AM",93,64,29,,,,,,,,,,17,8,9,16,,,,25,16,9,38,27,19,10,9,25,3,2,1,1,0,0,0,0
"Sep 18, 2019 12:00 PM",79,38,41,,,,,,,,,,20,13,7,10,,,,22,15,7,41,23,36,13,23,42,3,0,3,2,1,0,0,0
"Sep 18, 2019 1:00 PM",121,49,72,,,,,,,,,,17,10,7,13,,,,49,45,4,22,32,26,11,15,31,4,2,4,2,2,1,1,0
"Sep 18, 2019 2:00 PM",103,40,63,,,,,,,,,,24,17,7,19,,,,53,47,6,19,32,28,10,18,33,1,2,3,2,1,0,0,0
"Sep 18, 2019 3:00 PM",145,38,107,,,,,,,,,,21,7,14,11,,,,53,49,4,33,47,39,12,27,25,6,1,6,4,2,0,0,0
"Sep 18, 2019 4:00 PM",240,57,183,,,,,,,,,,25,15,10,13,,,,100,93,7,32,81,53,19,34,64,10,5,7,2,5,1,1,0
"Sep 18, 2019 5:00 PM",389,77,312,,,,,,,,,,22,13,9,32,,,,201,191,10,53,230,109,17,92,94,12,3,7,4,3,1,1,0
"Sep 18, 2019 6:00 PM",395,81,314,,,,,,,,,,28,20,8,35,,,,253,245,8,45,197,103,12,91,71,10,5,6,4,2,2,1,1
"Sep 18, 2019 7:00 PM",200,47,153,,,,,,,,,,19,10,9,26,,,,117,110,7,34,85,55,14,41,55,2,5,6,2,4,3,2,1
"Sep 18, 2019 8:00 PM",131,38,93,,,,,,,,,,8,6,2,15,,,,85,81,4,19,42,19,3,16,32,3,2,4,1,3,3,3,0
"Sep 18, 2019 9:00 PM",77,13,64,,,,,,,,,,5,3,2,9,,,,43,40,3,6,24,9,2,7,14,6,1,2,0,2,0,0,0
"Sep 18, 2019 10:00 PM",55,4,51,,,,,,,,,,4,2,2,3,,,,27,24,3,8,16,9,5,4,10,0,0,1,0,1,0,0,0
"Sep 18, 2019 11:00 PM",24,3,21,,,,,,,,,,2,1,1,3,,,,14,13,1,4,9,4,0,4,7,0,0,0,0,0,1,1,0
"Sep 19, 2019 12:00 AM",16,1,15,,,,,,,,,,1,1,0,0,,,,7,7,0,2,4,2,1,1,5,0,1,0,0,0,0,0,0
"Sep 19, 2019 1:00 AM",6,2,4,,,,,,,,,,1,1,0,0,,,,6,6,0,1,3,0,0,0,1,0,0,0,0,0,0,0,0
"Sep 19, 2019 2:00 AM",4,1,3,,,,,,,,,,0,0,0,0,,,,3,3,0,1,5,0,0,0,0,0,0,0,0,0,0,0,0
"Sep 19, 2019 3:00 AM",2,1,1,,,,,,,,,,0,0,0,0,,,,2,2,0,0,0,0,0,0,0,0,0,0,0,0,0,0,0
"Sep 19, 2019 4:00 AM",4,2,2,,,,,,,,,,0,0,0,0,,,,3,3,0,1,0,0,0,0,0,1,0,0,0,0,0,0,0
"Sep 19, 2019 5:00 AM",10,8,2,,,,,,,,,,0,0,0,2,,,,4,3,1,8,6,0,0,0,10,1,0,0,0,0,0,0,0
"Sep 19, 2019 6:00 AM",61,41,20,,,,,,,,,,5,2,3,7,,,,8,7,1,30,19,8,6,2,49,1,2,1,1,0,0,0,0
"Sep 19, 2019 7:00 AM",233,180,53,,,,,,,,,,10,3,7,21,,,,35,28,7,151,46,39,27,12,192,5,4,6,5,1,4,0,4
"Sep 19, 2019 8:00 AM",548,453,95,,,,,,,,,,40,9,31,25,,,,60,44,16,350,75,105,86,19,350,10,9,15,13,2,3,0,3
"Sep 19, 2019 9:00 AM",266,235,31,,,,,,,,,,15,4,11,15,,,,45,23,22,154,34,45,26,19,117,4,6,4,3,1,1,1,0
"Sep 19, 2019 10:00 AM",120,95,25,,,,,,,,,,9,4,5,16,,,,23,14,9,70,23,29,15,14,41,2,2,3,1,2,1,1,0
"Sep 19, 2019 11:00 AM",88,58,30,,,,,,,,,,18,6,12,8,,,,22,19,3,30,20,13,5,8,41,3,2,2,2,0,0,0,0
"Sep 19, 2019 12:00 PM",100,47,53,,,,,,,,,,12,7,5,7,,,,23,20,3,39,23,24,9,15,31,2,5,3,3,0,4,3,1
"Sep 19, 2019 1:00 PM",126,61,65,,,,,,,,,,15,8,7,9,,,,39,34,5,26,38,28,6,22,30,5,3,1,0,1,1,1,0
"Sep 19, 2019 2:00 PM",105,32,73,,,,,,,,,,21,13,8,7,,,,39,35,4,28,33,26,9,17,25,6,1,3,1,2,2,1,1
"Sep 19, 2019 3:00 PM",132,41,91,,,,,,,,,,30,16,14,14,,,,55,47,8,28,39,54,17,37,39,7,5,11,2,9,1,1,0
"Sep 19, 2019 4:00 PM",203,48,155,,,,,,,,,,19,12,7,20,,,,104,95,9,33,99,57,15,42,60,6,3,10,4,6,2,2,0
"Sep 19, 2019 5:00 PM",385,73,312,,,,,,,,,,28,16,12,30,,,,195,190,5,56,193,101,23,78,100,11,6,10,6,4,1,1,0
"Sep 19, 2019 6:00 PM",350,79,271,,,,,,,,,,24,14,10,25,,,,228,219,9,40,185,104,19,85,81,8,1,7,4,3,5,4,1
"Sep 19, 2019 7:00 PM",209,41,168,,,,,,,,,,14,8,6,19,,,,109,104,5,35,73,63,20,43,44,8,6,5,2,3,0,0,0
"Sep 19, 2019 8:00 PM",126,29,97,,,,,,,,,,3,2,1,17,,,,57,53,4,19,45,22,6,16,17,7,5,7,2,5,1,0,1
"Sep 19, 2019 9:00 PM",79,18,61,,,,,,,,,,4,3,1,9,,,,53,52,1,10,25,11,0,11,16,2,0,5,0,5,0,0,0
"Sep 19, 2019 10:00 PM",46,9,37,,,,,,,,,,4,3,1,6,,,,22,22,0,5,14,8,4,4,8,0,0,1,0,1,0,0,0
"Sep 19, 2019 11:00 PM",21,4,17,,,,,,,,,,0,0,0,1,,,,19,19,0,4,8,3,0,3,2,0,0,0,0,0,0,0,0
"Sep 20, 2019 12:00 AM",15,2,13,,,,,,,,,,3,3,0,2,,,,6,6,0,3,11,2,2,0,5,1,0,0,0,0,0,0,0
"Sep 20, 2019 1:00 AM",2,0,2,,,,,,,,,,1,1,0,2,,,,2,2,0,0,2,6,5,1,2,0,0,0,0,0,0,0,0
"Sep 20, 2019 2:00 AM",3,0,3,,,,,,,,,,0,0,0,2,,,,2,2,0,0,3,0,0,0,0,0,0,0,0,0,0,0,0
"Sep 20, 2019 3:00 AM",3,1,2,,,,,,,,,,0,0,0,1,,,,7,7,0,0,1,0,0,0,0,0,0,0,0,0,0,0,0
"Sep 20, 2019 4:00 AM",2,0,2,,,,,,,,,,0,0,0,0,,,,2,2,0,1,0,0,0,0,1,0,0,0,0,0,0,0,0
"Sep 20, 2019 5:00 AM",9,7,2,,,,,,,,,,0,0,0,5,,,,1,1,0,4,3,0,0,0,12,3,0,0,0,0,0,0,0
"Sep 20, 2019 6:00 AM",65,50,15,,,,,,,,,,2,1,1,12,,,,12,10,2,38,14,8,6,2,42,1,3,1,1,0,1,0,1
"Sep 20, 2019 7:00 AM",187,140,47,,,,,,,,,,11,4,7,12,,,,19,13,6,124,44,26,19,7,145,3,3,5,4,1,3,0,3
"Sep 20, 2019 8:00 AM",403,344,59,,,,,,,,,,31,6,25,31,,,,50,34,16,246,72,78,59,19,299,11,7,18,15,3,0,0,0
"Sep 20, 2019 9:00 AM",206,178,28,,,,,,,,,,13,7,6,6,,,,37,20,17,130,28,46,32,14,92,2,2,7,6,1,2,0,2
"Sep 20, 2019 10:00 AM",122,94,28,,,,,,,,,,8,4,4,8,,,,22,12,10,38,21,14,5,9,44,0,5,2,0,2,3,1,2
"Sep 20, 2019 11:00 AM",83,50,33,,,,,,,,,,11,5,6,10,,,,20,18,2,31,16,18,7,11,33,4,1,2,1,1,1,1,0
"Sep 20, 2019 12:00 PM",107,46,61,,,,,,,,,,13,9,4,9,,,,35,29,6,28,26,36,13,23,34,2,5,2,1,1,0,0,0
"Sep 20, 2019 1:00 PM",106,36,70,,,,,,,,,,18,12,6,10,,,,42,37,5,29,41,30,11,19,43,2,1,4,4,0,0,0,0
"Sep 20, 2019 2:00 PM",139,58,81,,,,,,,,,,21,16,5,8,,,,41,37,4,21,43,38,13,25,24,5,3,8,6,2,1,1,0
"Sep 20, 2019 3:00 PM",144,36,108,,,,,,,,,,19,7,12,21,,,,66,62,4,31,49,39,8,31,30,4,3,10,6,4,3,3,0
"Sep 20, 2019 4:00 PM",218,51,167,,,,,,,,,,35,21,14,36,,,,75,72,3,35,87,61,15,46,55,5,2,4,2,2,1,1,0
"Sep 20, 2019 5:00 PM",303,69,234,,,,,,,,,,23,18,5,48,,,,157,152,5,31,138,101,19,82,74,10,1,6,4,2,0,0,0
"Sep 20, 2019 6:00 PM",258,59,199,,,,,,,,,,28,16,12,16,,,,136,132,4,33,112,52,11,41,41,4,3,4,3,1,0,0,0
"Sep 20, 2019 7:00 PM",111,29,82,,,,,,,,,,18,13,5,37,,,,54,50,4,19,59,21,5,16,35,5,0,9,7,2,0,0,0
"Sep 20, 2019 8:00 PM",56,18,38,,,,,,,,,,8,5,3,11,,,,38,37,1,19,19,10,4,6,13,2,1,1,0,1,2,2,0
"Sep 20, 2019 9:00 PM",47,12,35,,,,,,,,,,4,1,3,9,,,,19,19,0,13,19,8,2,6,17,1,1,2,2,0,1,0,1
"Sep 20, 2019 10:00 PM",34,6,28,,,,,,,,,,1,1,0,5,,,,14,14,0,4,11,8,1,7,7,1,0,0,0,0,1,0,1
"Sep 20, 2019 11:00 PM",27,5,22,,,,,,,,,,1,0,1,5,,,,23,23,0,2,17,4,2,2,8,0,1,0,0,0,0,0,0
"Sep 21, 2019 12:00 AM",20,3,17,,,,,,,,,,4,1,3,2,,,,8,8,0,3,5,3,1,2,7,1,1,2,0,2,1,1,0
"Sep 21, 2019 1:00 AM",8,1,7,,,,,,,,,,0,0,0,1,,,,6,6,0,3,2,1,0,1,5,0,1,0,0,0,0,0,0
"Sep 21, 2019 2:00 AM",6,1,5,,,,,,,,,,0,0,0,1,,,,5,5,0,0,8,4,0,4,0,0,1,0,0,0,0,0,0
"Sep 21, 2019 3:00 AM",5,1,4,,,,,,,,,,0,0,0,0,,,,4,4,0,0,1,2,0,2,0,0,0,0,0,0,0,0,0
"Sep 21, 2019 4:00 AM",1,0,1,,,,,,,,,,0,0,0,0,,,,0,0,0,1,1,0,0,0,0,0,0,0,0,0,0,0,0
"Sep 21, 2019 5:00 AM",4,2,2,,,,,,,,,,0,0,0,1,,,,2,2,0,1,4,1,1,0,1,0,0,0,0,0,0,0,0
"Sep 21, 2019 6:00 AM",8,6,2,,,,,,,,,,1,1,0,0,,,,2,2,0,4,6,2,0,2,6,2,0,0,0,0,0,0,0
"Sep 21, 2019 7:00 AM",23,13,10,,,,,,,,,,4,3,1,2,,,,5,4,1,8,35,6,3,3,14,3,2,1,1,0,0,0,0
"Sep 21, 2019 8:00 AM",40,28,12,,,,,,,,,,8,7,1,3,,,,11,6,5,19,15,14,8,6,25,3,7,1,0,1,2,0,2
"Sep 21, 2019 9:00 AM",41,26,15,,,,,,,,,,19,12,7,7,,,,11,10,1,18,17,13,7,6,22,3,6,3,2,1,0,0,0
"Sep 21, 2019 10:00 AM",46,23,23,,,,,,,,,,24,6,18,11,,,,18,14,4,27,30,30,18,12,22,5,5,5,3,2,2,1,1
"Sep 21, 2019 11:00 AM",49,32,17,,,,,,,,,,27,14,13,14,,,,17,16,1,23,31,34,9,25,27,7,4,5,2,3,2,0,2
"Sep 21, 2019 12:00 PM",73,40,33,,,,,,,,,,43,36,7,32,,,,22,18,4,13,29,29,8,21,34,6,3,8,6,2,4,1,3
"Sep 21, 2019 1:00 PM",65,34,31,,,,,,,,,,31,27,4,21,,,,20,13,7,24,28,45,16,29,18,3,6,2,1,1,1,1,0
"Sep 21, 2019 2:00 PM",64,34,30,,,,,,,,,,33,18,15,16,,,,12,9,3,10,15,45,26,19,22,4,3,4,2,2,2,1,1
"Sep 21, 2019 3:00 PM",64,33,31,,,,,,,,,,27,22,5,22,,,,23,22,1,19,24,58,26,32,32,11,5,18,13,5,1,0,1
"Sep 21, 2019 4:00 PM",59,28,31,,,,,,,,,,33,28,5,28,,,,21,19,2,24,13,31,13,18,31,9,3,5,4,1,3,3,0
"Sep 21, 2019 5:00 PM",67,25,42,,,,,,,,,,20,16,4,17,,,,20,17,3,19,19,36,22,14,24,5,3,7,4,3,0,0,0
"Sep 21, 2019 6:00 PM",46,19,27,,,,,,,,,,16,12,4,10,,,,23,19,4,8,13,13,3,10,14,3,3,0,0,0,0,0,0
"Sep 21, 2019 7:00 PM",33,11,22,,,,,,,,,,8,7,1,4,,,,7,7,0,8,9,7,4,3,6,0,1,4,2,2,0,0,0
"Sep 21, 2019 8:00 PM",16,6,10,,,,,,,,,,1,1,0,5,,,,7,7,0,4,8,5,5,0,8,0,1,0,0,0,0,0,0
"Sep 21, 2019 9:00 PM",18,7,11,,,,,,,,,,2,1,1,2,,,,6,6,0,3,5,1,0,1,5,0,0,1,0,1,0,0,0
"Sep 21, 2019 10:00 PM",17,6,11,,,,,,,,,,1,1,0,0,,,,5,4,1,2,2,1,0,1,6,1,0,2,0,2,0,0,0
"Sep 21, 2019 11:00 PM",7,3,4,,,,,,,,,,1,1,0,9,,,,5,5,0,2,2,1,0,1,4,0,0,0,0,0,0,0,0
"Sep 22, 2019 12:00 AM",16,6,10,,,,,,,,,,1,1,0,0,,,,6,6,0,1,1,1,1,0,4,0,0,0,0,0,0,0,0
"Sep 22, 2019 1:00 AM",6,0,6,,,,,,,,,,0,0,0,2,,,,7,7,0,3,0,4,3,1,2,0,1,0,0,0,0,0,0
"Sep 22, 2019 2:00 AM",3,2,1,,,,,,,,,,0,0,0,3,,,,4,4,0,0,1,0,0,0,3,0,2,0,0,0,0,0,0
"Sep 22, 2019 3:00 AM",4,0,4,,,,,,,,,,0,0,0,1,,,,3,3,0,0,0,0,0,0,0,0,0,0,0,0,0,0,0
"Sep 22, 2019 4:00 AM",2,1,1,,,,,,,,,,0,0,0,0,,,,1,1,0,1,0,0,0,0,0,0,0,0,0,0,0,0,0
"Sep 22, 2019 5:00 AM",2,1,1,,,,,,,,,,0,0,0,1,,,,1,1,0,1,0,1,1,0,4,0,0,0,0,0,0,0,0
"Sep 22, 2019 6:00 AM",1,1,0,,,,,,,,,,0,0,0,0,,,,0,0,0,2,2,0,0,0,6,2,0,0,0,0,0,0,0
"Sep 22, 2019 7:00 AM",8,6,2,,,,,,,,,,0,0,0,2,,,,3,2,1,1,4,1,0,1,4,0,0,0,0,0,0,0,0
"Sep 22, 2019 8:00 AM",13,7,6,,,,,,,,,,1,1,0,2,,,,3,2,1,1,4,3,1,2,4,0,1,0,0,0,0,0,0
"Sep 22, 2019 9:00 AM",20,17,3,,,,,,,,,,5,3,2,4,,,,6,5,1,3,6,2,0,2,2,1,4,0,0,0,0,0,0
"Sep 22, 2019 10:00 AM",24,12,12,,,,,,,,,,4,3,1,8,,,,4,3,1,11,7,4,1,3,0,4,6,1,0,1,0,0,0
"Sep 22, 2019 11:00 AM",50,27,23,,,,,,,,,,17,12,5,13,,,,7,3,4,18,15,5,0,5,2,3,6,3,2,1,0,0,0
"Sep 22, 2019 12:00 PM",41,26,15,,,,,,,,,,17,7,10,22,,,,9,7,2,20,12,14,7,7,8,1,0,7,2,5,0,0,0
"Sep 22, 2019 1:00 PM",22,4,18,,,,,,,,,,20,13,7,10,,,,7,5,2,9,15,11,5,6,18,4,1,4,2,2,2,0,2
"Sep 22, 2019 2:00 PM",40,24,16,,,,,,,,,,20,6,14,13,,,,16,15,1,8,16,21,8,13,20,3,4,5,3,2,2,1,1
"Sep 22, 2019 3:00 PM",46,22,24,,,,,,,,,,16,10,6,20,,,,11,9,2,16,19,24,13,11,14,5,8,4,1,3,0,0,0
"Sep 22, 2019 4:00 PM",52,27,25,,,,,,,,,,9,6,3,26,,,,14,10,4,14,16,25,9,16,18,3,2,1,1,0,0,0,0
"Sep 22, 2019 5:00 PM",56,19,37,,,,,,,,,,22,15,7,23,,,,18,16,2,10,10,28,13,15,16,0,1,2,1,1,0,0,0
"Sep 22, 2019 6:00 PM",37,9,28,,,,,,,,,,11,3,8,4,,,,21,17,4,7,12,18,8,10,16,0,2,1,1,0,0,0,0
"Sep 22, 2019 7:00 PM",27,11,16,,,,,,,,,,7,6,1,4,,,,10,7,3,3,6,2,1,1,11,2,0,2,1,1,0,0,0
"Sep 22, 2019 8:00 PM",24,8,16,,,,,,,,,,4,2,2,4,,,,5,4,1,5,4,5,2,3,4,0,0,0,0,0,1,1,0
"Sep 22, 2019 9:00 PM",11,2,9,,,,,,,,,,1,1,0,0,,,,4,2,2,4,4,4,2,2,3,0,0,0,0,0,0,0,0
"Sep 22, 2019 10:00 PM",4,0,4,,,,,,,,,,1,0,1,1,,,,1,1,0,2,5,2,2,0,5,0,2,0,0,0,1,0,1
"Sep 22, 2019 11:00 PM",8,3,5,,,,,,,,,,1,1,0,0,,,,4,4,0,3,1,2,1,1,5,0,0,2,1,1,0,0,0
"Sep 23, 2019 12:00 AM",3,1,2,,,,,,,,,,0,0,0,0,,,,3,3,0,0,2,3,2,1,2,0,0,0,0,0,0,0,0
"Sep 23, 2019 1:00 AM",3,0,3,,,,,,,,,,0,0,0,0,,,,2,2,0,0,1,0,0,0,1,0,1,1,0,1,0,0,0
"Sep 23, 2019 2:00 AM",1,0,1,,,,,,,,,,0,0,0,0,,,,1,1,0,0,0,0,0,0,0,0,0,0,0,0,0,0,0
"Sep 23, 2019 3:00 AM",1,1,0,,,,,,,,,,0,0,0,1,,,,0,0,0,0,0,0,0,0,0,0,0,0,0,0,0,0,0
"Sep 23, 2019 4:00 AM",1,0,1,,,,,,,,,,0,0,0,0,,,,0,0,0,1,0,0,0,0,1,0,0,0,0,0,0,0,0
"Sep 23, 2019 5:00 AM",5,5,0,,,,,,,,,,0,0,0,1,,,,1,1,0,5,6,0,0,0,14,3,0,0,0,0,1,0,1
"Sep 23, 2019 6:00 AM",47,34,13,,,,,,,,,,5,1,4,6,,,,8,7,1,24,14,7,5,2,49,0,1,2,1,1,1,0,1
"Sep 23, 2019 7:00 AM",199,156,43,,,,,,,,,,10,5,5,12,,,,22,17,5,143,42,23,15,8,186,3,3,8,7,1,4,0,4
"Sep 23, 2019 8:00 AM",538,452,86,,,,,,,,,,25,7,18,38,,,,56,37,19,348,64,111,94,17,334,9,4,14,10,4,1,0,1
"Sep 23, 2019 9:00 AM",268,241,27,,,,,,,,,,12,4,8,9,,,,36,18,18,133,37,44,31,13,98,3,3,9,6,3,0,0,0
"Sep 23, 2019 10:00 AM",107,86,21,,,,,,,,,,17,8,9,10,,,,18,12,6,53,16,12,8,4,27,0,3,3,2,1,0,0,0
"Sep 23, 2019 11:00 AM",62,38,24,,,,,,,,,,2,2,0,7,,,,25,24,1,25,8,5,4,1,26,0,2,0,0,0,0,0,0
"Sep 23, 2019 12:00 PM",80,40,40,,,,,,,,,,8,5,3,5,,,,23,21,2,34,11,13,4,9,21,3,0,4,3,1,0,0,0
"Sep 23, 2019 1:00 PM",83,26,57,,,,,,,,,,15,14,1,4,,,,16,14,2,18,19,7,1,6,22,2,2,4,3,1,0,0,0
"Sep 23, 2019 2:00 PM",65,21,44,,,,,,,,,,7,2,5,6,,,,32,29,3,5,8,6,2,4,8,1,1,1,0,1,0,0,0
"Sep 23, 2019 3:00 PM",73,14,59,,,,,,,,,,5,5,0,10,,,,42,42,0,18,21,8,1,7,16,2,0,4,2,2,1,1,0
"Sep 23, 2019 4:00 PM",175,32,143,,,,,,,,,,6,4,2,10,,,,59,56,3,10,54,15,2,13,24,1,0,5,2,3,3,2,1
"Sep 23, 2019 5:00 PM",323,57,266,,,,,,,,,,11,6,5,18,,,,190,186,4,33,167,75,7,68,65,4,2,2,2,0,2,2,0
"Sep 23, 2019 6:00 PM",366,68,298,,,,,,,,,,20,11,9,26,,,,208,203,5,32,173,82,8,74,49,4,3,2,0,2,2,2,0
"Sep 23, 2019 7:00 PM",180,36,144,,,,,,,,,,11,8,3,19,,,,102,97,5,12,73,40,2,38,21,7,3,4,2,2,2,1,1
"Sep 23, 2019 8:00 PM",103,19,84,,,,,,,,,,5,2,3,9,,,,50,48,2,14,29,16,0,16,19,3,1,1,0,1,3,3,0
"Sep 23, 2019 9:00 PM",82,13,69,,,,,,,,,,2,2,0,8,,,,31,29,2,11,13,7,2,5,14,4,0,1,0,1,0,0,0
"Sep 23, 2019 10:00 PM",47,7,40,,,,,,,,,,1,1,0,2,,,,16,15,1,3,15,1,0,1,5,1,0,1,1,0,0,0,0
"Sep 23, 2019 11:00 PM",20,1,19,,,,,,,,,,1,1,0,2,,,,18,18,0,0,7,1,1,0,3,0,0,1,0,1,0,0,0
"Sep 24, 2019 12:00 AM",9,3,6,,,,,,,,,,0,0,0,0,,,,5,4,1,2,3,1,0,1,4,1,0,1,1,0,1,1,0
"Sep 24, 2019 1:00 AM",2,0,2,,,,,,,,,,0,0,0,0,,,,0,0,0,0,0,0,0,0,1,0,1,0,0,0,0,0,0
"Sep 24, 2019 2:00 AM",0,0,0,,,,,,,,,,0,0,0,0,,,,1,1,0,0,1,0,0,0,0,0,0,0,0,0,0,0,0
"Sep 24, 2019 3:00 AM",2,2,0,,,,,,,,,,0,0,0,0,,,,0,0,0,0,0,0,0,0,0,0,0,0,0,0,0,0,0
"Sep 24, 2019 4:00 AM",4,2,2,,,,,,,,,,0,0,0,0,,,,0,0,0,1,0,0,0,0,0,0,0,2,1,1,0,0,0
"Sep 24, 2019 5:00 AM",6,4,2,,,,,,,,,,0,0,0,2,,,,2,1,1,6,2,0,0,0,13,2,0,0,0,0,0,0,0
"Sep 24, 2019 6:00 AM",46,35,11,,,,,,,,,,3,0,3,8,,,,7,4,3,36,10,8,7,1,49,0,3,1,0,1,0,0,0
"Sep 24, 2019 7:00 AM",213,171,42,,,,,,,,,,8,2,6,13,,,,28,24,4,121,43,26,14,12,170,2,3,7,6,1,3,0,3
"Sep 24, 2019 8:00 AM",538,455,83,,,,,,,,,,41,12,29,38,,,,54,30,24,343,75,116,98,18,356,8,7,14,11,3,2,0,2
"Sep 24, 2019 9:00 AM",246,225,21,,,,,,,,,,10,4,6,3,,,,36,19,17,154,34,34,21,13,101,2,8,5,4,1,2,1,1
"Sep 24, 2019 10:00 AM",106,83,23,,,,,,,,,,9,3,6,10,,,,19,11,8,68,14,15,6,9,46,2,4,2,0,2,2,1,1
"Sep 24, 2019 11:00 AM",96,67,29,,,,,,,,,,12,4,8,8,,,,19,17,2,29,22,14,8,6,29,1,2,2,2,0,0,0,0
"Sep 24, 2019 12:00 PM",80,39,41,,,,,,,,,,13,7,6,4,,,,28,23,5,21,15,22,13,9,27,4,4,2,2,0,0,0,0
"Sep 24, 2019 1:00 PM",112,57,55,,,,,,,,,,24,18,6,10,,,,31,22,9,38,23,20,6,14,32,3,0,4,4,0,0,0,0
"Sep 24, 2019 2:00 PM",101,46,55,,,,,,,,,,21,10,11,5,,,,31,27,4,21,29,20,6,14,20,3,2,4,3,1,1,1,0
"Sep 24, 2019 3:00 PM",113,22,91,,,,,,,,,,11,7,4,19,,,,63,60,3,24,27,24,9,15,27,5,3,10,7,3,1,0,1
"Sep 24, 2019 4:00 PM",186,51,135,,,,,,,,,,10,8,2,14,,,,89,88,1,30,59,32,6,26,37,2,2,2,1,1,1,0,1
"Sep 24, 2019 5:00 PM",373,70,303,,,,,,,,,,22,13,9,27,,,,174,166,8,48,211,82,13,69,70,2,3,6,1,5,0,0,0
"Sep 24, 2019 6:00 PM",374,67,307,,,,,,,,,,25,20,5,24,,,,225,224,1,56,187,98,6,92,56,11,4,1,0,1,5,2,3
"Sep 24, 2019 7:00 PM",234,38,196,,,,,,,,,,11,8,3,19,,,,117,112,5,28,78,42,4,38,42,3,3,9,5,4,5,3,2
"Sep 24, 2019 8:00 PM",157,24,133,,,,,,,,,,5,5,0,16,,,,58,55,3,17,46,16,3,13,22,5,5,7,3,4,6,5,1
"Sep 24, 2019 9:00 PM",82,11,71,,,,,,,,,,2,2,0,4,,,,41,39,2,9,31,8,1,7,18,1,1,5,2,3,2,2,0
"Sep 24, 2019 10:00 PM",46,9,37,,,,,,,,,,1,1,0,1,,,,26,25,1,2,26,3,0,3,18,1,1,1,1,0,2,0,2
"Sep 24, 2019 11:00 PM",20,5,15,,,,,,,,,,3,2,1,1,,,,17,17,0,2,6,4,2,2,4,0,0,0,0,0,1,1,0
"Sep 25, 2019 12:00 AM",11,3,8,,,,,,,,,,1,0,1,1,,,,8,8,0,4,2,1,1,0,3,0,0,0,0,0,0,0,0
"Sep 25, 2019 1:00 AM",1,0,1,,,,,,,,,,0,0,0,0,,,,3,3,0,0,2,0,0,0,1,0,0,1,1,0,0,0,0
"Sep 25, 2019 2:00 AM",4,1,3,,,,,,,,,,0,0,0,0,,,,2,1,1,1,1,0,0,0,0,0,0,0,0,0,0,0,0
"Sep 25, 2019 3:00 AM",3,1,2,,,,,,,,,,0,0,0,0,,,,2,2,0,0,0,0,0,0,0,0,0,0,0,0,0,0,0
"Sep 25, 2019 4:00 AM",3,1,2,,,,,,,,,,0,0,0,0,,,,0,0,0,1,0,0,0,0,2,0,0,0,0,0,0,0,0
"Sep 25, 2019 5:00 AM",8,7,1,,,,,,,,,,0,0,0,4,,,,3,2,1,8,3,0,0,0,12,4,0,0,0,0,0,0,0
"Sep 25, 2019 6:00 AM",58,43,15,,,,,,,,,,5,1,4,10,,,,10,9,1,32,22,10,7,3,52,1,3,3,1,2,1,0,1
"Sep 25, 2019 7:00 AM",244,190,54,,,,,,,,,,9,1,8,17,,,,32,22,10,169,55,40,31,9,180,4,4,8,6,2,1,0,1
"Sep 25, 2019 8:00 AM",544,455,89,,,,,,,,,,48,13,35,37,,,,59,34,25,336,76,112,90,22,380,10,7,15,14,1,2,0,2
"Sep 25, 2019 9:00 AM",280,245,35,,,,,,,,,,21,8,13,12,,,,40,19,21,162,33,53,38,15,111,1,4,7,4,3,1,0,1
"Sep 25, 2019 10:00 AM",118,98,20,,,,,,,,,,14,7,7,2,,,,26,15,11,69,22,23,11,12,34,4,2,1,0,1,0,0,0
"Sep 25, 2019 11:00 AM",84,55,29,,,,,,,,,,18,8,10,5,,,,19,11,8,40,14,12,5,7,27,2,0,1,1,0,2,1,1
"Sep 25, 2019 12:00 PM",92,49,43,,,,,,,,,,18,9,9,8,,,,39,26,13,33,22,23,8,15,36,1,1,4,1,3,1,1,0
"Sep 25, 2019 1:00 PM",100,46,54,,,,,,,,,,24,13,11,10,,,,43,38,5,34,29,33,9,24,28,8,0,4,2,2,2,2,0
"Sep 25, 2019 2:00 PM",103,33,70,,,,,,,,,,19,10,9,13,,,,45,43,2,32,25,16,5,11,27,3,6,4,1,3,2,2,0
"Sep 25, 2019 3:00 PM",109,39,70,,,,,,,,,,20,15,5,13,,,,46,38,8,21,29,19,7,12,27,3,2,11,4,7,0,0,0
"Sep 25, 2019 4:00 PM",193,46,147,,,,,,,,,,17,12,5,28,,,,90,87,3,28,80,36,9,27,46,6,1,3,3,0,3,3,0
"Sep 25, 2019 5:00 PM",365,76,289,,,,,,,,,,17,10,7,30,,,,169,164,5,47,210,83,8,75,72,5,3,10,4,6,1,0,1
"Sep 25, 2019 6:00 PM",404,75,329,,,,,,,,,,30,24,6,33,,,,232,226,6,43,192,111,12,99,59,7,6,7,5,2,2,2,0
"Sep 25, 2019 7:00 PM",226,42,184,,,,,,,,,,12,9,3,20,,,,120,114,6,24,90,46,8,38,36,2,3,8,4,4,2,1,1
"Sep 25, 2019 8:00 PM",145,34,111,,,,,,,,,,2,1,1,15,,,,59,56,3,16,38,12,5,7,22,6,1,5,2,3,2,1,1
"Sep 25, 2019 9:00 PM",61,7,54,,,,,,,,,,6,4,2,9,,,,39,38,1,7,13,8,4,4,15,5,1,3,3,0,1,1,0
"Sep 25, 2019 10:00 PM",49,7,42,,,,,,,,,,4,3,1,7,,,,28,25,3,3,16,2,1,1,11,0,0,1,1,0,0,0,0
"Sep 25, 2019 11:00 PM",26,3,23,,,,,,,,,,1,1,0,1,,,,16,16,0,3,8,4,1,3,3,0,1,0,0,0,0,0,0
"Sep 26, 2019 12:00 AM",11,2,9,,,,,,,,,,3,0,3,0,,,,9,9,0,2,4,4,2,2,4,0,1,0,0,0,0,0,0
"Sep 26, 2019 1:00 AM",2,0,2,,,,,,,,,,1,1,0,2,,,,1,1,0,0,4,0,0,0,3,0,0,0,0,0,0,0,0
"Sep 26, 2019 2:00 AM",3,0,3,,,,,,,,,,0,0,0,0,,,,2,2,0,0,3,1,0,1,1,0,0,1,0,1,0,0,0
"Sep 26, 2019 3:00 AM",2,1,1,,,,,,,,,,0,0,0,1,,,,2,2,0,0,0,0,0,0,0,1,0,0,0,0,0,0,0
"Sep 26, 2019 4:00 AM",6,2,4,,,,,,,,,,0,0,0,0,,,,3,3,0,1,0,0,0,0,0,1,0,0,0,0,0,0,0
"Sep 26, 2019 5:00 AM",12,11,1,,,,,,,,,,0,0,0,1,,,,2,1,1,8,2,1,1,0,11,1,0,1,0,1,0,0,0
"Sep 26, 2019 6:00 AM",51,31,20,,,,,,,,,,1,0,1,8,,,,12,10,2,35,17,7,4,3,41,3,3,2,2,0,0,0,0
"Sep 26, 2019 7:00 AM",205,156,49,,,,,,,,,,13,0,13,9,,,,22,17,5,138,50,36,24,12,171,3,3,6,6,0,4,0,4
"Sep 26, 2019 8:00 AM",502,431,71,,,,,,,,,,49,14,35,37,,,,52,39,13,320,88,90,71,19,351,8,12,10,6,4,3,0,3
"Sep 26, 2019 9:00 AM",255,225,30,,,,,,,,,,21,11,10,12,,,,36,21,15,144,37,49,27,22,121,2,5,6,3,3,2,1,1
"Sep 26, 2019 10:00 AM",107,84,23,,,,,,,,,,10,5,5,7,,,,22,13,9,74,12,18,6,12,39,0,6,0,0,0,2,2,0
"Sep 26, 2019 11:00 AM",85,50,35,,,,,,,,,,6,2,4,5,,,,20,15,5,39,14,13,4,9,26,1,3,2,1,1,0,0,0
"Sep 26, 2019 12:00 PM",107,53,54,,,,,,,,,,13,7,6,11,,,,19,15,4,18,21,10,7,3,19,3,2,4,4,0,3,1,2
"Sep 26, 2019 1:00 PM",93,39,54,,,,,,,,,,7,5,2,10,,,,32,26,6,30,30,27,7,20,20,2,1,3,3,0,0,0,0
"Sep 26, 2019 2:00 PM",103,41,62,,,,,,,,,,12,8,4,14,,,,37,26,11,25,22,12,7,5,20,2,2,4,1,3,3,1,2
"Sep 26, 2019 3:00 PM",116,31,85,,,,,,,,,,17,7,10,11,,,,49,47,2,24,37,21,4,17,27,4,5,9,3,6,2,2,0
"Sep 26, 2019 4:00 PM",208,43,165,,,,,,,,,,11,9,2,16,,,,83,80,3,36,75,41,11,30,40,5,7,5,2,3,3,2,1
"Sep 26, 2019 5:00 PM",349,73,276,,,,,,,,,,30,16,14,21,,,,194,188,6,55,175,90,22,68,84,5,5,11,5,6,3,3,0
"Sep 26, 2019 6:00 PM",301,53,248,,,,,,,,,,16,13,3,16,,,,196,191,5,37,150,58,6,52,45,3,1,4,1,3,0,0,0
"Sep 26, 2019 7:00 PM",200,34,166,,,,,,,,,,11,8,3,11,,,,78,74,4,17,76,32,6,26,11,4,3,4,2,2,2,1,1
"Sep 26, 2019 8:00 PM",104,22,82,,,,,,,,,,8,5,3,6,,,,48,44,4,20,40,11,2,9,12,6,4,2,1,1,0,0,0
"Sep 26, 2019 9:00 PM",81,14,67,,,,,,,,,,1,1,0,3,,,,35,34,1,7,25,9,0,9,15,3,1,0,0,0,0,0,0
"Sep 26, 2019 10:00 PM",47,7,40,,,,,,,,,,3,1,2,2,,,,33,33,0,4,10,8,0,8,17,0,0,3,2,1,0,0,0
"Sep 26, 2019 11:00 PM",26,4,22,,,,,,,,,,1,0,1,2,,,,19,18,1,1,13,1,0,1,6,0,0,1,0,1,0,0,0
"Sep 27, 2019 12:00 AM",9,1,8,,,,,,,,,,1,1,0,0,,,,8,8,0,1,6,3,2,1,3,0,0,1,1,0,0,0,0
"Sep 27, 2019 1:00 AM",3,1,2,,,,,,,,,,0,0,0,0,,,,2,2,0,0,2,1,0,1,2,0,0,1,0,1,1,0,1
"Sep 27, 2019 2:00 AM",5,1,4,,,,,,,,,,0,0,0,0,,,,1,1,0,0,1,1,0,1,0,0,0,0,0,0,0,0,0
"Sep 27, 2019 3:00 AM",2,1,1,,,,,,,,,,0,0,0,1,,,,2,2,0,0,1,0,0,0,0,1,0,1,0,1,0,0,0
"Sep 27, 2019 4:00 AM",2,0,2,,,,,,,,,,1,1,0,0,,,,2,2,0,0,1,0,0,0,1,1,0,0,0,0,0,0,0
"Sep 27, 2019 5:00 AM",9,6,3,,,,,,,,,,0,0,0,1,,,,3,3,0,6,4,0,0,0,11,3,0,0,0,0,0,0,0
"Sep 27, 2019 6:00 AM",39,26,13,,,,,,,,,,2,1,1,5,,,,9,8,1,20,14,3,2,1,44,3,4,0,0,0,0,0,0
"Sep 27, 2019 7:00 AM",139,105,34,,,,,,,,,,9,1,8,12,,,,14,10,4,118,44,23,18,5,120,1,1,3,3,0,4,0,4
"Sep 27, 2019 8:00 AM",344,277,67,,,,,,,,,,21,7,14,18,,,,36,23,13,209,51,62,53,9,221,0,3,6,5,1,2,1,1
"Sep 27, 2019 9:00 AM",172,155,17,,,,,,,,,,8,1,7,7,,,,23,10,13,82,15,25,18,7,62,3,0,2,2,0,0,0,0
"Sep 27, 2019 10:00 AM",82,59,23,,,,,,,,,,2,1,1,8,,,,18,8,10,36,8,7,2,5,23,0,0,1,1,0,2,1,1
"Sep 27, 2019 11:00 AM",72,39,33,,,,,,,,,,12,3,9,4,,,,21,15,6,22,9,6,1,5,26,2,0,0,0,0,2,1,1
"Sep 27, 2019 12:00 PM",95,40,55,,,,,,,,,,16,9,7,7,,,,21,19,2,34,20,9,4,5,18,3,1,2,1,1,0,0,0
"Sep 27, 2019 1:00 PM",100,29,71,,,,,,,,,,13,10,3,5,,,,29,23,6,27,28,9,1,8,21,3,0,2,1,1,0,0,0
"Sep 27, 2019 2:00 PM",105,53,52,,,,,,,,,,8,5,3,9,,,,39,34,5,22,29,10,4,6,22,4,2,6,4,2,1,1,0
"Sep 27, 2019 3:00 PM",103,29,74,,,,,,,,,,15,6,9,13,,,,44,42,2,28,38,16,6,10,27,2,2,5,2,3,4,4,0
"Sep 27, 2019 4:00 PM",147,44,103,,,,,,,,,,22,16,6,18,,,,74,71,3,16,67,25,4,21,38,2,2,3,1,2,0,0,0
"Sep 27, 2019 5:00 PM",279,49,230,,,,,,,,,,15,11,4,20,,,,131,129,2,36,152,63,10,53,53,4,7,1,1,0,1,0,1
"Sep 27, 2019 6:00 PM",208,40,168,,,,,,,,,,13,8,5,15,,,,134,131,3,23,108,59,6,53,45,4,5,6,3,3,1,1,0
"Sep 27, 2019 7:00 PM",135,37,98,,,,,,,,,,13,8,5,20,,,,55,52,3,14,46,19,4,15,21,8,0,2,1,1,1,1,0
"Sep 27, 2019 8:00 PM",59,19,40,,,,,,,,,,4,2,2,5,,,,30,30,0,11,26,8,2,6,11,1,1,4,2,2,1,1,0
"Sep 27, 2019 9:00 PM",43,17,26,,,,,,,,,,5,3,2,6,,,,17,16,1,6,14,5,2,3,13,0,0,2,0,2,0,0,0
"Sep 27, 2019 10:00 PM",30,10,20,,,,,,,,,,3,1,2,3,,,,11,11,0,6,12,3,3,0,8,1,0,1,1,0,1,0,1
"Sep 27, 2019 11:00 PM",24,5,19,,,,,,,,,,4,2,2,1,,,,13,13,0,5,5,7,4,3,4,0,0,0,0,0,0,0,0
"Sep 28, 2019 12:00 AM",14,3,11,,,,,,,,,,0,0,0,1,,,,2,2,0,4,2,1,1,0,6,0,1,1,1,0,2,2,0
"Sep 28, 2019 1:00 AM",5,2,3,,,,,,,,,,1,0,1,0,,,,5,4,1,0,2,1,1,0,3,1,0,0,0,0,0,0,0
"Sep 28, 2019 2:00 AM",5,1,4,,,,,,,,,,0,0,0,0,,,,3,3,0,0,4,2,0,2,1,0,1,0,0,0,0,0,0
"Sep 28, 2019 3:00 AM",3,1,2,,,,,,,,,,0,0,0,2,,,,6,6,0,0,0,1,0,1,0,0,0,0,0,0,0,0,0
"Sep 28, 2019 4:00 AM",6,1,5,,,,,,,,,,0,0,0,0,,,,1,1,0,2,1,1,0,1,0,0,0,0,0,0,0,0,0
"Sep 28, 2019 5:00 AM",4,2,2,,,,,,,,,,0,0,0,2,,,,3,3,0,1,2,0,0,0,1,0,0,0,0,0,0,0,0
"Sep 28, 2019 6:00 AM",15,10,5,,,,,,,,,,4,3,1,1,,,,2,2,0,6,6,1,1,0,9,1,0,0,0,0,0,0,0
"Sep 28, 2019 7:00 AM",14,8,6,,,,,,,,,,4,3,1,2,,,,4,3,1,7,16,3,1,2,16,2,0,0,0,0,0,0,0
"Sep 28, 2019 8:00 AM",27,17,10,,,,,,,,,,5,2,3,5,,,,11,8,3,13,10,5,2,3,16,1,0,1,0,1,0,0,0
"Sep 28, 2019 9:00 AM",38,30,8,,,,,,,,,,10,5,5,6,,,,9,7,2,16,18,7,4,3,20,1,3,2,2,0,1,0,1
"Sep 28, 2019 10:00 AM",42,27,15,,,,,,,,,,16,8,8,40,,,,16,10,6,27,18,13,2,11,19,5,3,4,4,0,1,0,1
"Sep 28, 2019 11:00 AM",63,38,25,,,,,,,,,,22,12,10,28,,,,16,14,2,22,23,24,8,16,28,1,11,2,2,0,3,0,3
"Sep 28, 2019 12:00 PM",54,26,28,,,,,,,,,,39,28,11,24,,,,16,12,4,23,22,29,12,17,32,2,2,1,0,1,2,0,2
"Sep 28, 2019 1:00 PM",72,36,36,,,,,,,,,,23,17,6,22,,,,18,16,2,23,29,34,21,13,22,5,5,1,1,0,1,1,0
"Sep 28, 2019 2:00 PM",58,37,21,,,,,,,,,,28,17,11,20,,,,18,15,3,19,24,30,12,18,27,3,3,4,2,2,1,1,0
"Sep 28, 2019 3:00 PM",58,25,33,,,,,,,,,,25,10,15,12,,,,21,16,5,23,26,13,5,8,21,3,4,7,6,1,2,0,2
"Sep 28, 2019 4:00 PM",49,16,33,,,,,,,,,,39,23,16,16,,,,30,24,6,18,20,24,9,15,24,4,2,3,1,2,3,2,1
"Sep 28, 2019 5:00 PM",59,24,35,,,,,,,,,,25,13,12,6,,,,24,22,2,22,17,30,10,20,20,5,1,7,5,2,3,1,2
"Sep 28, 2019 6:00 PM",54,19,35,,,,,,,,,,18,12,6,12,,,,19,18,1,14,16,16,6,10,14,5,2,4,2,2,1,1,0
"Sep 28, 2019 7:00 PM",47,21,26,,,,,,,,,,5,3,2,11,,,,13,9,4,6,10,5,3,2,13,1,0,1,1,0,2,2,0
"Sep 28, 2019 8:00 PM",15,8,7,,,,,,,,,,5,4,1,6,,,,7,7,0,4,3,2,0,2,8,1,0,2,2,0,0,0,0
"Sep 28, 2019 9:00 PM",9,4,5,,,,,,,,,,3,3,0,4,,,,5,5,0,2,1,1,0,1,3,0,0,1,1,0,1,0,1
"Sep 28, 2019 10:00 PM",16,3,13,,,,,,,,,,2,2,0,0,,,,4,4,0,0,2,1,0,1,4,0,1,0,0,0,0,0,0
"Sep 28, 2019 11:00 PM",15,7,8,,,,,,,,,,0,0,0,2,,,,6,6,0,4,4,1,1,0,2,0,0,0,0,0,0,0,0
"Sep 29, 2019 12:00 AM",7,1,6,,,,,,,,,,2,1,1,0,,,,3,3,0,3,2,1,1,0,2,0,0,0,0,0,0,0,0
"Sep 29, 2019 1:00 AM",3,2,1,,,,,,,,,,0,0,0,1,,,,1,1,0,0,1,0,0,0,2,0,0,0,0,0,0,0,0
"Sep 29, 2019 2:00 AM",1,0,1,,,,,,,,,,1,1,0,0,,,,2,2,0,0,0,1,1,0,3,0,1,0,0,0,0,0,0
"Sep 29, 2019 3:00 AM",1,0,1,,,,,,,,,,0,0,0,0,,,,2,1,1,0,1,1,0,1,0,0,0,0,0,0,0,0,0
"Sep 29, 2019 4:00 AM",1,1,0,,,,,,,,,,0,0,0,1,,,,0,0,0,0,0,0,0,0,0,0,0,0,0,0,0,0,0
"Sep 29, 2019 5:00 AM",3,2,1,,,,,,,,,,0,0,0,0,,,,0,0,0,0,1,0,0,0,4,0,0,0,0,0,0,0,0
"Sep 29, 2019 6:00 AM",11,9,2,,,,,,,,,,0,0,0,2,,,,1,1,0,11,5,3,3,0,19,2,0,0,0,0,0,0,0
"Sep 29, 2019 7:00 AM",9,6,3,,,,,,,,,,1,1,0,3,,,,7,4,3,11,12,4,0,4,26,1,1,1,1,0,1,0,1
"Sep 29, 2019 8:00 AM",19,16,3,,,,,,,,,,6,2,4,6,,,,4,2,2,11,10,1,0,1,15,1,3,1,1,0,0,0,0
"Sep 29, 2019 9:00 AM",26,20,6,,,,,,,,,,4,0,4,6,,,,8,5,3,15,10,5,2,3,15,0,3,1,0,1,0,0,0
"Sep 29, 2019 10:00 AM",31,17,14,,,,,,,,,,12,4,8,8,,,,7,6,1,10,19,21,7,14,59,3,4,5,1,4,0,0,0
"Sep 29, 2019 11:00 AM",45,24,21,,,,,,,,,,16,5,11,10,,,,11,9,2,14,15,15,3,12,22,2,3,5,3,2,0,0,0
"Sep 29, 2019 12:00 PM",70,32,38,,,,,,,,,,25,12,13,10,,,,12,9,3,17,23,21,6,15,26,0,5,3,1,2,1,1,0
"Sep 29, 2019 1:00 PM",62,32,30,,,,,,,,,,24,11,13,17,,,,15,13,2,14,55,35,13,22,28,3,1,5,3,2,1,0,1
"Sep 29, 2019 2:00 PM",55,25,30,,,,,,,,,,27,14,13,10,,,,18,16,2,13,19,32,9,23,37,2,2,3,1,2,0,0,0
"Sep 29, 2019 3:00 PM",54,20,34,,,,,,,,,,28,15,13,15,,,,21,18,3,15,24,15,4,11,28,2,5,3,2,1,0,0,0
"Sep 29, 2019 4:00 PM",45,22,23,,,,,,,,,,26,15,11,18,,,,9,8,1,8,16,27,10,17,28,7,8,9,4,5,2,1,1
"Sep 29, 2019 5:00 PM",63,26,37,,,,,,,,,,33,18,15,8,,,,17,15,2,13,19,25,8,17,24,2,4,5,4,1,0,0,0
"Sep 29, 2019 6:00 PM",50,20,30,,,,,,,,,,15,13,2,12,,,,14,11,3,5,12,32,21,11,21,0,2,3,1,2,0,0,0
"Sep 29, 2019 7:00 PM",32,14,18,,,,,,,,,,14,5,9,9,,,,12,7,5,3,15,14,9,5,8,1,2,4,1,3,2,0,2
"Sep 29, 2019 8:00 PM",32,15,17,,,,,,,,,,1,1,0,5,,,,9,7,2,12,7,1,0,1,7,0,1,1,0,1,1,1,0
"Sep 29, 2019 9:00 PM",24,7,17,,,,,,,,,,1,1,0,2,,,,6,6,0,6,5,3,2,1,8,2,0,0,0,0,1,1,0
"Sep 29, 2019 10:00 PM",18,7,11,,,,,,,,,,0,0,0,1,,,,2,2,0,0,3,2,0,2,6,0,3,2,2,0,0,0,0
"Sep 29, 2019 11:00 PM",9,2,7,,,,,,,,,,1,0,1,0,,,,2,2,0,3,4,1,0,1,3,0,0,0,0,0,0,0,0
"Sep 30, 2019 12:00 AM",2,2,0,,,,,,,,,,1,0,1,1,,,,2,2,0,1,3,0,0,0,4,1,0,0,0,0,0,0,0
"Sep 30, 2019 1:00 AM",5,1,4,,,,,,,,,,0,0,0,0,,,,2,2,0,0,2,0,0,0,0,0,3,0,0,0,0,0,0
"Sep 30, 2019 2:00 AM",0,0,0,,,,,,,,,,0,0,0,0,,,,0,0,0,0,0,0,0,0,0,0,0,0,0,0,0,0,0
"Sep 30, 2019 3:00 AM",0,0,0,,,,,,,,,,0,0,0,1,,,,2,2,0,0,0,0,0,0,0,0,0,0,0,0,0,0,0
"Sep 30, 2019 4:00 AM",2,2,0,,,,,,,,,,0,0,0,0,,,,1,1,0,1,0,1,0,1,0,0,0,0,0,0,0,0,0
"Sep 30, 2019 5:00 AM",5,3,2,,,,,,,,,,1,0,1,2,,,,0,0,0,9,5,0,0,0,14,4,0,0,0,0,0,0,0
"Sep 30, 2019 6:00 AM",51,39,12,,,,,,,,,,2,0,2,1,,,,10,8,2,27,16,7,4,3,39,0,3,3,1,2,1,0,1
"Sep 30, 2019 7:00 AM",184,139,45,,,,,,,,,,7,1,6,17,,,,28,24,4,123,39,30,20,10,175,0,5,6,5,1,1,0,1
"Sep 30, 2019 8:00 AM",462,391,71,,,,,,,,,,39,14,25,42,,,,46,30,16,323,70,116,91,25,332,10,7,16,12,4,3,0,3
"Sep 30, 2019 9:00 AM",259,231,28,,,,,,,,,,21,6,15,10,,,,41,19,22,145,29,45,27,18,115,3,5,3,2,1,0,0,0
"Sep 30, 2019 10:00 AM",118,97,21,,,,,,,,,,10,7,3,13,,,,11,5,6,69,11,13,3,10,28,5,1,6,3,3,3,1,2
"Sep 30, 2019 11:00 AM",65,41,24,,,,,,,,,,8,4,4,8,,,,22,15,7,32,16,12,5,7,20,1,0,2,2,0,0,0,0
"Sep 30, 2019 12:00 PM",74,36,38,,,,,,,,,,10,5,5,8,,,,24,19,5,17,19,12,2,10,18,1,0,5,3,2,0,0,0
"Sep 30, 2019 1:00 PM",68,28,40,,,,,,,,,,7,6,1,7,,,,21,19,2,24,14,2,1,1,17,4,1,2,1,1,0,0,0
"Sep 30, 2019 2:00 PM",48,16,32,,,,,,,,,,10,5,5,7,,,,18,17,1,5,15,2,1,1,13,0,0,3,2,1,1,0,1
"Sep 30, 2019 3:00 PM",75,14,61,,,,,,,,,,2,1,1,6,,,,30,29,1,22,11,3,1,2,15,4,0,9,2,7,1,1,0
"Sep 30, 2019 4:00 PM",153,29,124,,,,,,,,,,4,4,0,9,,,,61,58,3,9,52,21,6,15,27,3,0,3,2,1,1,1,0
"Sep 30, 2019 5:00 PM",279,45,234,,,,,,,,,,8,8,0,12,,,,121,116,5,37,158,53,4,49,54,7,0,3,3,0,1,1,0
"Sep 30, 2019 6:00 PM",297,28,269,,,,,,,,,,17,7,10,20,,,,190,185,5,28,152,74,4,70,32,5,7,1,1,0,2,2,0
"Sep 30, 2019 7:00 PM",143,16,127,,,,,,,,,,5,4,1,6,,,,101,99,2,11,67,26,0,26,15,2,3,2,0,2,1,1,0
"Sep 30, 2019 8:00 PM",75,6,69,,,,,,,,,,1,1,0,1,,,,38,38,0,3,18,15,3,12,6,1,0,1,1,0,0,0,0
"Sep 30, 2019 9:00 PM",30,4,26,,,,,,,,,,0,0,0,5,,,,16,15,1,2,6,4,0,4,7,2,1,1,0,1,0,0,0
"Sep 30, 2019 10:00 PM",24,6,18,,,,,,,,,,1,0,1,1,,,,10,10,0,1,12,0,0,0,4,0,0,1,0,1,1,1,0
"Sep 30, 2019 11:00 PM",11,3,8,,,,,,,,,,0,0,0,0,,,,4,4,0,0,5,0,0,0,3,0,0,0,0,0,0,0,0
"Oct 1, 2019 12:00 AM",4,1,3,,,,,,,,,,0,0,0,1,,,,2,2,0,1,3,0,0,0,1,0,2,0,0,0,0,0,0
"Oct 1, 2019 1:00 AM",2,0,2,,,,,,,,,,0,0,0,0,,,,2,2,0,0,0,0,0,0,0,0,0,0,0,0,0,0,0
"Oct 1, 2019 2:00 AM",2,1,1,,,,,,,,,,0,0,0,0,,,,0,0,0,0,3,0,0,0,0,0,0,0,0,0,0,0,0
"Oct 1, 2019 3:00 AM",0,0,0,,,,,,,,,,0,0,0,0,,,,1,1,0,0,0,0,0,0,0,0,0,1,0,1,0,0,0
"Oct 1, 2019 4:00 AM",5,2,3,,,,,,,,,,0,0,0,0,,,,1,1,0,1,0,0,0,0,0,0,0,0,0,0,0,0,0
"Oct 1, 2019 5:00 AM",6,4,2,,,,,,,,,,0,0,0,3,,,,1,0,1,4,5,0,0,0,11,2,0,0,0,0,0,0,0
"Oct 1, 2019 6:00 AM",56,38,18,,,,,,,,,,1,0,1,6,,,,7,6,1,27,9,6,4,2,42,2,1,0,0,0,0,0,0
"Oct 1, 2019 7:00 AM",160,127,33,,,,,,,,,,8,2,6,15,,,,23,19,4,109,32,18,14,4,145,1,3,6,6,0,1,0,1
"Oct 1, 2019 8:00 AM",449,381,68,,,,,,,,,,19,6,13,23,,,,42,25,17,272,61,52,46,6,284,3,2,8,7,1,2,0,2
"Oct 1, 2019 9:00 AM",211,191,20,,,,,,,,,,8,4,4,3,,,,30,18,12,105,18,21,11,10,80,1,2,0,0,0,0,0,0
"Oct 1, 2019 10:00 AM",74,61,13,,,,,,,,,,1,1,0,3,,,,12,7,5,37,2,4,3,1,17,0,0,0,0,0,0,0,0
"Oct 1, 2019 11:00 AM",39,25,14,,,,,,,,,,2,1,1,1,,,,11,10,1,16,9,1,0,1,4,0,0,1,1,0,0,0,0
"Oct 1, 2019 12:00 PM",48,32,16,,,,,,,,,,7,5,2,6,,,,9,9,0,11,4,1,1,0,14,0,2,1,0,1,1,1,0
"Oct 1, 2019 1:00 PM",52,18,34,,,,,,,,,,2,0,2,2,,,,17,13,4,9,13,2,1,1,4,0,2,0,0,0,0,0,0
"Oct 1, 2019 2:00 PM",47,10,37,,,,,,,,,,8,5,3,2,,,,17,15,2,4,13,1,0,1,6,2,0,1,1,0,1,1,0
"Oct 1, 2019 3:00 PM",60,14,46,,,,,,,,,,8,4,4,4,,,,29,27,2,13,16,4,0,4,17,2,0,6,3,3,1,1,0
"Oct 1, 2019 4:00 PM",148,28,120,,,,,,,,,,6,0,6,14,,,,58,55,3,14,55,13,1,12,25,3,2,2,2,0,1,1,0
"Oct 1, 2019 5:00 PM",327,63,264,,,,,,,,,,6,2,4,17,,,,139,137,2,41,156,59,5,54,62,6,0,9,4,5,6,1,5
"Oct 1, 2019 6:00 PM",323,56,267,,,,,,,,,,10,6,4,23,,,,177,173,4,31,164,64,3,61,38,2,1,6,5,1,2,2,0
"Oct 1, 2019 7:00 PM",181,36,145,,,,,,,,,,5,3,2,11,,,,85,83,2,20,57,31,6,25,25,4,1,5,3,2,0,0,0
"Oct 1, 2019 8:00 PM",120,19,101,,,,,,,,,,3,2,1,10,,,,46,44,2,7,37,7,1,6,18,1,2,3,0,3,0,0,0
"Oct 1, 2019 9:00 PM",80,16,64,,,,,,,,,,1,0,1,4,,,,42,39,3,9,22,6,0,6,8,1,0,0,0,0,0,0,0
"Oct 1, 2019 10:00 PM",44,9,35,,,,,,,,,,2,1,1,1,,,,23,20,3,3,11,2,0,2,4,1,0,2,0,2,1,0,1
"Oct 1, 2019 11:00 PM",7,0,7,,,,,,,,,,0,0,0,1,,,,4,4,0,1,3,0,0,0,1,0,1,1,0,1,0,0,0
"Oct 2, 2019 12:00 AM",8,3,5,,,,,,,,,,3,3,0,1,,,,2,2,0,0,5,0,0,0,2,0,1,0,0,0,0,0,0
"Oct 2, 2019 1:00 AM",3,0,3,,,,,,,,,,0,0,0,1,,,,2,2,0,0,0,0,0,0,0,0,0,0,0,0,0,0,0
"Oct 2, 2019 2:00 AM",0,0,0,,,,,,,,,,0,0,0,0,,,,0,0,0,0,2,0,0,0,1,0,0,0,0,0,0,0,0
"Oct 2, 2019 3:00 AM",1,1,0,,,,,,,,,,0,0,0,1,,,,0,0,0,1,1,0,0,0,0,0,0,1,0,1,0,0,0
"Oct 2, 2019 4:00 AM",2,2,0,,,,,,,,,,0,0,0,0,,,,0,0,0,1,0,0,0,0,0,0,0,0,0,0,0,0,0
"Oct 2, 2019 5:00 AM",4,3,1,,,,,,,,,,0,0,0,3,,,,0,0,0,9,3,0,0,0,14,2,0,0,0,0,0,0,0
"Oct 2, 2019 6:00 AM",56,42,14,,,,,,,,,,2,1,1,9,,,,7,6,1,27,15,4,3,1,34,1,0,1,1,0,0,0,0
"Oct 2, 2019 7:00 AM",198,157,41,,,,,,,,,,8,0,8,17,,,,34,25,9,149,36,26,19,7,189,2,4,5,4,1,2,0,2
"Oct 2, 2019 8:00 AM",488,403,85,,,,,,,,,,34,7,27,31,,,,57,37,20,334,63,100,80,20,338,8,8,14,11,3,1,0,1
"Oct 2, 2019 9:00 AM",287,261,26,,,,,,,,,,18,8,10,5,,,,29,10,19,174,29,42,29,13,120,3,4,5,2,3,1,0,1
"Oct 2, 2019 10:00 AM",123,98,25,,,,,,,,,,9,1,8,14,,,,19,12,7,50,14,22,8,14,34,1,3,3,1,2,0,0,0
"Oct 2, 2019 11:00 AM",68,45,23,,,,,,,,,,11,6,5,4,,,,16,11,5,36,12,25,11,14,28,4,2,4,1,3,3,2,1
"Oct 2, 2019 12:00 PM",96,46,50,,,,,,,,,,17,12,5,8,,,,29,20,9,19,16,14,7,7,24,2,1,9,6,3,1,1,0
"Oct 2, 2019 1:00 PM",103,49,54,,,,,,,,,,25,17,8,10,,,,37,29,8,34,34,26,9,17,31,5,0,7,2,5,4,4,0
"Oct 2, 2019 2:00 PM",88,32,56,,,,,,,,,,19,11,8,17,,,,43,40,3,24,22,27,9,18,25,3,2,4,2,2,1,0,1
"Oct 2, 2019 3:00 PM",102,27,75,,,,,,,,,,13,9,4,18,,,,34,32,2,29,33,14,1,13,18,7,3,7,4,3,0,0,0
"Oct 2, 2019 4:00 PM",171,34,137,,,,,,,,,,16,14,2,21,,,,80,74,6,28,77,38,9,29,37,8,3,10,4,6,3,3,0
"Oct 2, 2019 5:00 PM",363,72,291,,,,,,,,,,25,19,6,28,,,,167,162,5,52,196,66,8,58,88,10,4,9,3,6,2,1,1
"Oct 2, 2019 6:00 PM",375,70,305,,,,,,,,,,24,14,10,25,,,,245,237,8,53,206,104,11,93,56,6,5,7,4,3,4,3,1
"Oct 2, 2019 7:00 PM",185,40,145,,,,,,,,,,10,7,3,12,,,,116,111,5,23,81,37,7,30,26,4,4,6,4,2,0,0,0
"Oct 2, 2019 8:00 PM",123,33,90,,,,,,,,,,5,4,1,11,,,,57,54,3,17,33,15,3,12,8,1,1,2,0,2,2,2,0
"Oct 2, 2019 9:00 PM",87,18,69,,,,,,,,,,2,2,0,7,,,,44,41,3,5,21,13,4,9,18,2,0,0,0,0,0,0,0
"Oct 2, 2019 10:00 PM",59,6,53,,,,,,,,,,0,0,0,3,,,,20,19,1,6,18,4,0,4,2,0,0,0,0,0,1,0,1
"Oct 2, 2019 11:00 PM",17,3,14,,,,,,,,,,3,2,1,0,,,,12,12,0,3,4,4,3,1,7,0,0,3,1,2,0,0,0
"Oct 3, 2019 12:00 AM",20,5,15,,,,,,,,,,0,0,0,0,,,,7,6,1,2,3,2,1,1,2,2,1,0,0,0,0,0,0
"Oct 3, 2019 1:00 AM",6,2,4,,,,,,,,,,0,0,0,0,,,,1,1,0,1,3,1,0,1,0,0,0,0,0,0,0,0,0
"Oct 3, 2019 2:00 AM",1,0,1,,,,,,,,,,0,0,0,0,,,,1,1,0,0,3,0,0,0,0,0,0,0,0,0,0,0,0
"Oct 3, 2019 3:00 AM",1,1,0,,,,,,,,,,0,0,0,1,,,,1,1,0,0,1,0,0,0,0,0,0,0,0,0,0,0,0
"Oct 3, 2019 4:00 AM",2,1,1,,,,,,,,,,0,0,0,0,,,,2,2,0,2,0,0,0,0,0,0,0,0,0,0,0,0,0
"Oct 3, 2019 5:00 AM",5,5,0,,,,,,,,,,0,0,0,2,,,,2,1,1,9,4,0,0,0,7,1,0,0,0,0,0,0,0
"Oct 3, 2019 6:00 AM",44,31,13,,,,,,,,,,1,0,1,5,,,,6,5,1,21,9,5,4,1,29,1,0,0,0,0,0,0,0
"Oct 3, 2019 7:00 AM",159,129,30,,,,,,,,,,8,2,6,8,,,,12,11,1,88,32,22,18,4,108,1,1,4,3,1,4,0,4
"Oct 3, 2019 8:00 AM",412,347,65,,,,,,,,,,21,5,16,28,,,,41,24,17,207,41,60,51,9,234,7,3,8,6,2,3,0,3
"Oct 3, 2019 9:00 AM",189,164,25,,,,,,,,,,13,7,6,6,,,,21,11,10,84,21,35,20,15,64,1,2,4,1,3,2,0,2
"Oct 3, 2019 10:00 AM",83,62,21,,,,,,,,,,4,2,2,7,,,,15,5,10,52,7,5,3,2,26,1,1,0,0,0,1,1,0
"Oct 3, 2019 11:00 AM",65,43,22,,,,,,,,,,6,3,3,10,,,,10,8,2,16,7,4,1,3,14,0,1,2,1,1,1,0,1
"Oct 3, 2019 12:00 PM",72,34,38,,,,,,,,,,8,5,3,3,,,,17,13,4,14,7,7,1,6,15,1,1,2,2,0,0,0,0
"Oct 3, 2019 1:00 PM",71,30,41,,,,,,,,,,9,5,4,6,,,,21,16,5,10,14,7,1,6,9,2,0,2,1,1,0,0,0
"Oct 3, 2019 2:00 PM",67,22,45,,,,,,,,,,7,3,4,3,,,,24,22,2,11,14,13,3,10,16,1,1,1,0,1,2,2,0
"Oct 3, 2019 3:00 PM",89,23,66,,,,,,,,,,6,4,2,11,,,,28,22,6,15,25,6,2,4,14,0,0,4,2,2,1,1,0
"Oct 3, 2019 4:00 PM",137,29,108,,,,,,,,,,8,4,4,8,,,,49,43,6,10,43,20,5,15,14,1,0,4,1,3,2,1,1
"Oct 3, 2019 5:00 PM",230,37,193,,,,,,,,,,11,10,1,15,,,,106,101,5,24,117,38,6,32,42,2,0,0,0,0,0,0,0
"Oct 3, 2019 6:00 PM",246,53,193,,,,,,,,,,7,3,4,18,,,,124,120,4,11,119,56,11,45,37,3,1,3,2,1,0,0,0
"Oct 3, 2019 7:00 PM",128,21,107,,,,,,,,,,4,1,3,9,,,,80,72,8,7,38,14,1,13,15,2,3,6,4,2,2,1,1
"Oct 3, 2019 8:00 PM",89,16,73,,,,,,,,,,2,2,0,5,,,,36,33,3,13,15,12,0,12,11,0,0,0,0,0,0,0,0
"Oct 3, 2019 9:00 PM",42,3,39,,,,,,,,,,3,2,1,3,,,,18,11,7,10,13,5,1,4,7,1,0,1,1,0,0,0,0
"Oct 3, 2019 10:00 PM",24,6,18,,,,,,,,,,1,1,0,1,,,,21,19,2,1,10,7,2,5,5,1,0,1,1,0,0,0,0
"Oct 3, 2019 11:00 PM",19,3,16,,,,,,,,,,1,1,0,3,,,,11,11,0,5,9,2,1,1,6,0,1,2,1,1,0,0,0
"Oct 4, 2019 12:00 AM",5,1,4,,,,,,,,,,1,0,1,0,,,,3,3,0,1,0,0,0,0,5,0,1,0,0,0,0,0,0
"Oct 4, 2019 1:00 AM",3,0,3,,,,,,,,,,0,0,0,0,,,,1,1,0,0,0,0,0,0,1,0,0,0,0,0,0,0,0
"Oct 4, 2019 2:00 AM",3,1,2,,,,,,,,,,0,0,0,0,,,,2,2,0,0,0,2,1,1,1,0,0,0,0,0,0,0,0
"Oct 4, 2019 3:00 AM",1,0,1,,,,,,,,,,0,0,0,1,,,,0,0,0,0,0,0,0,0,1,0,0,1,0,1,0,0,0
"Oct 4, 2019 4:00 AM",4,3,1,,,,,,,,,,0,0,0,0,,,,1,1,0,1,0,0,0,0,0,0,0,0,0,0,0,0,0
"Oct 4, 2019 5:00 AM",6,5,1,,,,,,,,,,0,0,0,0,,,,0,0,0,5,3,0,0,0,9,3,0,0,0,0,0,0,0
"Oct 4, 2019 6:00 AM",33,26,7,,,,,,,,,,0,0,0,5,,,,5,3,2,13,6,1,1,0,31,2,0,1,0,1,0,0,0
"Oct 4, 2019 7:00 AM",92,72,20,,,,,,,,,,8,5,3,7,,,,16,11,5,63,19,15,10,5,85,3,1,6,6,0,0,0,0
"Oct 4, 2019 8:00 AM",260,219,41,,,,,,,,,,13,7,6,15,,,,36,22,14,154,35,31,29,2,172,4,3,5,5,0,0,0,0
"Oct 4, 2019 9:00 AM",132,114,18,,,,,,,,,,9,3,6,6,,,,16,7,9,59,11,18,13,5,68,0,2,4,3,1,1,0,1
"Oct 4, 2019 10:00 AM",56,40,16,,,,,,,,,,1,0,1,3,,,,12,3,9,34,5,3,2,1,21,0,4,4,1,3,2,1,1
"Oct 4, 2019 11:00 AM",49,35,14,,,,,,,,,,7,7,0,5,,,,11,6,5,20,2,5,1,4,19,1,0,1,1,0,1,1,0
"Oct 4, 2019 12:00 PM",71,40,31,,,,,,,,,,12,11,1,4,,,,16,14,2,21,18,8,2,6,12,3,4,2,2,0,0,0,0
"Oct 4, 2019 1:00 PM",80,35,45,,,,,,,,,,6,2,4,4,,,,20,18,2,19,28,8,3,5,26,1,2,2,2,0,1,0,1
"Oct 4, 2019 2:00 PM",74,30,44,,,,,,,,,,10,8,2,10,,,,16,16,0,18,20,10,1,9,26,3,1,4,3,1,1,1,0
"Oct 4, 2019 3:00 PM",92,25,67,,,,,,,,,,9,7,2,8,,,,40,36,4,17,31,19,8,11,21,4,1,3,2,1,3,3,0
"Oct 4, 2019 4:00 PM",132,33,99,,,,,,,,,,9,9,0,11,,,,38,36,2,23,56,20,6,14,27,7,1,8,5,3,3,3,0
"Oct 4, 2019 5:00 PM",227,41,186,,,,,,,,,,15,10,5,24,,,,103,100,3,31,108,43,4,39,46,6,4,3,1,2,1,1,0
"Oct 4, 2019 6:00 PM",179,46,133,,,,,,,,,,14,12,2,14,,,,109,107,2,14,87,48,4,44,26,4,2,5,3,2,1,1,0
"Oct 4, 2019 7:00 PM",92,27,65,,,,,,,,,,7,7,0,11,,,,61,57,4,20,28,17,6,11,14,2,1,2,1,1,2,1,1
"Oct 4, 2019 8:00 PM",56,15,41,,,,,,,,,,6,4,2,3,,,,24,21,3,7,20,7,2,5,10,0,2,4,1,3,3,3,0
"Oct 4, 2019 9:00 PM",31,9,22,,,,,,,,,,2,2,0,6,,,,12,11,1,10,8,7,0,7,6,0,1,10,6,4,3,1,2
"Oct 4, 2019 10:00 PM",33,5,28,,,,,,,,,,0,0,0,7,,,,16,15,1,4,14,1,0,1,11,3,0,1,1,0,0,0,0
"Oct 4, 2019 11:00 PM",24,5,19,,,,,,,,,,1,0,1,1,,,,8,8,0,4,7,0,0,0,4,0,0,2,0,2,0,0,0
"Oct 5, 2019 12:00 AM",17,3,14,,,,,,,,,,0,0,0,1,,,,6,5,1,0,9,2,1,1,6,1,0,1,0,1,2,2,0
"Oct 5, 2019 1:00 AM",9,1,8,,,,,,,,,,0,0,0,0,,,,5,4,1,0,3,0,0,0,3,0,1,1,1,0,0,0,0
"Oct 5, 2019 2:00 AM",2,1,1,,,,,,,,,,0,0,0,1,,,,5,4,1,0,5,1,1,0,0,0,2,0,0,0,2,2,0
"Oct 5, 2019 3:00 AM",2,2,0,,,,,,,,,,0,0,0,1,,,,1,1,0,1,2,0,0,0,4,0,0,1,0,1,0,0,0
"Oct 5, 2019 4:00 AM",6,1,5,,,,,,,,,,0,0,0,0,,,,0,0,0,0,1,0,0,0,2,0,0,0,0,0,0,0,0
"Oct 5, 2019 5:00 AM",1,1,0,,,,,,,,,,0,0,0,1,,,,2,2,0,1,1,0,0,0,2,1,0,0,0,0,0,0,0
"Oct 5, 2019 6:00 AM",9,6,3,,,,,,,,,,1,1,0,1,,,,4,4,0,2,4,1,1,0,9,0,0,0,0,0,0,0,0
"Oct 5, 2019 7:00 AM",15,8,7,,,,,,,,,,2,2,0,3,,,,4,4,0,8,13,5,4,1,18,0,0,0,0,0,0,0,0
"Oct 5, 2019 8:00 AM",68,31,37,,,,,,,,,,10,9,1,4,,,,6,5,1,18,5,8,3,5,24,0,4,2,1,1,1,0,1
"Oct 5, 2019 9:00 AM",38,27,11,,,,,,,,,,6,6,0,7,,,,7,6,1,15,13,13,5,8,16,2,5,0,0,0,0,0,0
"Oct 5, 2019 10:00 AM",34,19,15,,,,,,,,,,5,4,1,9,,,,13,8,5,18,10,16,5,11,17,5,6,3,2,1,1,1,0
"Oct 5, 2019 11:00 AM",58,30,28,,,,,,,,,,11,11,0,11,,,,8,8,0,18,17,22,11,11,27,4,1,2,0,2,0,0,0
"Oct 5, 2019 12:00 PM",56,38,18,,,,,,,,,,21,19,2,25,,,,15,10,5,18,19,23,9,14,24,2,2,4,0,4,0,0,0
"Oct 5, 2019 1:00 PM",62,25,37,,,,,,,,,,14,14,0,29,,,,16,11,5,10,18,12,4,8,17,4,0,3,2,1,0,0,0
"Oct 5, 2019 2:00 PM",44,23,21,,,,,,,,,,13,13,0,9,,,,16,14,2,11,7,12,4,8,12,3,1,4,2,2,0,0,0
"Oct 5, 2019 3:00 PM",29,14,15,,,,,,,,,,5,5,0,4,,,,8,8,0,14,8,10,6,4,7,0,2,2,1,1,0,0,0
"Oct 5, 2019 4:00 PM",36,14,22,,,,,,,,,,5,5,0,11,,,,11,10,1,8,11,6,3,3,12,0,1,0,0,0,1,1,0
"Oct 5, 2019 5:00 PM",39,13,26,,,,,,,,,,7,6,1,2,,,,17,14,3,5,7,4,0,4,14,1,1,0,0,0,0,0,0
"Oct 5, 2019 6:00 PM",37,15,22,,,,,,,,,,2,1,1,6,,,,10,10,0,4,5,5,1,4,4,3,1,6,6,0,0,0,0
"Oct 5, 2019 7:00 PM",18,5,13,,,,,,,,,,5,3,2,4,,,,3,2,1,4,7,1,1,0,6,2,1,5,3,2,1,1,0
"Oct 5, 2019 8:00 PM",16,7,9,,,,,,,,,,3,2,1,1,,,,7,5,2,3,8,0,0,0,3,0,0,1,0,1,1,1,0
"Oct 5, 2019 9:00 PM",10,3,7,,,,,,,,,,0,0,0,0,,,,1,1,0,4,0,1,0,1,2,0,0,0,0,0,0,0,0
"Oct 5, 2019 10:00 PM",9,4,5,,,,,,,,,,1,1,0,9,,,,5,5,0,3,5,0,0,0,4,0,0,0,0,0,0,0,0
"Oct 5, 2019 11:00 PM",10,2,8,,,,,,,,,,0,0,0,0,,,,6,6,0,4,5,2,0,2,3,0,0,0,0,0,0,0,0
"Oct 6, 2019 12:00 AM",7,3,4,,,,,,,,,,1,1,0,9,,,,1,1,0,1,1,3,2,1,6,0,0,0,0,0,0,0,0
"Oct 6, 2019 1:00 AM",8,0,8,,,,,,,,,,0,0,0,1,,,,2,2,0,0,0,0,0,0,1,0,0,1,0,1,1,1,0
"Oct 6, 2019 2:00 AM",4,0,4,,,,,,,,,,0,0,0,2,,,,1,1,0,0,0,0,0,0,2,0,2,2,1,1,1,1,0
"Oct 6, 2019 3:00 AM",2,1,1,,,,,,,,,,0,0,0,3,,,,2,2,0,1,1,0,0,0,1,0,0,0,0,0,1,1,0
"Oct 6, 2019 4:00 AM",1,0,1,,,,,,,,,,0,0,0,0,,,,0,0,0,1,0,0,0,0,2,0,0,0,0,0,0,0,0
"Oct 6, 2019 5:00 AM",1,0,1,,,,,,,,,,0,0,0,0,,,,1,1,0,0,2,2,0,2,2,0,0,0,0,0,0,0,0
"Oct 6, 2019 6:00 AM",10,3,7,,,,,,,,,,0,0,0,0,,,,0,0,0,2,5,2,1,1,9,2,0,0,0,0,0,0,0
"Oct 6, 2019 7:00 AM",15,12,3,,,,,,,,,,1,1,0,1,,,,10,9,1,4,12,3,0,3,4,1,2,1,0,1,0,0,0
"Oct 6, 2019 8:00 AM",31,17,14,,,,,,,,,,4,4,0,7,,,,8,5,3,8,9,12,6,6,17,2,10,2,1,1,0,0,0
"Oct 6, 2019 9:00 AM",47,32,15,,,,,,,,,,17,17,0,7,,,,9,7,2,15,32,35,10,25,15,2,10,4,2,2,3,2,1
"Oct 6, 2019 10:00 AM",51,32,19,,,,,,,,,,19,17,2,6,,,,8,5,3,18,16,73,53,20,39,4,5,5,1,4,2,2,0
"Oct 6, 2019 11:00 AM",74,41,33,,,,,,,,,,37,34,3,21,,,,18,14,4,22,24,98,16,82,33,10,5,6,2,4,6,3,3
"Oct 6, 2019 12:00 PM",77,46,31,,,,,,,,,,44,37,7,18,,,,21,18,3,32,35,32,15,17,33,4,9,6,5,1,1,0,1
"Oct 6, 2019 1:00 PM",74,34,40,,,,,,,,,,40,36,4,14,,,,27,25,2,23,42,38,12,26,34,5,4,4,3,1,0,0,0
"Oct 6, 2019 2:00 PM",55,22,33,,,,,,,,,,40,36,4,31,,,,16,15,1,13,28,35,22,13,35,2,6,6,0,6,5,5,0
"Oct 6, 2019 3:00 PM",56,28,28,,,,,,,,,,50,46,4,14,,,,17,13,4,14,26,26,8,18,22,6,6,5,3,2,5,3,2
"Oct 6, 2019 4:00 PM",53,27,26,,,,,,,,,,54,45,9,18,,,,18,16,2,29,24,28,14,14,32,4,3,7,5,2,1,0,1
"Oct 6, 2019 5:00 PM",46,15,31,,,,,,,,,,30,24,6,18,,,,21,16,5,26,17,28,14,14,31,4,2,11,6,5,4,1,3
"Oct 6, 2019 6:00 PM",55,13,42,,,,,,,,,,16,14,2,16,,,,18,17,1,19,7,28,14,14,27,2,3,4,3,1,1,1,0
"Oct 6, 2019 7:00 PM",45,17,28,,,,,,,,,,7,6,1,9,,,,16,16,0,5,14,14,7,7,14,0,0,4,3,1,0,0,0
"Oct 6, 2019 8:00 PM",26,10,16,,,,,,,,,,7,3,4,6,,,,10,10,0,8,10,7,4,3,10,1,0,4,1,3,0,0,0
"Oct 6, 2019 9:00 PM",16,9,7,,,,,,,,,,3,3,0,1,,,,5,5,0,3,4,7,3,4,6,2,0,1,1,0,1,1,0
"Oct 6, 2019 10:00 PM",11,2,9,,,,,,,,,,1,1,0,2,,,,4,3,1,2,0,4,1,3,4,0,0,0,0,0,0,0,0
"Oct 6, 2019 11:00 PM",15,3,12,,,,,,,,,,1,1,0,1,,,,1,1,0,2,2,5,4,1,2,0,1,1,1,0,0,0,0
"Oct 7, 2019 12:00 AM",5,1,4,,,,,,,,,,1,0,1,0,,,,2,2,0,0,4,1,1,0,2,0,0,1,0,1,0,0,0
"Oct 7, 2019 1:00 AM",4,1,3,,,,,,,,,,1,0,1,0,,,,2,2,0,0,1,1,0,1,0,0,2,0,0,0,0,0,0
"Oct 7, 2019 2:00 AM",2,0,2,,,,,,,,,,1,1,0,0,,,,1,1,0,0,0,1,0,1,3,0,0,0,0,0,0,0,0
"Oct 7, 2019 3:00 AM",0,0,0,,,,,,,,,,1,1,0,0,,,,1,1,0,0,0,0,0,0,1,1,0,0,0,0,0,0,0
"Oct 7, 2019 4:00 AM",2,1,1,,,,,,,,,,0,0,0,1,,,,0,0,0,1,1,0,0,0,0,0,0,0,0,0,0,0,0
"Oct 7, 2019 5:00 AM",6,6,0,,,,,,,,,,0,0,0,1,,,,1,1,0,4,2,0,0,0,10,2,0,0,0,0,0,0,0
"Oct 7, 2019 6:00 AM",48,38,10,,,,,,,,,,1,0,1,7,,,,8,7,1,21,8,4,2,2,36,0,1,2,1,1,0,0,0
"Oct 7, 2019 7:00 AM",167,140,27,,,,,,,,,,5,1,4,15,,,,17,15,2,102,38,15,10,5,170,1,5,6,5,1,3,0,3
"Oct 7, 2019 8:00 AM",461,381,80,,,,,,,,,,25,4,21,29,,,,50,28,22,312,66,82,68,14,325,6,6,14,13,1,4,0,4
"Oct 7, 2019 9:00 AM",272,245,27,,,,,,,,,,13,3,10,12,,,,37,18,19,156,24,40,26,14,114,1,2,2,2,0,0,0,0
"Oct 7, 2019 10:00 AM",113,101,12,,,,,,,,,,9,3,6,11,,,,15,7,8,59,17,14,7,7,23,1,1,6,4,2,2,2,0
"Oct 7, 2019 11:00 AM",73,44,29,,,,,,,,,,5,2,3,6,,,,10,7,3,27,12,9,5,4,18,2,0,0,0,0,0,0,0
"Oct 7, 2019 12:00 PM",86,43,43,,,,,,,,,,14,7,7,8,,,,23,21,2,22,15,8,4,4,26,3,2,4,2,2,1,0,1
"Oct 7, 2019 1:00 PM",111,52,59,,,,,,,,,,14,9,5,15,,,,25,19,6,21,18,12,5,7,26,3,1,3,2,1,1,1,0
"Oct 7, 2019 2:00 PM",95,43,52,,,,,,,,,,13,7,6,13,,,,31,25,6,12,24,9,0,9,12,1,1,4,3,1,1,0,1
"Oct 7, 2019 3:00 PM",90,23,67,,,,,,,,,,10,4,6,10,,,,48,42,6,25,26,19,9,10,26,3,2,9,4,5,2,2,0
"Oct 7, 2019 4:00 PM",178,40,138,,,,,,,,,,10,9,1,23,,,,79,71,8,26,56,31,8,23,32,4,2,5,1,4,6,6,0
"Oct 7, 2019 5:00 PM",352,66,286,,,,,,,,,,14,10,4,32,,,,170,165,5,47,181,85,8,77,83,4,3,7,5,2,4,2,2
"Oct 7, 2019 6:00 PM",392,68,324,,,,,,,,,,29,15,14,29,,,,191,188,3,29,181,91,7,84,58,10,6,10,5,5,0,0,0
"Oct 7, 2019 7:00 PM",164,31,133,,,,,,,,,,17,12,5,17,,,,119,115,4,17,71,33,3,30,33,4,4,4,1,3,3,2,1
"Oct 7, 2019 8:00 PM",145,22,123,,,,,,,,,,5,2,3,7,,,,55,55,0,12,37,8,1,7,16,1,2,5,1,4,1,1,0
"Oct 7, 2019 9:00 PM",63,11,52,,,,,,,,,,3,1,2,7,,,,27,27,0,15,22,12,3,9,10,2,0,3,1,2,0,0,0
"Oct 7, 2019 10:00 PM",41,5,36,,,,,,,,,,1,0,1,5,,,,22,22,0,2,14,4,2,2,10,1,2,4,2,2,0,0,0
"Oct 7, 2019 11:00 PM",14,3,11,,,,,,,,,,0,0,0,1,,,,6,6,0,4,4,2,2,0,6,0,0,0,0,0,0,0,0
"Oct 8, 2019 12:00 AM",3,0,3,,,,,,,,,,0,0,0,0,,,,4,4,0,1,4,2,1,1,2,0,1,1,0,1,2,2,0
"Oct 8, 2019 1:00 AM",4,0,4,,,,,,,,,,0,0,0,0,,,,3,3,0,0,2,1,0,1,0,0,1,0,0,0,0,0,0
"Oct 8, 2019 2:00 AM",4,2,2,,,,,,,,,,1,1,0,0,,,,1,1,0,0,4,1,0,1,0,0,0,0,0,0,0,0,0
"Oct 8, 2019 3:00 AM",3,3,0,,,,,,,,,,0,0,0,0,,,,1,1,0,0,0,0,0,0,0,0,0,0,0,0,0,0,0
"Oct 8, 2019 4:00 AM",4,1,3,,,,,,,,,,0,0,0,0,,,,0,0,0,1,0,0,0,0,1,1,0,0,0,0,0,0,0
"Oct 8, 2019 5:00 AM",10,7,3,,,,,,,,,,0,0,0,2,,,,2,1,1,8,3,0,0,0,12,2,0,0,0,0,0,0,0
"Oct 8, 2019 6:00 AM",59,46,13,,,,,,,,,,3,0,3,7,,,,14,11,3,31,13,8,5,3,53,2,2,2,2,0,1,0,1
"Oct 8, 2019 7:00 AM",204,160,44,,,,,,,,,,6,4,2,17,,,,28,22,6,135,44,44,31,13,219,1,8,3,2,1,2,0,2
"Oct 8, 2019 8:00 AM",568,469,99,,,,,,,,,,55,14,41,41,,,,67,44,23,371,85,93,73,20,409,13,9,18,16,2,4,0,4
"Oct 8, 2019 9:00 AM",266,231,35,,,,,,,,,,14,7,7,16,,,,42,22,20,167,36,52,30,22,120,6,5,8,7,1,0,0,0
"Oct 8, 2019 10:00 AM",110,92,18,,,,,,,,,,8,3,5,9,,,,15,9,6,74,14,16,4,12,35,0,6,9,3,6,3,0,3
"Oct 8, 2019 11:00 AM",69,42,27,,,,,,,,,,6,5,1,5,,,,21,17,4,36,16,14,5,9,21,1,1,3,1,2,0,0,0
"Oct 8, 2019 12:00 PM",92,54,38,,,,,,,,,,13,6,7,15,,,,24,21,3,35,21,11,6,5,34,4,2,7,7,0,2,0,2
"Oct 8, 2019 1:00 PM",103,46,57,,,,,,,,,,19,12,7,13,,,,23,18,5,32,31,20,9,11,29,0,2,4,4,0,1,0,1
"Oct 8, 2019 2:00 PM",93,38,55,,,,,,,,,,22,15,7,9,,,,35,29,6,28,27,20,6,14,16,2,3,3,2,1,2,2,0
"Oct 8, 2019 3:00 PM",109,22,87,,,,,,,,,,17,8,9,10,,,,50,47,3,25,33,19,7,12,26,8,1,16,7,9,5,4,1
"Oct 8, 2019 4:00 PM",183,45,138,,,,,,,,,,16,10,6,25,,,,89,85,4,25,83,47,15,32,43,3,3,9,4,5,3,2,1
"Oct 8, 2019 5:00 PM",353,69,284,,,,,,,,,,18,10,8,22,,,,194,183,11,55,218,83,10,73,88,7,2,14,11,3,2,1,1
"Oct 8, 2019 6:00 PM",433,91,342,,,,,,,,,,22,18,4,37,,,,228,219,9,56,225,100,18,82,72,8,3,20,12,8,2,1,1
"Oct 8, 2019 7:00 PM",220,35,185,,,,,,,,,,8,6,2,21,,,,129,125,4,25,84,38,2,36,32,3,2,12,3,9,5,5,0
"Oct 8, 2019 8:00 PM",151,25,126,,,,,,,,,,13,9,4,9,,,,89,84,5,12,39,28,3,25,22,2,2,3,0,3,1,0,1
"Oct 8, 2019 9:00 PM",86,10,76,,,,,,,,,,0,0,0,7,,,,42,40,2,11,33,13,1,12,10,1,2,3,1,2,1,1,0
"Oct 8, 2019 10:00 PM",54,6,48,,,,,,,,,,2,2,0,4,,,,31,29,2,3,19,6,2,4,8,1,1,1,1,0,0,0,0
"Oct 8, 2019 11:00 PM",20,3,17,,,,,,,,,,2,1,1,2,,,,17,17,0,3,11,3,1,2,1,0,0,2,1,1,0,0,0
"Oct 9, 2019 12:00 AM",9,2,7,,,,,,,,,,1,1,0,0,,,,4,4,0,0,6,2,2,0,1,1,2,0,0,0,1,1,0
"Oct 9, 2019 1:00 AM",3,0,3,,,,,,,,,,1,1,0,0,,,,5,5,0,1,1,2,1,1,1,0,0,0,0,0,0,0,0
"Oct 9, 2019 2:00 AM",0,0,0,,,,,,,,,,0,0,0,0,,,,0,0,0,0,2,0,0,0,0,0,1,1,1,0,0,0,0
"Oct 9, 2019 3:00 AM",2,1,1,,,,,,,,,,0,0,0,0,,,,1,1,0,1,1,1,0,1,1,0,0,1,0,1,0,0,0
"Oct 9, 2019 4:00 AM",2,2,0,,,,,,,,,,0,0,0,0,,,,1,1,0,0,0,0,0,0,0,0,0,0,0,0,0,0,0
"Oct 9, 2019 5:00 AM",10,8,2,,,,,,,,,,0,0,0,1,,,,1,1,0,6,4,0,0,0,14,2,0,0,0,0,0,0,0
"Oct 9, 2019 6:00 AM",63,48,15,,,,,,,,,,0,0,0,10,,,,9,8,1,36,17,6,3,3,51,2,0,0,0,0,0,0,0
"Oct 9, 2019 7:00 AM",261,215,46,,,,,,,,,,8,2,6,15,,,,27,18,9,141,48,32,24,8,182,1,5,7,5,2,2,0,2
"Oct 9, 2019 8:00 AM",538,456,82,,,,,,,,,,42,11,31,37,,,,54,29,25,348,78,105,82,23,371,7,9,14,12,2,2,0,2
"Oct 9, 2019 9:00 AM",296,263,33,,,,,,,,,,17,4,13,6,,,,37,18,19,175,34,51,30,21,117,3,4,5,1,4,1,0,1
"Oct 9, 2019 10:00 AM",111,81,30,,,,,,,,,,5,2,3,7,,,,23,14,9,75,15,21,9,12,36,2,2,3,1,2,1,1,0
"Oct 9, 2019 11:00 AM",77,58,19,,,,,,,,,,11,6,5,6,,,,12,8,4,29,13,16,6,10,22,1,0,1,1,0,1,1,0
"Oct 9, 2019 12:00 PM",80,40,40,,,,,,,,,,24,12,12,8,,,,33,26,7,29,27,12,3,9,30,3,0,3,3,0,1,0,1
"Oct 9, 2019 1:00 PM",104,40,64,,,,,,,,,,17,8,9,11,,,,43,39,4,26,22,18,9,9,26,1,3,4,1,3,3,2,1
"Oct 9, 2019 2:00 PM",97,40,57,,,,,,,,,,21,14,7,22,,,,45,42,3,27,25,15,5,10,25,2,3,4,2,2,3,3,0
"Oct 9, 2019 3:00 PM",106,32,74,,,,,,,,,,14,9,5,13,,,,41,37,4,34,33,22,8,14,21,5,3,8,7,1,3,0,3
"Oct 9, 2019 4:00 PM",200,55,145,,,,,,,,,,6,4,2,19,,,,75,73,2,24,87,46,11,35,41,4,2,9,5,4,7,7,0
"Oct 9, 2019 5:00 PM",357,65,292,,,,,,,,,,21,13,8,25,,,,167,157,10,42,193,93,13,80,77,6,2,7,4,3,3,2,1
"Oct 9, 2019 6:00 PM",387,63,324,,,,,,,,,,14,9,5,24,,,,233,227,6,34,190,81,9,72,65,4,2,5,3,2,1,1,0
"Oct 9, 2019 7:00 PM",212,52,160,,,,,,,,,,6,3,3,11,,,,126,116,10,18,84,40,4,36,27,2,1,1,1,0,1,1,0
"Oct 9, 2019 8:00 PM",135,23,112,,,,,,,,,,8,5,3,12,,,,65,61,4,25,44,10,2,8,18,2,2,3,0,3,2,2,0
"Oct 9, 2019 9:00 PM",91,12,79,,,,,,,,,,5,4,1,6,,,,35,33,2,11,27,16,2,14,24,1,1,2,1,1,0,0,0
"Oct 9, 2019 10:00 PM",64,10,54,,,,,,,,,,5,4,1,4,,,,29,29,0,4,22,4,1,3,10,0,0,0,0,0,1,0,1
"Oct 9, 2019 11:00 PM",27,6,21,,,,,,,,,,3,2,1,2,,,,18,18,0,5,15,4,1,3,0,0,0,0,0,0,0,0,0
"Oct 10, 2019 12:00 AM",11,1,10,,,,,,,,,,1,1,0,1,,,,7,7,0,4,6,0,0,0,5,0,0,0,0,0,0,0,0
"Oct 10, 2019 1:00 AM",4,0,4,,,,,,,,,,0,0,0,1,,,,1,1,0,0,1,0,0,0,3,1,0,0,0,0,0,0,0
"Oct 10, 2019 2:00 AM",0,0,0,,,,,,,,,,0,0,0,0,,,,0,0,0,0,2,0,0,0,0,0,0,0,0,0,0,0,0
"Oct 10, 2019 3:00 AM",3,1,2,,,,,,,,,,0,0,0,0,,,,1,1,0,0,1,0,0,0,1,0,0,0,0,0,0,0,0
"Oct 10, 2019 4:00 AM",3,2,1,,,,,,,,,,0,0,0,0,,,,1,1,0,1,0,1,0,1,2,1,0,0,0,0,0,0,0
"Oct 10, 2019 5:00 AM",6,6,0,,,,,,,,,,0,0,0,1,,,,1,1,0,6,2,0,0,0,11,2,0,0,0,0,0,0,0
"Oct 10, 2019 6:00 AM",52,39,13,,,,,,,,,,2,1,1,8,,,,8,6,2,31,14,5,3,2,43,1,1,3,2,1,0,0,0
"Oct 10, 2019 7:00 AM",193,147,46,,,,,,,,,,3,2,1,16,,,,24,18,6,138,39,42,35,7,162,2,7,6,5,1,3,0,3
"Oct 10, 2019 8:00 AM",507,430,77,,,,,,,,,,29,8,21,33,,,,59,36,23,286,77,105,81,24,350,6,10,20,17,3,5,0,5
"Oct 10, 2019 9:00 AM",266,236,30,,,,,,,,,,19,8,11,13,,,,31,15,16,141,40,47,31,16,107,4,3,7,4,3,3,1,2
"Oct 10, 2019 10:00 AM",115,94,21,,,,,,,,,,8,3,5,8,,,,20,11,9,65,19,7,4,3,29,1,6,4,1,3,1,1,0
"Oct 10, 2019 11:00 AM",68,47,21,,,,,,,,,,4,1,3,4,,,,18,14,4,28,13,9,3,6,31,2,2,4,2,2,0,0,0
"Oct 10, 2019 12:00 PM",85,42,43,,,,,,,,,,11,5,6,6,,,,25,19,6,28,12,14,7,7,18,2,1,5,4,1,0,0,0
"Oct 10, 2019 1:00 PM",108,41,67,,,,,,,,,,11,6,5,9,,,,24,19,5,27,20,14,3,11,23,3,0,5,2,3,1,1,0
"Oct 10, 2019 2:00 PM",85,30,55,,,,,,,,,,19,13,6,9,,,,30,27,3,20,16,13,4,9,26,5,2,4,4,0,2,1,1
"Oct 10, 2019 3:00 PM",104,31,73,,,,,,,,,,17,9,8,8,,,,50,46,4,18,32,23,3,20,24,4,1,7,4,3,4,4,0
"Oct 10, 2019 4:00 PM",174,36,138,,,,,,,,,,18,10,8,10,,,,89,84,5,24,71,30,8,22,34,8,1,10,2,8,5,3,2
"Oct 10, 2019 5:00 PM",334,55,279,,,,,,,,,,17,13,4,20,,,,168,163,5,39,192,84,16,68,79,6,5,7,6,1,3,2,1
"Oct 10, 2019 6:00 PM",347,64,283,,,,,,,,,,17,14,3,28,,,,176,168,8,40,148,72,7,65,48,12,2,8,5,3,5,3,2
"Oct 10, 2019 7:00 PM",165,23,142,,,,,,,,,,3,1,2,5,,,,108,105,3,18,69,27,2,25,30,3,0,7,1,6,3,3,0
"Oct 10, 2019 8:00 PM",108,18,90,,,,,,,,,,7,4,3,8,,,,56,56,0,9,33,11,1,10,18,4,2,2,2,0,0,0,0
"Oct 10, 2019 9:00 PM",70,12,58,,,,,,,,,,1,1,0,4,,,,33,32,1,5,29,9,0,9,13,0,0,3,1,2,0,0,0
"Oct 10, 2019 10:00 PM",55,10,45,,,,,,,,,,1,1,0,1,,,,27,26,1,5,19,5,0,5,9,1,1,1,0,1,0,0,0
"Oct 10, 2019 11:00 PM",22,3,19,,,,,,,,,,1,1,0,2,,,,16,14,2,3,12,6,2,4,6,0,1,2,1,1,0,0,0
"Oct 11, 2019 12:00 AM",13,0,13,,,,,,,,,,0,0,0,2,,,,8,8,0,4,13,2,0,2,4,0,1,0,0,0,0,0,0
"Oct 11, 2019 1:00 AM",3,1,2,,,,,,,,,,0,0,0,1,,,,3,2,1,1,4,1,1,0,0,0,0,0,0,0,0,0,0
"Oct 11, 2019 2:00 AM",2,1,1,,,,,,,,,,0,0,0,0,,,,0,0,0,0,4,0,0,0,0,0,0,0,0,0,0,0,0
"Oct 11, 2019 3:00 AM",3,0,3,,,,,,,,,,0,0,0,0,,,,0,0,0,0,2,0,0,0,0,0,0,0,0,0,0,0,0
"Oct 11, 2019 4:00 AM",4,3,1,,,,,,,,,,0,0,0,0,,,,2,1,1,1,0,0,0,0,0,1,0,0,0,0,0,0,0
"Oct 11, 2019 5:00 AM",5,5,0,,,,,,,,,,0,0,0,0,,,,3,3,0,10,5,0,0,0,11,3,0,1,0,1,0,0,0
"Oct 11, 2019 6:00 AM",40,29,11,,,,,,,,,,2,1,1,4,,,,9,7,2,28,14,4,2,2,40,1,0,1,1,0,1,0,1
"Oct 11, 2019 7:00 AM",157,119,38,,,,,,,,,,7,5,2,10,,,,21,19,2,90,34,24,18,6,139,3,1,9,8,1,3,0,3
"Oct 11, 2019 8:00 AM",394,330,64,,,,,,,,,,40,8,32,28,,,,52,33,19,243,65,72,57,15,271,9,8,14,10,4,4,1,3
"Oct 11, 2019 9:00 AM",231,200,31,,,,,,,,,,13,5,8,10,,,,40,17,23,107,17,34,19,15,115,3,2,5,1,4,0,0,0
"Oct 11, 2019 10:00 AM",78,58,20,,,,,,,,,,9,5,4,8,,,,16,6,10,51,14,24,11,13,27,2,3,6,3,3,0,0,0
"Oct 11, 2019 11:00 AM",85,50,35,,,,,,,,,,14,6,8,5,,,,18,13,5,34,14,7,1,6,20,0,2,3,1,2,1,0,1
"Oct 11, 2019 12:00 PM",95,45,50,,,,,,,,,,13,9,4,6,,,,26,22,4,23,18,22,11,11,31,4,4,8,4,4,0,0,0
"Oct 11, 2019 1:00 PM",117,41,76,,,,,,,,,,20,14,6,10,,,,34,26,8,22,27,23,7,16,29,6,3,8,5,3,0,0,0
"Oct 11, 2019 2:00 PM",106,42,64,,,,,,,,,,14,12,2,3,,,,38,35,3,16,37,20,5,15,15,3,1,4,2,2,0,0,0
"Oct 11, 2019 3:00 PM",113,32,81,,,,,,,,,,20,10,10,10,,,,57,52,5,24,38,23,7,16,35,8,3,9,5,4,5,4,1
"Oct 11, 2019 4:00 PM",172,38,134,,,,,,,,,,17,16,1,10,,,,85,83,2,21,83,36,5,31,43,4,3,9,6,3,4,1,3
"Oct 11, 2019 5:00 PM",305,54,251,,,,,,,,,,23,21,2,22,,,,125,120,5,42,154,68,10,58,57,5,3,1,1,0,0,0,0
"Oct 11, 2019 6:00 PM",236,49,187,,,,,,,,,,17,5,12,28,,,,135,133,2,27,119,57,4,53,34,3,3,4,1,3,0,0,0
"Oct 11, 2019 7:00 PM",121,31,90,,,,,,,,,,6,5,1,4,,,,61,53,8,18,47,22,10,12,16,2,0,6,0,6,1,1,0
"Oct 11, 2019 8:00 PM",74,20,54,,,,,,,,,,5,4,1,8,,,,33,33,0,9,27,7,2,5,11,0,0,1,0,1,1,1,0
"Oct 11, 2019 9:00 PM",55,9,46,,,,,,,,,,10,6,4,4,,,,16,16,0,7,21,7,2,5,11,1,1,3,2,1,0,0,0
"Oct 11, 2019 10:00 PM",45,7,38,,,,,,,,,,1,1,0,3,,,,17,16,1,1,13,2,0,2,12,3,0,2,1,1,1,0,1
"Oct 11, 2019 11:00 PM",28,5,23,,,,,,,,,,6,1,5,0,,,,10,10,0,5,19,5,3,2,6,0,0,1,0,1,0,0,0
"Oct 12, 2019 12:00 AM",11,4,7,,,,,,,,,,3,2,1,1,,,,6,6,0,2,7,2,1,1,6,1,1,0,0,0,0,0,0
"Oct 12, 2019 1:00 AM",7,0,7,,,,,,,,,,0,0,0,2,,,,3,3,0,2,7,3,2,1,4,0,0,0,0,0,0,0,0
"Oct 12, 2019 2:00 AM",1,0,1,,,,,,,,,,0,0,0,0,,,,2,2,0,2,3,0,0,0,1,0,2,0,0,0,0,0,0
"Oct 12, 2019 3:00 AM",2,1,1,,,,,,,,,,0,0,0,0,,,,2,1,1,1,0,0,0,0,2,0,0,0,0,0,0,0,0
"Oct 12, 2019 4:00 AM",4,1,3,,,,,,,,,,0,0,0,0,,,,2,2,0,2,2,2,0,2,1,0,0,0,0,0,0,0,0
"Oct 12, 2019 5:00 AM",1,0,1,,,,,,,,,,0,0,0,0,,,,2,2,0,1,2,0,0,0,4,0,0,0,0,0,0,0,0
"Oct 12, 2019 6:00 AM",13,9,4,,,,,,,,,,3,1,2,1,,,,2,2,0,7,6,0,0,0,6,1,0,0,0,0,0,0,0
"Oct 12, 2019 7:00 AM",18,9,9,,,,,,,,,,4,2,2,6,,,,6,6,0,5,15,3,0,3,16,0,3,0,0,0,0,0,0
"Oct 12, 2019 8:00 AM",53,31,22,,,,,,,,,,9,5,4,6,,,,8,8,0,24,13,12,7,5,25,1,0,1,1,0,0,0,0
"Oct 12, 2019 9:00 AM",60,42,18,,,,,,,,,,12,2,10,14,,,,15,12,3,24,21,24,10,14,39,3,5,2,0,2,0,0,0
"Oct 12, 2019 10:00 AM",63,41,22,,,,,,,,,,23,12,11,9,,,,19,17,2,21,26,33,12,21,23,7,10,8,7,1,2,0,2
"Oct 12, 2019 11:00 AM",63,33,30,,,,,,,,,,26,17,9,16,,,,19,19,0,26,24,23,13,10,22,2,8,6,5,1,1,0,1
"Oct 12, 2019 12:00 PM",47,25,22,,,,,,,,,,29,16,13,14,,,,11,8,3,14,15,33,15,18,28,2,2,2,1,1,0,0,0
"Oct 12, 2019 1:00 PM",59,37,22,,,,,,,,,,27,20,7,13,,,,15,12,3,20,18,28,10,18,22,4,4,8,5,3,4,1,3
"Oct 12, 2019 2:00 PM",53,30,23,,,,,,,,,,34,19,15,22,,,,25,20,5,16,27,66,24,42,24,5,1,6,2,4,4,3,1
"Oct 12, 2019 3:00 PM",58,34,24,,,,,,,,,,25,14,11,8,,,,19,17,2,15,33,31,20,11,41,3,2,3,3,0,0,0,0
"Oct 12, 2019 4:00 PM",66,28,38,,,,,,,,,,51,26,25,25,,,,19,18,1,16,16,30,16,14,22,8,4,6,3,3,3,3,0
"Oct 12, 2019 5:00 PM",78,22,56,,,,,,,,,,22,14,8,27,,,,21,19,2,21,30,35,21,14,31,3,3,5,4,1,0,0,0
"Oct 12, 2019 6:00 PM",42,12,30,,,,,,,,,,28,18,10,4,,,,21,19,2,11,13,16,5,11,25,3,1,2,1,1,0,0,0
"Oct 12, 2019 7:00 PM",33,14,19,,,,,,,,,,10,7,3,17,,,,12,12,0,8,10,9,6,3,9,2,0,2,2,0,0,0,0
"Oct 12, 2019 8:00 PM",27,12,15,,,,,,,,,,8,5,3,6,,,,8,8,0,7,8,7,4,3,4,0,0,0,0,0,0,0,0
"Oct 12, 2019 9:00 PM",10,5,5,,,,,,,,,,3,1,2,1,,,,7,6,1,5,4,2,2,0,7,0,0,1,0,1,0,0,0
"Oct 12, 2019 10:00 PM",18,7,11,,,,,,,,,,0,0,0,1,,,,4,4,0,0,5,2,1,1,10,1,0,0,0,0,0,0,0
"Oct 12, 2019 11:00 PM",13,5,8,,,,,,,,,,4,3,1,5,,,,6,4,2,5,7,5,3,2,5,0,0,0,0,0,1,1,0
"Oct 13, 2019 12:00 AM",15,6,9,,,,,,,,,,0,0,0,2,,,,5,4,1,2,0,1,0,1,2,0,1,0,0,0,0,0,0
"Oct 13, 2019 1:00 AM",4,0,4,,,,,,,,,,1,1,0,0,,,,2,2,0,1,4,0,0,0,3,0,2,0,0,0,0,0,0
"Oct 13, 2019 2:00 AM",2,0,2,,,,,,,,,,0,0,0,2,,,,3,3,0,0,2,4,4,0,0,0,1,1,1,0,0,0,0
"Oct 13, 2019 3:00 AM",4,2,2,,,,,,,,,,0,0,0,0,,,,0,0,0,1,2,1,0,1,3,0,1,0,0,0,0,0,0
"Oct 13, 2019 4:00 AM",2,0,2,,,,,,,,,,0,0,0,0,,,,1,1,0,1,0,0,0,0,0,0,0,0,0,0,0,0,0
"Oct 13, 2019 5:00 AM",0,0,0,,,,,,,,,,0,0,0,0,,,,0,0,0,0,1,0,0,0,3,0,0,0,0,0,0,0,0
"Oct 13, 2019 6:00 AM",8,5,3,,,,,,,,,,0,0,0,0,,,,2,2,0,0,4,1,0,1,8,0,0,0,0,0,0,0,0
"Oct 13, 2019 7:00 AM",12,5,7,,,,,,,,,,2,1,1,3,,,,4,3,1,2,10,2,1,1,11,0,0,0,0,0,0,0,0
"Oct 13, 2019 8:00 AM",11,6,5,,,,,,,,,,3,2,1,2,,,,2,2,0,5,5,0,0,0,9,1,1,2,2,0,0,0,0
"Oct 13, 2019 9:00 AM",12,8,4,,,,,,,,,,1,0,1,0,,,,2,2,0,10,6,0,0,0,4,1,3,0,0,0,0,0,0
"Oct 13, 2019 10:00 AM",12,6,6,,,,,,,,,,0,0,0,6,,,,1,1,0,7,6,0,0,0,4,0,0,0,0,0,0,0,0
"Oct 13, 2019 11:00 AM",25,19,6,,,,,,,,,,3,3,0,2,,,,4,2,2,2,5,2,0,2,8,0,1,0,0,0,0,0,0
"Oct 13, 2019 12:00 PM",28,15,13,,,,,,,,,,6,5,1,6,,,,3,1,2,7,13,7,2,5,6,0,0,2,0,2,0,0,0
"Oct 13, 2019 1:00 PM",31,16,15,,,,,,,,,,24,10,14,8,,,,7,5,2,10,13,3,1,2,11,0,1,2,0,2,0,0,0
"Oct 13, 2019 2:00 PM",61,31,30,,,,,,,,,,22,12,10,13,,,,17,12,5,13,13,17,6,11,18,0,5,8,6,2,2,0,2
"Oct 13, 2019 3:00 PM",39,20,19,,,,,,,,,,26,6,20,25,,,,14,12,2,15,19,22,6,16,21,5,5,5,3,2,0,0,0
"Oct 13, 2019 4:00 PM",46,26,20,,,,,,,,,,58,28,30,21,,,,17,15,2,10,21,19,8,11,18,3,2,1,1,0,0,0,0
"Oct 13, 2019 5:00 PM",48,13,35,,,,,,,,,,21,13,8,40,,,,15,15,0,11,14,20,13,7,19,3,1,5,3,2,2,2,0
"Oct 13, 2019 6:00 PM",48,14,34,,,,,,,,,,10,6,4,277,,,,18,16,2,19,12,10,4,6,4,4,3,2,2,0,0,0,0
"Oct 13, 2019 7:00 PM",41,15,26,,,,,,,,,,9,4,5,3,,,,14,11,3,7,5,3,1,2,18,1,0,3,1,2,0,0,0
"Oct 13, 2019 8:00 PM",25,5,20,,,,,,,,,,2,1,1,0,,,,10,8,2,3,5,6,3,3,7,1,2,2,1,1,1,0,1
"Oct 13, 2019 9:00 PM",17,4,13,,,,,,,,,,3,1,2,2,,,,9,8,1,6,2,1,0,1,7,0,0,1,0,1,0,0,0
"Oct 13, 2019 10:00 PM",13,3,10,,,,,,,,,,0,0,0,4,,,,3,3,0,4,2,0,0,0,7,0,0,1,1,0,0,0,0
"Oct 13, 2019 11:00 PM",11,3,8,,,,,,,,,,2,2,0,2,,,,3,3,0,3,5,0,0,0,3,0,2,1,1,0,0,0,0
"Oct 14, 2019 12:00 AM",1,1,0,,,,,,,,,,1,1,0,3,,,,5,4,1,1,4,0,0,0,2,0,0,1,0,1,0,0,0
"Oct 14, 2019 1:00 AM",3,0,3,,,,,,,,,,0,0,0,0,,,,0,0,0,0,2,0,0,0,0,0,0,0,0,0,0,0,0
"Oct 14, 2019 2:00 AM",1,0,1,,,,,,,,,,0,0,0,0,,,,0,0,0,0,0,1,1,0,0,0,0,2,1,1,1,0,1
"Oct 14, 2019 3:00 AM",0,0,0,,,,,,,,,,0,0,0,1,,,,0,0,0,0,0,0,0,0,0,0,0,0,0,0,0,0,0
"Oct 14, 2019 4:00 AM",1,0,1,,,,,,,,,,0,0,0,1,,,,0,0,0,1,0,0,0,0,3,0,0,0,0,0,0,0,0
"Oct 14, 2019 5:00 AM",8,6,2,,,,,,,,,,0,0,0,0,,,,1,1,0,9,4,2,0,2,9,3,0,0,0,0,0,0,0
"Oct 14, 2019 6:00 AM",49,40,9,,,,,,,,,,1,1,0,3,,,,8,5,3,33,7,10,6,4,36,0,0,0,0,0,0,0,0
"Oct 14, 2019 7:00 AM",140,103,37,,,,,,,,,,5,0,5,13,,,,25,18,7,83,31,22,14,8,139,2,4,7,4,3,2,0,2
"Oct 14, 2019 8:00 AM",334,282,52,,,,,,,,,,15,4,11,25,,,,44,25,19,216,55,56,49,7,232,7,6,13,12,1,2,1,1
"Oct 14, 2019 9:00 AM",170,153,17,,,,,,,,,,11,4,7,11,,,,26,17,9,79,15,21,13,8,92,2,3,1,0,1,0,0,0
"Oct 14, 2019 10:00 AM",92,78,14,,,,,,,,,,1,0,1,4,,,,13,4,9,54,9,3,2,1,22,0,0,1,1,0,0,0,0
"Oct 14, 2019 11:00 AM",53,44,9,,,,,,,,,,2,1,1,8,,,,12,8,4,27,7,2,0,2,10,0,1,5,2,3,0,0,0
"Oct 14, 2019 12:00 PM",72,40,32,,,,,,,,,,13,7,6,7,,,,9,9,0,31,12,7,4,3,16,1,0,2,2,0,1,1,0
"Oct 14, 2019 1:00 PM",83,46,37,,,,,,,,,,10,7,3,6,,,,21,15,6,21,15,10,3,7,20,1,1,3,1,2,1,1,0
"Oct 14, 2019 2:00 PM",72,36,36,,,,,,,,,,12,5,7,4,,,,20,19,1,14,22,13,4,9,17,1,1,4,3,1,1,0,1
"Oct 14, 2019 3:00 PM",87,29,58,,,,,,,,,,4,0,4,10,,,,37,33,4,16,23,4,0,4,19,3,2,6,3,3,2,2,0
"Oct 14, 2019 4:00 PM",139,32,107,,,,,,,,,,10,8,2,4,,,,49,44,5,16,52,19,9,10,25,7,2,11,2,9,6,6,0
"Oct 14, 2019 5:00 PM",283,53,230,,,,,,,,,,16,11,5,36,,,,122,120,2,37,125,59,5,54,45,4,2,10,3,7,0,0,0
"Oct 14, 2019 6:00 PM",295,55,240,,,,,,,,,,16,11,5,22,,,,178,173,5,33,153,72,8,64,34,6,3,2,2,0,3,0,3
"Oct 14, 2019 7:00 PM",172,34,138,,,,,,,,,,9,5,4,16,,,,90,83,7,16,72,20,5,15,13,4,5,3,1,2,1,1,0
"Oct 14, 2019 8:00 PM",121,10,111,,,,,,,,,,6,4,2,7,,,,52,49,3,10,24,5,1,4,17,3,1,7,5,2,2,1,1
"Oct 14, 2019 9:00 PM",91,17,74,,,,,,,,,,2,0,2,3,,,,30,28,2,7,14,9,1,8,11,3,1,2,2,0,0,0,0
"Oct 14, 2019 10:00 PM",39,6,33,,,,,,,,,,2,2,0,1,,,,26,21,5,5,7,5,1,4,6,0,0,2,0,2,1,1,0
"Oct 14, 2019 11:00 PM",18,4,14,,,,,,,,,,1,1,0,0,,,,9,8,1,3,7,1,0,1,3,0,0,1,0,1,0,0,0
"Oct 15, 2019 12:00 AM",6,2,4,,,,,,,,,,0,0,0,0,,,,1,1,0,1,2,1,0,1,5,0,1,1,0,1,1,0,1
"Oct 15, 2019 1:00 AM",0,0,0,,,,,,,,,,0,0,0,0,,,,0,0,0,0,0,0,0,0,0,0,0,0,0,0,0,0,0
"Oct 15, 2019 2:00 AM",1,0,1,,,,,,,,,,0,0,0,0,,,,1,1,0,0,1,1,0,1,0,0,0,0,0,0,0,0,0
"Oct 15, 2019 3:00 AM",2,1,1,,,,,,,,,,0,0,0,0,,,,0,0,0,0,0,1,0,1,1,0,0,0,0,0,0,0,0
"Oct 15, 2019 4:00 AM",2,1,1,,,,,,,,,,0,0,0,2,,,,0,0,0,2,0,0,0,0,1,0,0,0,0,0,0,0,0
"Oct 15, 2019 5:00 AM",8,8,0,,,,,,,,,,1,0,1,2,,,,4,2,2,9,3,0,0,0,11,2,0,0,0,0,0,0,0
"Oct 15, 2019 6:00 AM",46,36,10,,,,,,,,,,2,1,1,4,,,,9,6,3,20,13,10,6,4,44,1,2,1,1,0,0,0,0
"Oct 15, 2019 7:00 AM",212,164,48,,,,,,,,,,13,3,10,17,,,,36,26,10,158,47,32,26,6,197,7,7,6,6,0,2,0,2
"Oct 15, 2019 8:00 AM",512,421,91,,,,,,,,,,43,9,34,45,,,,67,40,27,348,80,112,90,22,388,11,12,18,14,4,4,0,4
"Oct 15, 2019 9:00 AM",280,246,34,,,,,,,,,,15,8,7,9,,,,30,15,15,198,27,53,32,21,125,4,6,8,5,3,3,1,2
"Oct 15, 2019 10:00 AM",109,91,18,,,,,,,,,,9,3,6,12,,,,19,15,4,59,21,19,7,12,40,2,5,5,3,2,3,2,1
"Oct 15, 2019 11:00 AM",82,56,26,,,,,,,,,,7,3,4,6,,,,23,15,8,39,20,18,7,11,28,3,1,3,3,0,2,2,0
"Oct 15, 2019 12:00 PM",98,53,45,,,,,,,,,,27,16,11,15,,,,22,17,5,24,14,19,8,11,31,2,3,8,3,5,3,2,1
"Oct 15, 2019 1:00 PM",110,55,55,,,,,,,,,,14,7,7,6,,,,34,28,6,29,24,20,12,8,24,3,5,4,1,3,0,0,0
"Oct 15, 2019 2:00 PM",82,35,47,,,,,,,,,,16,11,5,6,,,,33,28,5,19,25,17,6,11,22,1,1,2,0,2,3,2,1
"Oct 15, 2019 3:00 PM",110,25,85,,,,,,,,,,24,11,13,18,,,,62,57,5,23,32,18,3,15,26,6,0,8,6,2,0,0,0
"Oct 15, 2019 4:00 PM",192,44,148,,,,,,,,,,12,10,2,13,,,,109,107,2,31,77,42,8,34,48,7,2,9,5,4,3,3,0
"Oct 15, 2019 5:00 PM",350,76,274,,,,,,,,,,22,19,3,14,,,,232,224,8,49,188,94,14,80,84,7,4,4,4,0,2,0,2
"Oct 15, 2019 6:00 PM",398,81,317,,,,,,,,,,16,11,5,29,,,,193,186,7,52,212,94,11,83,60,9,0,15,9,6,3,1,2
"Oct 15, 2019 7:00 PM",190,28,162,,,,,,,,,,8,6,2,5,,,,108,105,3,19,70,31,4,27,28,2,0,11,2,9,1,1,0
"Oct 15, 2019 8:00 PM",127,18,109,,,,,,,,,,9,3,6,9,,,,64,61,3,15,57,15,2,13,22,0,2,4,0,4,1,1,0
"Oct 15, 2019 9:00 PM",83,9,74,,,,,,,,,,2,1,1,6,,,,40,39,1,10,32,12,0,12,14,1,0,1,1,0,0,0,0
"Oct 15, 2019 10:00 PM",48,3,45,,,,,,,,,,1,1,0,5,,,,21,19,2,2,21,7,4,3,8,1,0,0,0,0,1,1,0
"Oct 15, 2019 11:00 PM",19,2,17,,,,,,,,,,3,2,1,1,,,,8,8,0,5,11,2,0,2,3,0,0,0,0,0,0,0,0
"Oct 16, 2019 12:00 AM",6,3,3,,,,,,,,,,0,0,0,1,,,,3,1,2,2,2,0,0,0,0,1,1,0,0,0,1,1,0
"Oct 16, 2019 1:00 AM",1,0,1,,,,,,,,,,0,0,0,0,,,,1,1,0,0,4,0,0,0,0,0,1,0,0,0,0,0,0
"Oct 16, 2019 2:00 AM",1,1,0,,,,,,,,,,0,0,0,0,,,,0,0,0,0,3,0,0,0,0,0,0,0,0,0,0,0,0
"Oct 16, 2019 3:00 AM",0,0,0,,,,,,,,,,0,0,0,0,,,,0,0,0,0,1,0,0,0,3,0,0,0,0,0,0,0,0
"Oct 16, 2019 4:00 AM",3,2,1,,,,,,,,,,0,0,0,1,,,,1,1,0,1,1,0,0,0,0,0,0,0,0,0,0,0,0
"Oct 16, 2019 5:00 AM",5,4,1,,,,,,,,,,0,0,0,1,,,,1,1,0,10,2,0,0,0,10,2,0,0,0,0,0,0,0
"Oct 16, 2019 6:00 AM",52,39,13,,,,,,,,,,1,1,0,5,,,,9,8,1,27,15,7,3,4,43,1,2,2,1,1,1,1,0
"Oct 16, 2019 7:00 AM",206,162,44,,,,,,,,,,10,4,6,11,,,,40,31,9,162,46,34,25,9,200,2,6,10,7,3,2,0,2
"Oct 16, 2019 8:00 AM",482,397,85,,,,,,,,,,42,9,33,34,,,,62,34,28,321,75,105,83,22,334,10,4,9,7,2,3,1,2
"Oct 16, 2019 9:00 AM",262,229,33,,,,,,,,,,21,6,15,20,,,,37,21,16,166,36,47,31,16,126,3,4,5,3,2,3,0,3
"Oct 16, 2019 10:00 AM",120,102,18,,,,,,,,,,9,6,3,9,,,,33,18,15,65,14,27,10,17,43,3,1,5,3,2,1,1,0
"Oct 16, 2019 11:00 AM",90,59,31,,,,,,,,,,9,5,4,9,,,,26,11,15,50,17,13,5,8,33,0,0,4,2,2,2,1,1
"Oct 16, 2019 12:00 PM",84,42,42,,,,,,,,,,20,11,9,6,,,,23,16,7,37,24,20,5,15,26,3,2,3,1,2,0,0,0
"Oct 16, 2019 1:00 PM",111,47,64,,,,,,,,,,16,8,8,11,,,,38,32,6,26,36,32,14,18,22,2,0,9,4,5,2,1,1
"Oct 16, 2019 2:00 PM",89,35,54,,,,,,,,,,15,10,5,6,,,,37,34,3,28,23,23,7,16,32,1,2,7,3,4,4,2,2
"Oct 16, 2019 3:00 PM",109,31,78,,,,,,,,,,15,6,9,17,,,,52,49,3,31,37,30,9,21,20,4,2,4,3,1,0,0,0
"Oct 16, 2019 4:00 PM",200,45,155,,,,,,,,,,19,10,9,26,,,,93,91,2,29,88,47,16,31,46,2,3,1,0,1,1,0,1
"Oct 16, 2019 5:00 PM",411,85,326,,,,,,,,,,25,21,4,14,,,,208,199,9,42,201,105,17,88,95,5,2,6,3,3,2,2,0
"Oct 16, 2019 6:00 PM",346,67,279,,,,,,,,,,19,12,7,19,,,,222,215,7,57,214,93,14,79,55,6,7,6,1,5,0,0,0
"Oct 16, 2019 7:00 PM",214,45,169,,,,,,,,,,14,8,6,10,,,,105,99,6,30,66,32,2,30,40,4,3,5,3,2,1,0,1
"Oct 16, 2019 8:00 PM",148,27,121,,,,,,,,,,5,4,1,13,,,,78,75,3,15,46,17,4,13,22,2,2,3,0,3,0,0,0
"Oct 16, 2019 9:00 PM",100,20,80,,,,,,,,,,5,5,0,7,,,,39,36,3,9,31,11,1,10,20,3,1,0,0,0,0,0,0
"Oct 16, 2019 10:00 PM",60,9,51,,,,,,,,,,3,3,0,2,,,,37,35,2,4,18,3,0,3,11,0,1,1,1,0,0,0,0
"Oct 16, 2019 11:00 PM",27,5,22,,,,,,,,,,0,0,0,2,,,,22,21,1,5,11,7,4,3,5,2,0,2,1,1,0,0,0
"Oct 17, 2019 12:00 AM",10,4,6,,,,,,,,,,0,0,0,0,,,,7,7,0,1,5,0,0,0,5,1,0,0,0,0,0,0,0
"Oct 17, 2019 1:00 AM",7,3,4,,,,,,,,,,0,0,0,0,,,,2,2,0,0,1,3,1,2,1,0,0,0,0,0,0,0,0
"Oct 17, 2019 2:00 AM",1,0,1,,,,,,,,,,0,0,0,1,,,,2,2,0,0,1,0,0,0,0,0,0,0,0,0,0,0,0
"Oct 17, 2019 3:00 AM",1,1,0,,,,,,,,,,0,0,0,0,,,,1,1,0,0,1,0,0,0,0,0,0,0,0,0,0,0,0
"Oct 17, 2019 4:00 AM",3,1,2,,,,,,,,,,1,1,0,1,,,,0,0,0,0,0,1,0,1,4,0,0,0,0,0,0,0,0
"Oct 17, 2019 5:00 AM",6,6,0,,,,,,,,,,0,0,0,1,,,,2,2,0,11,3,0,0,0,13,2,1,0,0,0,0,0,0
"Oct 17, 2019 6:00 AM",59,46,13,,,,,,,,,,1,1,0,6,,,,11,8,3,23,8,9,7,2,37,1,1,0,0,0,0,0,0
"Oct 17, 2019 7:00 AM",188,145,43,,,,,,,,,,6,2,4,20,,,,27,22,5,132,45,47,33,14,170,1,6,10,8,2,4,0,4
"Oct 17, 2019 8:00 AM",479,404,75,,,,,,,,,,40,9,31,35,,,,54,39,15,322,80,88,67,21,325,11,9,9,6,3,3,3,0
"Oct 17, 2019 9:00 AM",260,224,36,,,,,,,,,,20,9,11,12,,,,34,16,18,135,36,42,29,13,133,5,6,6,4,2,2,0,2
"Oct 17, 2019 10:00 AM",111,93,18,,,,,,,,,,10,4,6,12,,,,27,13,14,71,13,16,8,8,38,4,2,3,1,2,1,0,1
"Oct 17, 2019 11:00 AM",72,53,19,,,,,,,,,,7,2,5,6,,,,15,7,8,26,14,19,13,6,21,3,2,2,2,0,0,0,0
"Oct 17, 2019 12:00 PM",80,38,42,,,,,,,,,,11,7,4,6,,,,26,20,6,30,19,12,3,9,23,2,1,2,2,0,1,1,0
"Oct 17, 2019 1:00 PM",113,54,59,,,,,,,,,,2,2,0,3,,,,34,30,4,24,25,17,4,13,28,1,1,1,1,0,0,0,0
"Oct 17, 2019 2:00 PM",91,35,56,,,,,,,,,,15,9,6,10,,,,27,23,4,24,23,20,5,15,25,2,0,5,1,4,2,2,0
"Oct 17, 2019 3:00 PM",109,30,79,,,,,,,,,,15,10,5,15,,,,41,35,6,22,24,21,3,18,27,4,4,7,4,3,4,2,2
"Oct 17, 2019 4:00 PM",151,31,120,,,,,,,,,,16,10,6,10,,,,75,71,4,24,75,32,5,27,35,4,3,4,2,2,2,2,0
"Oct 17, 2019 5:00 PM",343,66,277,,,,,,,,,,18,13,5,19,,,,169,161,8,50,180,74,12,62,72,17,1,11,7,4,1,1,0
"Oct 17, 2019 6:00 PM",308,53,255,,,,,,,,,,20,14,6,19,,,,222,217,5,28,179,78,5,73,56,6,4,5,3,2,2,1,1
"Oct 17, 2019 7:00 PM",187,31,156,,,,,,,,,,12,10,2,10,,,,93,90,3,17,65,35,3,32,24,0,2,6,1,5,4,3,1
"Oct 17, 2019 8:00 PM",124,25,99,,,,,,,,,,6,3,3,3,,,,59,56,3,17,32,4,1,3,27,3,1,1,1,0,2,2,0
"Oct 17, 2019 9:00 PM",99,12,87,,,,,,,,,,4,3,1,4,,,,47,47,0,7,22,3,2,1,10,0,1,2,1,1,2,1,1
"Oct 17, 2019 10:00 PM",51,7,44,,,,,,,,,,5,5,0,7,,,,25,22,3,3,13,4,0,4,7,0,1,1,1,0,1,0,1
"Oct 17, 2019 11:00 PM",35,12,23,,,,,,,,,,1,0,1,0,,,,14,14,0,4,8,2,2,0,3,0,0,2,0,2,1,1,0
"Oct 18, 2019 12:00 AM",11,0,11,,,,,,,,,,0,0,0,2,,,,12,11,1,2,5,4,2,2,2,0,0,1,1,0,0,0,0
"Oct 18, 2019 1:00 AM",5,1,4,,,,,,,,,,3,3,0,1,,,,0,0,0,1,3,2,0,2,0,0,0,1,1,0,1,0,1
"Oct 18, 2019 2:00 AM",6,1,5,,,,,,,,,,0,0,0,0,,,,0,0,0,0,1,1,0,1,0,0,0,0,0,0,0,0,0
"Oct 18, 2019 3:00 AM",3,1,2,,,,,,,,,,1,0,1,2,,,,0,0,0,0,0,1,0,1,1,0,0,0,0,0,0,0,0
"Oct 18, 2019 4:00 AM",4,2,2,,,,,,,,,,0,0,0,1,,,,0,0,0,1,1,0,0,0,1,0,0,0,0,0,0,0,0
"Oct 18, 2019 5:00 AM",11,9,2,,,,,,,,,,0,0,0,1,,,,2,1,1,6,6,0,0,0,13,3,0,0,0,0,0,0,0
"Oct 18, 2019 6:00 AM",41,33,8,,,,,,,,,,1,1,0,7,,,,7,6,1,17,9,3,3,0,44,1,0,3,2,1,2,0,2
"Oct 18, 2019 7:00 AM",142,106,36,,,,,,,,,,8,4,4,22,,,,29,18,11,104,27,15,10,5,107,1,3,6,6,0,3,0,3
"Oct 18, 2019 8:00 AM",341,277,64,,,,,,,,,,42,9,33,24,,,,48,33,15,252,67,72,56,16,248,8,7,7,6,1,2,1,1
"Oct 18, 2019 9:00 AM",220,189,31,,,,,,,,,,17,8,9,11,,,,21,11,10,135,23,38,26,12,101,4,6,11,5,6,6,2,4
"Oct 18, 2019 10:00 AM",89,68,21,,,,,,,,,,14,4,10,6,,,,14,5,9,57,16,19,9,10,37,0,4,2,2,0,0,0,0
"Oct 18, 2019 11:00 AM",61,34,27,,,,,,,,,,8,6,2,9,,,,21,15,6,37,15,11,3,8,19,1,2,2,1,1,1,1,0
"Oct 18, 2019 12:00 PM",108,55,53,,,,,,,,,,19,10,9,10,,,,32,27,5,24,22,18,7,11,30,3,2,4,4,0,0,0,0
"Oct 18, 2019 1:00 PM",96,43,53,,,,,,,,,,12,5,7,8,,,,24,22,2,15,28,16,4,12,19,1,1,3,1,2,2,0,2
"Oct 18, 2019 2:00 PM",97,38,59,,,,,,,,,,16,9,7,12,,,,43,37,6,13,28,8,0,8,24,2,3,5,4,1,0,0,0
"Oct 18, 2019 3:00 PM",108,21,87,,,,,,,,,,11,5,6,14,,,,54,49,5,22,37,14,4,10,29,3,0,12,6,6,6,5,1
"Oct 18, 2019 4:00 PM",158,34,124,,,,,,,,,,8,5,3,13,,,,88,84,4,20,81,14,1,13,18,5,3,6,2,4,4,4,0
"Oct 18, 2019 5:00 PM",308,56,252,,,,,,,,,,18,15,3,20,,,,165,161,4,45,156,68,9,59,51,7,2,9,4,5,0,0,0
"Oct 18, 2019 6:00 PM",210,48,162,,,,,,,,,,10,9,1,13,,,,109,109,0,21,112,42,2,40,32,2,3,5,1,4,0,0,0
"Oct 18, 2019 7:00 PM",95,23,72,,,,,,,,,,5,4,1,13,,,,47,44,3,10,41,11,3,8,14,2,1,0,0,0,1,1,0
"Oct 18, 2019 8:00 PM",62,10,52,,,,,,,,,,7,4,3,2,,,,30,29,1,13,25,11,3,8,8,0,0,2,2,0,1,1,0
"Oct 18, 2019 9:00 PM",43,10,33,,,,,,,,,,6,4,2,13,,,,11,11,0,8,15,6,1,5,6,0,0,1,1,0,0,0,0
"Oct 18, 2019 10:00 PM",42,4,38,,,,,,,,,,0,0,0,1,,,,19,18,1,3,6,4,3,1,10,1,0,2,1,1,0,0,0
"Oct 18, 2019 11:00 PM",20,5,15,,,,,,,,,,0,0,0,1,,,,5,5,0,3,8,1,1,0,5,1,2,0,0,0,0,0,0
"Oct 19, 2019 12:00 AM",16,5,11,,,,,,,,,,2,2,0,0,,,,6,6,0,1,5,0,0,0,4,0,0,0,0,0,0,0,0
"Oct 19, 2019 1:00 AM",12,5,7,,,,,,,,,,1,1,0,1,,,,2,2,0,0,1,5,3,2,1,0,0,0,0,0,0,0,0
"Oct 19, 2019 2:00 AM",5,1,4,,,,,,,,,,0,0,0,1,,,,2,2,0,0,3,0,0,0,2,1,2,1,0,1,0,0,0
"Oct 19, 2019 3:00 AM",3,1,2,,,,,,,,,,0,0,0,0,,,,1,1,0,1,4,2,0,2,2,0,0,0,0,0,0,0,0
"Oct 19, 2019 4:00 AM",4,2,2,,,,,,,,,,0,0,0,0,,,,1,1,0,1,1,0,0,0,1,0,0,0,0,0,0,0,0
"Oct 19, 2019 5:00 AM",1,0,1,,,,,,,,,,0,0,0,0,,,,2,2,0,3,0,0,0,0,2,0,0,0,0,0,0,0,0
"Oct 19, 2019 6:00 AM",7,4,3,,,,,,,,,,0,0,0,1,,,,7,6,1,5,6,1,1,0,8,0,1,1,1,0,0,0,0
"Oct 19, 2019 7:00 AM",14,7,7,,,,,,,,,,2,2,0,0,,,,6,4,2,5,9,2,0,2,14,1,1,0,0,0,0,0,0
"Oct 19, 2019 8:00 AM",41,28,13,,,,,,,,,,6,4,2,12,,,,7,4,3,13,12,7,5,2,20,1,0,1,0,1,0,0,0
"Oct 19, 2019 9:00 AM",44,32,12,,,,,,,,,,12,5,7,5,,,,9,7,2,16,15,16,7,9,26,1,2,0,0,0,1,1,0
"Oct 19, 2019 10:00 AM",48,28,20,,,,,,,,,,5,2,3,7,,,,7,6,1,14,14,13,6,7,16,2,2,2,1,1,2,0,2
"Oct 19, 2019 11:00 AM",40,25,15,,,,,,,,,,3,2,1,8,,,,12,9,3,7,5,5,2,3,11,1,0,1,1,0,1,0,1
"Oct 19, 2019 12:00 PM",31,19,12,,,,,,,,,,4,1,3,7,,,,13,11,2,10,7,1,1,0,5,1,2,1,0,1,0,0,0
"Oct 19, 2019 1:00 PM",43,23,20,,,,,,,,,,8,3,5,8,,,,11,10,1,9,18,6,2,4,10,2,0,1,1,0,0,0,0
"Oct 19, 2019 2:00 PM",48,27,21,,,,,,,,,,4,2,2,10,,,,10,7,3,7,14,9,2,7,15,1,0,4,1,3,0,0,0
"Oct 19, 2019 3:00 PM",48,24,24,,,,,,,,,,8,4,4,3,,,,14,11,3,18,13,7,2,5,11,0,2,1,1,0,0,0,0
"Oct 19, 2019 4:00 PM",57,22,35,,,,,,,,,,9,4,5,18,,,,13,12,1,10,11,26,8,18,20,3,0,4,2,2,0,0,0
"Oct 19, 2019 5:00 PM",66,25,41,,,,,,,,,,17,5,12,10,,,,26,23,3,13,13,11,3,8,15,6,2,3,2,1,0,0,0
"Oct 19, 2019 6:00 PM",44,11,33,,,,,,,,,,8,6,2,12,,,,9,8,1,10,16,7,1,6,15,0,1,3,3,0,0,0,0
"Oct 19, 2019 7:00 PM",31,11,20,,,,,,,,,,3,2,1,9,,,,5,4,1,2,13,3,1,2,12,0,0,0,0,0,0,0,0
"Oct 19, 2019 8:00 PM",23,14,9,,,,,,,,,,6,3,3,4,,,,5,5,0,4,9,2,1,1,9,1,1,0,0,0,0,0,0
"Oct 19, 2019 9:00 PM",21,9,12,,,,,,,,,,1,0,1,2,,,,3,2,1,4,2,3,2,1,8,0,0,1,0,1,0,0,0
"Oct 19, 2019 10:00 PM",7,3,4,,,,,,,,,,4,4,0,2,,,,5,3,2,2,3,4,1,3,8,0,0,2,1,1,1,0,1
"Oct 19, 2019 11:00 PM",15,7,8,,,,,,,,,,0,0,0,1,,,,6,5,1,2,5,1,1,0,6,0,0,0,0,0,0,0,0
"Oct 20, 2019 12:00 AM",13,6,7,,,,,,,,,,0,0,0,0,,,,1,1,0,1,7,1,1,0,1,0,0,0,0,0,0,0,0
"Oct 20, 2019 1:00 AM",11,0,11,,,,,,,,,,0,0,0,0,,,,6,6,0,3,2,0,0,0,3,0,0,2,1,1,0,0,0
"Oct 20, 2019 2:00 AM",7,2,5,,,,,,,,,,0,0,0,0,,,,3,3,0,0,4,2,1,1,1,0,1,0,0,0,0,0,0
"Oct 20, 2019 3:00 AM",1,1,0,,,,,,,,,,0,0,0,0,,,,1,1,0,1,3,3,1,2,1,0,1,0,0,0,0,0,0
"Oct 20, 2019 4:00 AM",3,1,2,,,,,,,,,,0,0,0,0,,,,2,2,0,1,2,0,0,0,0,0,0,0,0,0,0,0,0
"Oct 20, 2019 5:00 AM",4,0,4,,,,,,,,,,1,1,0,0,,,,1,1,0,0,0,0,0,0,1,0,0,0,0,0,0,0,0
"Oct 20, 2019 6:00 AM",9,6,3,,,,,,,,,,0,0,0,0,,,,4,4,0,4,6,2,2,0,5,1,0,0,0,0,0,0,0
"Oct 20, 2019 7:00 AM",10,2,8,,,,,,,,,,0,0,0,2,,,,8,4,4,10,9,4,0,4,8,0,1,0,0,0,0,0,0
"Oct 20, 2019 8:00 AM",24,17,7,,,,,,,,,,5,2,3,7,,,,2,1,1,8,10,7,4,3,16,2,12,2,1,1,0,0,0
"Oct 20, 2019 9:00 AM",41,31,10,,,,,,,,,,7,4,3,8,,,,15,11,4,20,24,17,7,10,20,0,11,1,1,0,0,0,0
"Oct 20, 2019 10:00 AM",41,30,11,,,,,,,,,,21,10,11,13,,,,18,13,5,20,27,19,2,17,60,6,4,7,2,5,0,0,0
"Oct 20, 2019 11:00 AM",53,31,22,,,,,,,,,,19,8,11,6,,,,13,10,3,17,27,42,14,28,30,4,2,4,3,1,3,1,2
"Oct 20, 2019 12:00 PM",48,28,20,,,,,,,,,,28,19,9,14,,,,14,10,4,14,24,21,12,9,26,10,3,9,7,2,0,0,0
"Oct 20, 2019 1:00 PM",59,40,19,,,,,,,,,,26,15,11,13,,,,37,33,4,22,33,41,16,25,19,6,5,4,1,3,2,0,2
"Oct 20, 2019 2:00 PM",54,31,23,,,,,,,,,,24,16,8,16,,,,20,16,4,15,22,28,6,22,30,1,4,2,1,1,0,0,0
"Oct 20, 2019 3:00 PM",60,29,31,,,,,,,,,,28,13,15,10,,,,14,12,2,21,16,24,14,10,27,6,4,3,3,0,0,0,0
"Oct 20, 2019 4:00 PM",49,21,28,,,,,,,,,,21,10,11,9,,,,17,16,1,11,12,26,14,12,22,4,1,2,1,1,1,0,1
"Oct 20, 2019 5:00 PM",49,18,31,,,,,,,,,,24,22,2,8,,,,27,25,2,13,13,11,3,8,26,10,1,10,9,1,1,1,0
"Oct 20, 2019 6:00 PM",43,13,30,,,,,,,,,,9,4,5,11,,,,12,11,1,12,12,15,9,6,20,2,0,4,2,2,0,0,0
"Oct 20, 2019 7:00 PM",30,7,23,,,,,,,,,,6,3,3,6,,,,10,8,2,6,11,5,2,3,10,2,3,0,0,0,1,1,0
"Oct 20, 2019 8:00 PM",32,7,25,,,,,,,,,,0,0,0,3,,,,3,3,0,9,8,4,2,2,14,3,0,5,3,2,3,0,3
"Oct 20, 2019 9:00 PM",17,9,8,,,,,,,,,,3,2,1,6,,,,3,3,0,4,4,2,1,1,4,0,1,1,0,1,0,0,0
"Oct 20, 2019 10:00 PM",12,2,10,,,,,,,,,,0,0,0,2,,,,6,4,2,4,6,0,0,0,5,0,1,0,0,0,0,0,0
"Oct 20, 2019 11:00 PM",6,1,5,,,,,,,,,,3,3,0,0,,,,6,5,1,1,4,1,1,0,2,0,0,0,0,0,0,0,0
"Oct 21, 2019 12:00 AM",3,1,2,,,,,,,,,,1,1,0,0,,,,1,1,0,2,1,0,0,0,0,0,1,0,0,0,0,0,0
"Oct 21, 2019 1:00 AM",4,0,4,,,,,,,,,,0,0,0,1,,,,2,2,0,0,0,2,2,0,0,0,0,0,0,0,0,0,0
"Oct 21, 2019 2:00 AM",2,0,2,,,,,,,,,,0,0,0,0,,,,1,1,0,0,1,0,0,0,0,0,0,0,0,0,0,0,0
"Oct 21, 2019 3:00 AM",0,0,0,,,,,,,,,,0,0,0,0,,,,0,0,0,0,1,0,0,0,1,0,0,1,0,1,0,0,0
"Oct 21, 2019 4:00 AM",3,1,2,,,,,,,,,,0,0,0,0,,,,0,0,0,1,0,0,0,0,1,0,0,0,0,0,0,0,0
"Oct 21, 2019 5:00 AM",4,4,0,,,,,,,,,,0,0,0,1,,,,2,1,1,9,6,0,0,0,8,3,0,0,0,0,0,0,0
"Oct 21, 2019 6:00 AM",47,36,11,,,,,,,,,,3,1,2,1,,,,12,9,3,23,19,6,4,2,45,3,0,1,0,1,0,0,0
"Oct 21, 2019 7:00 AM",183,133,50,,,,,,,,,,10,1,9,18,,,,39,30,9,139,32,33,24,9,182,0,4,6,5,1,0,0,0
"Oct 21, 2019 8:00 AM",540,450,90,,,,,,,,,,34,6,28,34,,,,71,43,28,337,72,103,86,17,377,7,7,16,13,3,4,0,4
"Oct 21, 2019 9:00 AM",261,227,34,,,,,,,,,,19,9,10,12,,,,38,19,19,164,35,45,34,11,122,4,3,4,3,1,1,0,1
"Oct 21, 2019 10:00 AM",112,96,16,,,,,,,,,,9,2,7,11,,,,12,6,6,72,12,13,5,8,37,4,1,3,2,1,1,1,0
"Oct 21, 2019 11:00 AM",78,51,27,,,,,,,,,,4,2,2,6,,,,23,18,5,34,15,14,6,8,18,0,0,1,1,0,2,0,2
"Oct 21, 2019 12:00 PM",87,50,37,,,,,,,,,,18,13,5,11,,,,24,19,5,27,11,9,3,6,28,0,0,1,0,1,0,0,0
"Oct 21, 2019 1:00 PM",79,34,45,,,,,,,,,,15,10,5,5,,,,26,23,3,22,21,20,4,16,27,2,2,3,2,1,0,0,0
"Oct 21, 2019 2:00 PM",80,40,40,,,,,,,,,,17,9,8,12,,,,41,35,6,15,21,17,5,12,25,4,3,5,3,2,0,0,0
"Oct 21, 2019 3:00 PM",111,34,77,,,,,,,,,,14,7,7,18,,,,67,55,12,25,29,27,11,16,21,6,6,8,5,3,2,0,2
"Oct 21, 2019 4:00 PM",156,37,119,,,,,,,,,,23,19,4,18,,,,86,83,3,21,66,39,3,36,36,2,3,4,2,2,1,1,0
"Oct 21, 2019 5:00 PM",386,75,311,,,,,,,,,,25,17,8,34,,,,232,223,9,55,211,92,12,80,76,9,1,13,11,2,1,1,0
"Oct 21, 2019 6:00 PM",383,75,308,,,,,,,,,,22,17,5,21,,,,200,192,8,38,204,101,13,88,53,7,4,6,2,4,4,4,0
"Oct 21, 2019 7:00 PM",212,48,164,,,,,,,,,,14,11,3,7,,,,95,92,3,23,88,35,5,30,23,7,2,1,0,1,0,0,0
"Oct 21, 2019 8:00 PM",145,19,126,,,,,,,,,,2,1,1,6,,,,61,58,3,10,41,15,1,14,10,2,2,4,0,4,1,1,0
"Oct 21, 2019 9:00 PM",87,12,75,,,,,,,,,,4,2,2,6,,,,34,31,3,8,19,6,1,5,11,1,1,1,0,1,1,1,0
"Oct 21, 2019 10:00 PM",42,9,33,,,,,,,,,,1,0,1,3,,,,23,23,0,2,12,5,1,4,6,0,0,0,0,0,0,0,0
"Oct 21, 2019 11:00 PM",23,5,18,,,,,,,,,,4,4,0,1,,,,8,7,1,0,5,3,2,1,1,0,1,1,1,0,0,0,0
"Oct 22, 2019 12:00 AM",4,0,4,,,,,,,,,,0,0,0,0,,,,5,5,0,5,1,0,0,0,4,0,0,0,0,0,0,0,0
"Oct 22, 2019 1:00 AM",2,0,2,,,,,,,,,,0,0,0,1,,,,3,3,0,0,1,0,0,0,0,0,1,0,0,0,0,0,0
"Oct 22, 2019 2:00 AM",2,0,2,,,,,,,,,,0,0,0,0,,,,0,0,0,1,1,1,0,1,0,0,0,0,0,0,0,0,0
"Oct 22, 2019 3:00 AM",1,1,0,,,,,,,,,,0,0,0,0,,,,1,0,1,0,1,0,0,0,1,0,0,0,0,0,0,0,0
"Oct 22, 2019 4:00 AM",3,0,3,,,,,,,,,,0,0,0,0,,,,0,0,0,1,0,0,0,0,8,1,0,0,0,0,0,0,0
"Oct 22, 2019 5:00 AM",7,6,1,,,,,,,,,,0,0,0,2,,,,3,1,2,5,5,0,0,0,11,4,0,0,0,0,0,0,0
"Oct 22, 2019 6:00 AM",64,44,20,,,,,,,,,,3,1,2,3,,,,15,12,3,35,10,8,6,2,54,1,2,1,1,0,0,0,0
"Oct 22, 2019 7:00 AM",220,171,49,,,,,,,,,,10,3,7,16,,,,31,24,7,154,44,46,36,10,181,4,5,9,6,3,3,0,3
"Oct 22, 2019 8:00 AM",551,458,93,,,,,,,,,,49,11,38,31,,,,69,39,30,336,77,106,83,23,382,13,9,18,13,5,6,1,5
"Oct 22, 2019 9:00 AM",269,239,30,,,,,,,,,,17,5,12,8,,,,28,12,16,193,36,40,26,14,127,3,4,5,3,2,0,0,0
"Oct 22, 2019 10:00 AM",109,92,17,,,,,,,,,,2,1,1,4,,,,26,17,9,60,14,21,11,10,34,2,4,6,2,4,4,2,2
"Oct 22, 2019 11:00 AM",81,51,30,,,,,,,,,,10,7,3,6,,,,17,13,4,38,18,11,7,4,16,0,2,3,2,1,0,0,0
"Oct 22, 2019 12:00 PM",86,44,42,,,,,,,,,,18,10,8,11,,,,17,12,5,30,14,8,3,5,32,2,3,2,2,0,0,0,0
"Oct 22, 2019 1:00 PM",93,41,52,,,,,,,,,,18,8,10,8,,,,26,22,4,40,27,21,9,12,24,5,0,2,1,1,2,1,1
"Oct 22, 2019 2:00 PM",90,37,53,,,,,,,,,,23,16,7,9,,,,56,47,9,23,25,18,4,14,19,9,2,5,4,1,3,1,2
"Oct 22, 2019 3:00 PM",108,32,76,,,,,,,,,,25,14,11,12,,,,54,49,5,28,29,15,5,10,27,5,3,10,7,3,3,2,1
"Oct 22, 2019 4:00 PM",173,42,131,,,,,,,,,,25,15,10,16,,,,107,103,4,22,74,41,8,33,46,1,2,4,0,4,4,3,1
"Oct 22, 2019 5:00 PM",394,91,303,,,,,,,,,,23,17,6,28,,,,208,199,9,53,217,83,11,72,82,11,2,7,5,2,0,0,0
"Oct 22, 2019 6:00 PM",356,62,294,,,,,,,,,,25,23,2,22,,,,223,216,7,45,210,102,9,93,46,5,3,9,5,4,2,0,2
"Oct 22, 2019 7:00 PM",217,39,178,,,,,,,,,,12,8,4,13,,,,92,85,7,20,82,33,3,30,40,6,5,6,3,3,1,0,1
"Oct 22, 2019 8:00 PM",155,31,124,,,,,,,,,,9,4,5,5,,,,88,85,3,17,53,12,0,12,22,2,1,2,0,2,1,1,0
"Oct 22, 2019 9:00 PM",89,12,77,,,,,,,,,,3,3,0,6,,,,36,34,2,11,34,12,1,11,13,2,1,4,3,1,0,0,0
"Oct 22, 2019 10:00 PM",56,10,46,,,,,,,,,,0,0,0,4,,,,23,23,0,4,15,2,0,2,10,0,1,0,0,0,1,0,1
"Oct 22, 2019 11:00 PM",21,5,16,,,,,,,,,,0,0,0,2,,,,6,6,0,4,9,4,3,1,1,0,0,1,0,1,0,0,0
"Oct 23, 2019 12:00 AM",14,1,13,,,,,,,,,,0,0,0,2,,,,1,1,0,1,2,0,0,0,3,1,0,1,0,1,0,0,0
"Oct 23, 2019 1:00 AM",6,1,5,,,,,,,,,,0,0,0,0,,,,1,1,0,0,2,1,0,1,1,1,1,0,0,0,0,0,0
"Oct 23, 2019 2:00 AM",5,1,4,,,,,,,,,,0,0,0,0,,,,2,2,0,3,3,0,0,0,2,0,0,0,0,0,0,0,0
"Oct 23, 2019 3:00 AM",2,1,1,,,,,,,,,,0,0,0,0,,,,0,0,0,1,1,2,2,0,0,0,0,1,0,1,0,0,0
"Oct 23, 2019 4:00 AM",1,0,1,,,,,,,,,,0,0,0,0,,,,1,1,0,0,0,0,0,0,5,1,0,0,0,0,0,0,0
"Oct 23, 2019 5:00 AM",5,4,1,,,,,,,,,,0,0,0,2,,,,3,2,1,9,4,0,0,0,12,3,0,0,0,0,0,0,0
"Oct 23, 2019 6:00 AM",47,34,13,,,,,,,,,,1,0,1,7,,,,11,7,4,26,10,5,2,3,58,2,0,3,2,1,1,0,1
"Oct 23, 2019 7:00 AM",220,182,38,,,,,,,,,,8,3,5,16,,,,38,26,12,141,38,26,20,6,166,1,6,6,5,1,3,0,3
"Oct 23, 2019 8:00 AM",501,420,81,,,,,,,,,,44,14,30,28,,,,62,34,28,303,74,103,85,18,339,6,6,14,11,3,4,1,3
"Oct 23, 2019 9:00 AM",283,246,37,,,,,,,,,,16,7,9,13,,,,35,18,17,161,29,35,19,16,122,5,4,7,4,3,1,0,1
"Oct 23, 2019 10:00 AM",124,105,19,,,,,,,,,,10,2,8,12,,,,22,10,12,67,18,17,9,8,32,3,3,5,3,2,7,7,0
"Oct 23, 2019 11:00 AM",81,57,24,,,,,,,,,,11,5,6,9,,,,11,6,5,35,16,2,0,2,25,0,4,3,3,0,2,0,2
"Oct 23, 2019 12:00 PM",78,35,43,,,,,,,,,,22,13,9,1,,,,30,27,3,29,20,13,7,6,23,1,2,2,2,0,0,0,0
"Oct 23, 2019 1:00 PM",105,50,55,,,,,,,,,,22,13,9,15,,,,38,32,6,30,21,23,5,18,14,6,0,4,1,3,1,1,0
"Oct 23, 2019 2:00 PM",96,47,49,,,,,,,,,,20,9,11,10,,,,41,35,6,18,15,13,4,9,18,2,2,4,2,2,2,2,0
"Oct 23, 2019 3:00 PM",113,36,77,,,,,,,,,,11,3,8,15,,,,64,52,12,20,26,8,2,6,19,4,2,8,3,5,1,0,1
"Oct 23, 2019 4:00 PM",177,46,131,,,,,,,,,,15,12,3,17,,,,98,95,3,15,72,43,9,34,37,3,5,6,6,0,2,2,0
"Oct 23, 2019 5:00 PM",343,67,276,,,,,,,,,,17,12,5,14,,,,197,193,4,52,169,89,13,76,84,5,5,5,4,1,1,1,0
"Oct 23, 2019 6:00 PM",327,63,264,,,,,,,,,,14,12,2,19,,,,170,166,4,33,212,69,7,62,57,6,4,2,1,1,0,0,0
"Oct 23, 2019 7:00 PM",190,30,160,,,,,,,,,,8,4,4,7,,,,96,90,6,24,72,23,4,19,24,4,2,1,0,1,0,0,0
"Oct 23, 2019 8:00 PM",144,31,113,,,,,,,,,,6,6,0,11,,,,58,58,0,18,41,17,1,16,18,3,1,6,2,4,1,0,1
"Oct 23, 2019 9:00 PM",77,9,68,,,,,,,,,,6,4,2,6,,,,35,31,4,9,18,11,3,8,15,3,3,1,1,0,0,0,0
"Oct 23, 2019 10:00 PM",66,12,54,,,,,,,,,,2,1,1,3,,,,21,21,0,7,16,5,1,4,12,0,2,0,0,0,0,0,0
"Oct 23, 2019 11:00 PM",25,7,18,,,,,,,,,,1,0,1,3,,,,15,15,0,3,10,2,1,1,2,0,0,0,0,0,0,0,0
"Oct 24, 2019 12:00 AM",11,3,8,,,,,,,,,,0,0,0,0,,,,1,1,0,2,5,1,0,1,1,0,0,1,1,0,1,1,0
"Oct 24, 2019 1:00 AM",4,0,4,,,,,,,,,,0,0,0,1,,,,2,2,0,0,2,0,0,0,1,0,1,0,0,0,1,0,1
"Oct 24, 2019 2:00 AM",2,0,2,,,,,,,,,,0,0,0,0,,,,0,0,0,0,1,0,0,0,0,0,0,0,0,0,0,0,0
"Oct 24, 2019 3:00 AM",3,1,2,,,,,,,,,,0,0,0,1,,,,1,1,0,1,1,0,0,0,0,2,0,3,2,1,0,0,0
"Oct 24, 2019 4:00 AM",2,1,1,,,,,,,,,,0,0,0,0,,,,2,2,0,2,1,0,0,0,9,1,0,1,0,1,1,1,0
"Oct 24, 2019 5:00 AM",10,9,1,,,,,,,,,,0,0,0,2,,,,2,1,1,9,3,0,0,0,8,4,0,0,0,0,0,0,0
"Oct 24, 2019 6:00 AM",48,33,15,,,,,,,,,,6,0,6,3,,,,16,11,5,27,12,8,6,2,46,1,2,2,1,1,0,0,0
"Oct 24, 2019 7:00 AM",205,162,43,,,,,,,,,,6,1,5,7,,,,36,29,7,108,44,30,21,9,150,3,3,5,5,0,3,0,3
"Oct 24, 2019 8:00 AM",470,384,86,,,,,,,,,,41,14,27,36,,,,62,40,22,288,67,99,83,16,301,9,11,16,14,2,4,1,3
"Oct 24, 2019 9:00 AM",247,218,29,,,,,,,,,,14,6,8,12,,,,30,18,12,138,38,48,29,19,113,2,14,2,1,1,1,0,1
"Oct 24, 2019 10:00 AM",129,103,26,,,,,,,,,,4,1,3,9,,,,25,17,8,64,10,18,5,13,39,5,4,2,1,1,0,0,0
"Oct 24, 2019 11:00 AM",100,57,43,,,,,,,,,,7,1,6,7,,,,16,14,2,41,18,9,4,5,25,4,3,7,3,4,3,3,0
"Oct 24, 2019 12:00 PM",82,43,39,,,,,,,,,,12,6,6,9,,,,20,15,5,24,20,14,6,8,31,2,2,2,2,0,0,0,0
"Oct 24, 2019 1:00 PM",137,58,79,,,,,,,,,,9,3,6,11,,,,29,26,3,33,25,21,6,15,35,6,1,4,2,2,0,0,0
"Oct 24, 2019 2:00 PM",87,30,57,,,,,,,,,,23,15,8,16,,,,32,28,4,25,34,15,3,12,27,5,1,2,2,0,1,0,1
"Oct 24, 2019 3:00 PM",127,36,91,,,,,,,,,,9,8,1,5,,,,72,67,5,28,35,22,6,16,26,6,0,3,2,1,1,1,0
"Oct 24, 2019 4:00 PM",171,46,125,,,,,,,,,,16,7,9,17,,,,83,79,4,18,84,35,7,28,39,4,3,5,3,2,4,4,0
"Oct 24, 2019 5:00 PM",326,65,261,,,,,,,,,,14,10,4,22,,,,167,163,4,47,141,58,11,47,78,7,2,7,5,2,4,4,0
"Oct 24, 2019 6:00 PM",306,61,245,,,,,,,,,,21,17,4,20,,,,161,157,4,35,187,59,8,51,46,7,4,9,4,5,0,0,0
"Oct 24, 2019 7:00 PM",166,30,136,,,,,,,,,,4,3,1,6,,,,82,81,1,17,66,39,6,33,27,4,1,8,1,7,2,2,0
"Oct 24, 2019 8:00 PM",141,27,114,,,,,,,,,,7,6,1,9,,,,48,45,3,13,28,12,2,10,16,3,1,4,3,1,4,3,1
"Oct 24, 2019 9:00 PM",91,18,73,,,,,,,,,,4,1,3,9,,,,28,27,1,8,30,10,1,9,18,1,1,0,0,0,0,0,0
"Oct 24, 2019 10:00 PM",61,9,52,,,,,,,,,,3,3,0,2,,,,32,31,1,7,10,5,1,4,6,1,0,2,1,1,1,1,0
"Oct 24, 2019 11:00 PM",34,9,25,,,,,,,,,,0,0,0,1,,,,15,15,0,4,7,3,3,0,6,0,2,1,1,0,1,1,0
"Oct 25, 2019 12:00 AM",11,2,9,,,,,,,,,,3,2,1,1,,,,5,5,0,1,3,4,2,2,4,0,0,0,0,0,0,0,0
"Oct 25, 2019 1:00 AM",5,2,3,,,,,,,,,,0,0,0,0,,,,2,2,0,0,1,1,0,1,0,0,1,0,0,0,0,0,0
"Oct 25, 2019 2:00 AM",3,0,3,,,,,,,,,,0,0,0,0,,,,0,0,0,0,1,0,0,0,1,0,0,1,0,1,0,0,0
"Oct 25, 2019 3:00 AM",1,1,0,,,,,,,,,,0,0,0,1,,,,1,1,0,0,1,0,0,0,0,0,0,0,0,0,0,0,0
"Oct 25, 2019 4:00 AM",3,1,2,,,,,,,,,,1,0,1,0,,,,0,0,0,0,1,0,0,0,7,1,0,0,0,0,0,0,0
"Oct 25, 2019 5:00 AM",8,8,0,,,,,,,,,,0,0,0,1,,,,3,2,1,10,6,0,0,0,8,3,0,0,0,0,0,0,0
"Oct 25, 2019 6:00 AM",35,24,11,,,,,,,,,,2,0,2,2,,,,7,4,3,23,12,4,2,2,44,1,0,3,3,0,1,0,1
"Oct 25, 2019 7:00 AM",132,95,37,,,,,,,,,,6,3,3,14,,,,9,7,2,86,29,15,10,5,107,1,4,7,6,1,1,0,1
"Oct 25, 2019 8:00 AM",334,285,49,,,,,,,,,,10,3,7,23,,,,41,28,13,192,54,64,52,12,184,7,4,8,6,2,4,2,2
"Oct 25, 2019 9:00 AM",184,161,23,,,,,,,,,,8,6,2,10,,,,19,13,6,75,18,20,12,8,84,1,1,4,2,2,0,0,0
"Oct 25, 2019 10:00 AM",58,44,14,,,,,,,,,,2,1,1,2,,,,13,9,4,29,7,5,3,2,17,0,0,0,0,0,0,0,0
"Oct 25, 2019 11:00 AM",44,28,16,,,,,,,,,,2,0,2,1,,,,11,9,2,16,3,6,1,5,9,0,1,1,0,1,0,0,0
"Oct 25, 2019 12:00 PM",50,23,27,,,,,,,,,,4,1,3,3,,,,15,13,2,13,9,2,1,1,12,0,0,1,1,0,0,0,0
"Oct 25, 2019 1:00 PM",81,24,57,,,,,,,,,,3,0,3,7,,,,22,15,7,14,15,4,0,4,12,1,0,0,0,0,1,1,0
"Oct 25, 2019 2:00 PM",66,23,43,,,,,,,,,,1,1,0,4,,,,20,19,1,9,18,3,1,2,15,0,1,2,2,0,4,3,1
"Oct 25, 2019 3:00 PM",83,14,69,,,,,,,,,,1,1,0,8,,,,43,42,1,23,27,8,0,8,19,4,0,6,1,5,0,0,0
"Oct 25, 2019 4:00 PM",136,23,113,,,,,,,,,,3,3,0,13,,,,58,56,2,11,68,13,3,10,24,3,2,2,1,1,0,0,0
"Oct 25, 2019 5:00 PM",196,35,161,,,,,,,,,,8,6,2,13,,,,116,113,3,21,108,40,6,34,33,6,3,3,1,2,0,0,0
"Oct 25, 2019 6:00 PM",162,25,137,,,,,,,,,,7,3,4,9,,,,69,67,2,11,77,34,4,30,27,2,0,4,3,1,0,0,0
"Oct 25, 2019 7:00 PM",71,12,59,,,,,,,,,,4,3,1,6,,,,36,35,1,5,38,13,1,12,13,0,0,2,0,2,0,0,0
"Oct 25, 2019 8:00 PM",43,10,33,,,,,,,,,,2,1,1,4,,,,15,14,1,4,14,3,1,2,12,0,2,4,2,2,0,0,0
"Oct 25, 2019 9:00 PM",40,12,28,,,,,,,,,,1,0,1,2,,,,9,8,1,6,8,1,0,1,4,1,0,0,0,0,1,1,0
"Oct 25, 2019 10:00 PM",24,3,21,,,,,,,,,,0,0,0,4,,,,7,6,1,3,4,1,0,1,5,0,0,1,0,1,0,0,0
"Oct 25, 2019 11:00 PM",23,13,10,,,,,,,,,,2,2,0,0,,,,1,1,0,1,4,2,0,2,4,0,0,1,1,0,0,0,0
"Oct 26, 2019 12:00 AM",7,2,5,,,,,,,,,,0,0,0,0,,,,4,4,0,1,5,0,0,0,2,1,0,0,0,0,0,0,0
"Oct 26, 2019 1:00 AM",7,1,6,,,,,,,,,,1,1,0,1,,,,3,2,1,0,2,2,2,0,1,1,0,0,0,0,0,0,0
"Oct 26, 2019 2:00 AM",1,0,1,,,,,,,,,,0,0,0,2,,,,3,3,0,0,3,1,1,0,0,0,1,0,0,0,0,0,0
"Oct 26, 2019 3:00 AM",4,2,2,,,,,,,,,,0,0,0,2,,,,3,3,0,0,0,0,0,0,1,0,1,0,0,0,0,0,0
"Oct 26, 2019 4:00 AM",2,1,1,,,,,,,,,,0,0,0,0,,,,0,0,0,1,1,2,0,2,0,0,0,0,0,0,0,0,0
"Oct 26, 2019 5:00 AM",1,1,0,,,,,,,,,,0,0,0,1,,,,2,2,0,0,0,0,0,0,2,0,0,0,0,0,0,0,0
"Oct 26, 2019 6:00 AM",10,8,2,,,,,,,,,,1,1,0,0,,,,2,2,0,4,4,3,2,1,4,0,0,0,0,0,0,0,0
"Oct 26, 2019 7:00 AM",9,4,5,,,,,,,,,,0,0,0,2,,,,3,3,0,6,15,1,0,1,19,0,1,0,0,0,0,0,0
"Oct 26, 2019 8:00 AM",32,11,21,,,,,,,,,,6,4,2,2,,,,3,3,0,6,13,1,1,0,19,2,0,0,0,0,0,0,0
"Oct 26, 2019 9:00 AM",50,36,14,,,,,,,,,,6,2,4,4,,,,2,1,1,8,12,10,3,7,21,0,2,1,1,0,0,0,0
"Oct 26, 2019 10:00 AM",25,22,3,,,,,,,,,,3,1,2,4,,,,5,4,1,14,15,9,4,5,18,2,0,5,3,2,1,1,0
"Oct 26, 2019 11:00 AM",57,40,17,,,,,,,,,,11,4,7,14,,,,21,18,3,17,16,21,8,13,18,2,5,3,1,2,0,0,0
"Oct 26, 2019 12:00 PM",33,16,17,,,,,,,,,,18,9,9,16,,,,17,14,3,13,23,12,4,8,14,2,2,1,0,1,0,0,0
"Oct 26, 2019 1:00 PM",44,25,19,,,,,,,,,,22,10,12,14,,,,20,17,3,14,18,23,6,17,22,1,1,5,3,2,3,0,3
"Oct 26, 2019 2:00 PM",53,32,21,,,,,,,,,,32,19,13,13,,,,14,12,2,23,23,25,10,15,26,3,6,5,4,1,3,0,3
"Oct 26, 2019 3:00 PM",49,26,23,,,,,,,,,,25,17,8,11,,,,21,16,5,9,17,24,6,18,24,4,2,2,1,1,3,2,1
"Oct 26, 2019 4:00 PM",38,17,21,,,,,,,,,,18,13,5,25,,,,16,10,6,22,21,19,7,12,41,6,0,4,2,2,1,1,0
"Oct 26, 2019 5:00 PM",50,19,31,,,,,,,,,,15,10,5,8,,,,18,17,1,14,18,31,12,19,25,2,1,3,2,1,5,3,2
"Oct 26, 2019 6:00 PM",52,17,35,,,,,,,,,,8,6,2,8,,,,15,15,0,5,17,21,15,6,17,0,2,0,0,0,0,0,0
"Oct 26, 2019 7:00 PM",25,5,20,,,,,,,,,,5,5,0,5,,,,9,7,2,6,11,4,1,3,9,0,0,2,1,1,1,1,0
"Oct 26, 2019 8:00 PM",22,13,9,,,,,,,,,,3,2,1,3,,,,3,3,0,2,4,4,3,1,9,2,1,1,0,1,1,1,0
"Oct 26, 2019 9:00 PM",11,4,7,,,,,,,,,,2,1,1,6,,,,3,3,0,5,2,3,1,2,8,1,2,1,1,0,0,0,0
"Oct 26, 2019 10:00 PM",9,6,3,,,,,,,,,,0,0,0,2,,,,2,1,1,2,6,2,2,0,9,0,0,0,0,0,0,0,0
"Oct 26, 2019 11:00 PM",14,7,7,,,,,,,,,,1,0,1,2,,,,6,6,0,2,5,5,1,4,5,1,0,0,0,0,0,0,0
"Oct 27, 2019 12:00 AM",5,0,5,,,,,,,,,,0,0,0,2,,,,2,2,0,1,4,1,1,0,2,0,0,0,0,0,1,1,0
"Oct 27, 2019 1:00 AM",12,2,10,,,,,,,,,,0,0,0,1,,,,1,1,0,2,1,1,0,1,5,0,0,0,0,0,0,0,0
"Oct 27, 2019 2:00 AM",2,0,2,,,,,,,,,,0,0,0,0,,,,1,1,0,1,1,1,1,0,1,0,2,0,0,0,0,0,0
"Oct 27, 2019 3:00 AM",0,0,0,,,,,,,,,,0,0,0,1,,,,1,1,0,1,0,0,0,0,0,0,0,1,1,0,0,0,0
"Oct 27, 2019 4:00 AM",5,2,3,,,,,,,,,,0,0,0,0,,,,1,1,0,1,1,0,0,0,1,0,0,1,0,1,0,0,0
"Oct 27, 2019 5:00 AM",1,0,1,,,,,,,,,,2,0,2,0,,,,1,1,0,0,1,0,0,0,2,0,0,0,0,0,0,0,0
"Oct 27, 2019 6:00 AM",9,5,4,,,,,,,,,,0,0,0,1,,,,6,5,1,3,11,2,1,1,7,1,0,0,0,0,0,0,0
"Oct 27, 2019 7:00 AM",23,15,8,,,,,,,,,,1,1,0,1,,,,8,4,4,11,11,4,1,3,19,0,1,1,1,0,3,0,3
"Oct 27, 2019 8:00 AM",34,25,9,,,,,,,,,,5,3,2,8,,,,6,2,4,8,15,17,10,7,20,1,8,2,2,0,0,0,0
"Oct 27, 2019 9:00 AM",43,23,20,,,,,,,,,,4,2,2,1,,,,17,10,7,18,13,22,9,13,25,0,9,2,1,1,1,0,1
"Oct 27, 2019 10:00 AM",22,8,14,,,,,,,,,,14,0,14,9,,,,23,13,10,22,20,20,11,9,30,1,3,1,1,0,0,0,0
"Oct 27, 2019 11:00 AM",31,28,3,,,,,,,,,,33,20,13,13,,,,38,14,24,5,25,39,13,26,41,13,3,8,6,2,0,0,0
"Oct 27, 2019 12:00 PM",40,29,11,,,,,,,,,,27,21,6,17,,,,53,23,30,4,27,61,16,45,39,5,2,6,5,1,2,0,2
"Oct 27, 2019 1:00 PM",40,20,20,,,,,,,,,,42,27,15,17,,,,44,27,17,7,36,46,15,31,45,13,4,5,0,5,1,0,1
"Oct 27, 2019 2:00 PM",47,36,11,,,,,,,,,,26,10,16,15,,,,28,16,12,14,38,42,19,23,24,3,5,3,3,0,0,0,0
"Oct 27, 2019 3:00 PM",56,41,15,,,,,,,,,,34,29,5,23,,,,33,24,9,21,31,33,18,15,25,3,7,4,1,3,0,0,0
"Oct 27, 2019 4:00 PM",67,30,37,,,,,,,,,,24,13,11,13,,,,19,18,1,24,12,50,38,12,34,2,0,0,0,0,0,0,0
"Oct 27, 2019 5:00 PM",47,13,34,,,,,,,,,,4,3,1,9,,,,19,16,3,19,20,9,6,3,30,5,0,0,0,0,1,1,0
"Oct 27, 2019 6:00 PM",38,12,26,,,,,,,,,,4,4,0,8,,,,16,14,2,3,12,10,1,9,23,0,0,0,0,0,0,0,0
"Oct 27, 2019 7:00 PM",26,12,14,,,,,,,,,,2,2,0,1,,,,16,16,0,3,7,2,2,0,12,0,0,1,0,1,0,0,0
"Oct 27, 2019 8:00 PM",27,6,21,,,,,,,,,,6,3,3,0,,,,4,4,0,5,13,2,1,1,15,1,0,2,1,1,2,2,0
"Oct 27, 2019 9:00 PM",23,12,11,,,,,,,,,,3,2,1,2,,,,5,5,0,4,5,1,1,0,3,0,0,0,0,0,0,0,0
"Oct 27, 2019 10:00 PM",8,2,6,,,,,,,,,,0,0,0,2,,,,5,3,2,7,8,2,1,1,10,0,0,0,0,0,0,0,0
"Oct 27, 2019 11:00 PM",11,6,5,,,,,,,,,,3,2,1,3,,,,6,5,1,4,5,1,1,0,3,0,1,0,0,0,0,0,0
"Oct 28, 2019 12:00 AM",6,4,2,,,,,,,,,,1,0,1,0,,,,3,3,0,0,3,0,0,0,3,0,0,0,0,0,0,0,0
"Oct 28, 2019 1:00 AM",1,0,1,,,,,,,,,,2,1,1,0,,,,1,1,0,2,3,0,0,0,1,0,1,0,0,0,0,0,0
"Oct 28, 2019 2:00 AM",6,1,5,,,,,,,,,,1,0,1,1,,,,1,1,0,0,2,0,0,0,0,0,0,0,0,0,0,0,0
"Oct 28, 2019 3:00 AM",5,0,5,,,,,,,,,,0,0,0,1,,,,5,5,0,1,1,1,1,0,1,0,0,1,1,0,0,0,0
"Oct 28, 2019 4:00 AM",0,0,0,,,,,,,,,,0,0,0,0,,,,1,1,0,0,1,1,0,1,0,0,0,0,0,0,0,0,0
"Oct 28, 2019 5:00 AM",1,0,1,,,,,,,,,,0,0,0,2,,,,0,0,0,0,0,0,0,0,6,0,0,0,0,0,0,0,0
"Oct 28, 2019 6:00 AM",10,3,7,,,,,,,,,,0,0,0,0,,,,2,2,0,2,6,3,3,0,7,2,0,1,1,0,1,0,1
"Oct 28, 2019 7:00 AM",31,17,14,,,,,,,,,,5,1,4,2,,,,4,3,1,9,9,3,0,3,22,0,0,4,2,2,2,0,2
"Oct 28, 2019 8:00 AM",25,12,13,,,,,,,,,,4,3,1,1,,,,6,6,0,17,7,5,2,3,17,2,1,1,0,1,0,0,0
"Oct 28, 2019 9:00 AM",38,29,9,,,,,,,,,,7,3,4,13,,,,11,8,3,13,18,22,9,13,27,1,3,2,0,2,1,1,0
"Oct 28, 2019 10:00 AM",42,25,17,,,,,,,,,,17,6,11,13,,,,6,6,0,18,21,15,5,10,30,3,12,7,1,6,2,1,1
"Oct 28, 2019 11:00 AM",52,30,22,,,,,,,,,,14,8,6,10,,,,13,9,4,14,32,28,16,12,28,7,11,6,3,3,0,0,0
"Oct 28, 2019 12:00 PM",49,26,23,,,,,,,,,,35,26,9,4,,,,11,11,0,15,20,26,13,13,22,2,4,1,1,0,1,0,1
"Oct 28, 2019 1:00 PM",64,29,35,,,,,,,,,,23,15,8,29,,,,19,11,8,14,19,19,14,5,18,18,3,13,9,4,0,0,0
"Oct 28, 2019 2:00 PM",36,17,19,,,,,,,,,,13,6,7,9,,,,17,14,3,11,25,30,9,21,24,4,0,3,2,1,1,1,0
"Oct 28, 2019 3:00 PM",46,20,26,,,,,,,,,,23,14,9,12,,,,15,13,2,19,15,27,14,13,18,10,0,3,3,0,1,1,0
"Oct 28, 2019 4:00 PM",55,24,31,,,,,,,,,,19,15,4,2,,,,21,18,3,12,19,13,11,2,12,0,2,5,2,3,1,0,1
"Oct 28, 2019 5:00 PM",53,21,32,,,,,,,,,,6,5,1,10,,,,25,21,4,10,12,10,6,4,19,3,1,0,0,0,0,0,0
"Oct 28, 2019 6:00 PM",41,12,29,,,,,,,,,,6,4,2,2,,,,18,16,2,8,9,3,1,2,7,1,0,0,0,0,2,2,0
"Oct 28, 2019 7:00 PM",27,10,17,,,,,,,,,,2,1,1,7,,,,9,8,1,7,12,4,1,3,4,0,0,0,0,0,0,0,0
"Oct 28, 2019 8:00 PM",18,10,8,,,,,,,,,,1,1,0,5,,,,6,6,0,5,6,2,1,1,7,0,1,0,0,0,1,1,0
"Oct 28, 2019 9:00 PM",14,7,7,,,,,,,,,,0,0,0,5,,,,4,4,0,7,8,10,4,6,4,1,0,0,0,0,0,0,0
"Oct 28, 2019 10:00 PM",15,4,11,,,,,,,,,,0,0,0,0,,,,7,7,0,3,4,0,0,0,7,0,0,2,2,0,0,0,0
"Oct 28, 2019 11:00 PM",11,4,7,,,,,,,,,,0,0,0,2,,,,1,1,0,0,3,0,0,0,0,0,0,0,0,0,0,0,0
"Oct 29, 2019 12:00 AM",6,2,4,,,,,,,,,,0,0,0,0,,,,0,0,0,0,1,1,0,1,2,0,0,0,0,0,0,0,0
"Oct 29, 2019 1:00 AM",1,0,1,,,,,,,,,,0,0,0,0,,,,1,1,0,0,1,0,0,0,0,0,1,0,0,0,0,0,0
"Oct 29, 2019 2:00 AM",2,1,1,,,,,,,,,,1,0,1,0,,,,2,2,0,0,1,1,0,1,1,0,0,0,0,0,0,0,0
"Oct 29, 2019 3:00 AM",3,1,2,,,,,,,,,,0,0,0,0,,,,4,4,0,0,0,1,0,1,0,0,0,0,0,0,0,0,0
"Oct 29, 2019 4:00 AM",4,1,3,,,,,,,,,,0,0,0,3,,,,4,4,0,0,0,0,0,0,0,0,0,0,0,0,0,0,0
"Oct 29, 2019 5:00 AM",7,7,0,,,,,,,,,,0,0,0,3,,,,6,4,2,4,3,0,0,0,8,2,0,0,0,0,0,0,0
"Oct 29, 2019 6:00 AM",54,38,16,,,,,,,,,,2,0,2,1,,,,14,9,5,31,15,4,0,4,48,2,2,1,1,0,0,0,0
"Oct 29, 2019 7:00 AM",194,153,41,,,,,,,,,,21,7,14,17,,,,30,22,8,135,44,33,23,10,160,2,4,6,5,1,4,0,4
"Oct 29, 2019 8:00 AM",375,315,60,,,,,,,,,,17,3,14,30,,,,49,28,21,296,67,88,68,20,279,5,5,4,3,1,1,0,1
"Oct 29, 2019 9:00 AM",198,177,21,,,,,,,,,,13,4,9,11,,,,35,25,10,134,18,32,21,11,92,6,6,4,3,1,0,0,0
"Oct 29, 2019 10:00 AM",88,71,17,,,,,,,,,,10,3,7,11,,,,16,11,5,42,12,6,6,0,17,3,6,2,1,1,1,1,0
"Oct 29, 2019 11:00 AM",43,25,18,,,,,,,,,,16,8,8,11,,,,25,14,11,28,19,6,4,2,17,1,3,0,0,0,0,0,0
"Oct 29, 2019 12:00 PM",58,32,26,,,,,,,,,,8,5,3,16,,,,25,16,9,23,12,13,5,8,22,4,3,4,4,0,5,2,3
"Oct 29, 2019 1:00 PM",94,47,47,,,,,,,,,,19,9,10,7,,,,31,23,8,25,20,11,7,4,20,3,1,4,1,3,3,3,0
"Oct 29, 2019 2:00 PM",97,39,58,,,,,,,,,,13,10,3,8,,,,35,31,4,18,13,14,6,8,15,5,5,3,3,0,2,0,2
"Oct 29, 2019 3:00 PM",86,26,60,,,,,,,,,,14,7,7,19,,,,38,35,3,17,22,13,6,7,16,4,0,3,3,0,1,0,1
"Oct 29, 2019 4:00 PM",142,29,113,,,,,,,,,,12,8,4,12,,,,0,0,0,18,88,33,7,26,32,2,1,4,1,3,1,0,1
"Oct 29, 2019 5:00 PM",322,48,274,,,,,,,,,,23,18,5,15,,,,0,0,0,47,165,67,11,56,81,5,2,5,3,2,5,3,2
"Oct 29, 2019 6:00 PM",332,60,272,,,,,,,,,,20,15,5,17,,,,0,0,0,30,185,73,5,68,45,6,5,3,2,1,1,1,0
"Oct 29, 2019 7:00 PM",176,32,144,,,,,,,,,,11,9,2,13,,,,0,0,0,20,69,27,2,25,21,6,0,6,2,4,1,1,0
"Oct 29, 2019 8:00 PM",101,8,93,,,,,,,,,,2,1,1,5,,,,0,0,0,14,28,15,2,13,19,4,1,3,2,1,1,0,1
"Oct 29, 2019 9:00 PM",66,7,59,,,,,,,,,,6,5,1,4,,,,0,0,0,13,22,6,0,6,12,0,1,1,0,1,1,1,0
"Oct 29, 2019 10:00 PM",43,7,36,,,,,,,,,,1,0,1,4,,,,0,0,0,3,17,6,1,5,5,0,2,1,0,1,1,0,1
"Oct 29, 2019 11:00 PM",19,7,12,,,,,,,,,,1,0,1,0,,,,0,0,0,4,5,4,3,1,3,0,0,1,0,1,0,0,0
"Oct 30, 2019 12:00 AM",4,0,4,,,,,,,,,,0,0,0,1,,,,2,2,0,0,7,4,1,3,0,0,0,0,0,0,0,0,0
"Oct 30, 2019 1:00 AM",5,0,5,,,,,,,,,,0,0,0,0,,,,3,3,0,0,0,0,0,0,1,1,0,0,0,0,0,0,0
"Oct 30, 2019 2:00 AM",3,1,2,,,,,,,,,,0,0,0,0,,,,0,0,0,0,2,1,0,1,0,0,1,0,0,0,0,0,0
"Oct 30, 2019 3:00 AM",4,2,2,,,,,,,,,,0,0,0,2,,,,0,0,0,0,1,0,0,0,2,0,0,2,1,1,1,1,0
"Oct 30, 2019 4:00 AM",2,0,2,,,,,,,,,,0,0,0,1,,,,1,1,0,0,0,0,0,0,0,0,0,0,0,0,0,0,0
"Oct 30, 2019 5:00 AM",6,5,1,,,,,,,,,,0,0,0,2,,,,2,2,0,10,4,0,0,0,8,4,0,0,0,0,0,0,0
"Oct 30, 2019 6:00 AM",57,44,13,,,,,,,,,,3,0,3,3,,,,11,8,3,31,20,6,2,4,50,0,2,2,1,1,0,0,0
"Oct 30, 2019 7:00 AM",205,167,38,,,,,,,,,,9,1,8,7,,,,36,26,10,144,41,25,19,6,141,3,6,7,5,2,1,0,1
"Oct 30, 2019 8:00 AM",439,376,63,,,,,,,,,,16,3,13,22,,,,60,34,26,262,72,73,56,17,275,6,3,3,2,1,0,0,0
"Oct 30, 2019 9:00 AM",208,184,24,,,,,,,,,,9,4,5,4,,,,36,18,18,117,28,42,23,19,85,7,6,9,1,8,1,1,0
"Oct 30, 2019 10:00 AM",94,78,16,,,,,,,,,,10,2,8,6,,,,25,14,11,64,15,8,5,3,40,2,5,5,2,3,2,2,0
"Oct 30, 2019 11:00 AM",51,38,13,,,,,,,,,,10,6,4,12,,,,17,9,8,29,13,10,4,6,22,7,1,2,1,1,0,0,0
"Oct 30, 2019 12:00 PM",70,38,32,,,,,,,,,,10,8,2,15,,,,29,22,7,19,13,20,8,12,28,4,1,7,7,0,0,0,0
"Oct 30, 2019 1:00 PM",80,43,37,,,,,,,,,,12,4,8,6,,,,41,34,7,20,17,24,11,13,14,4,1,6,4,2,0,0,0
"Oct 30, 2019 2:00 PM",77,33,44,,,,,,,,,,14,2,12,5,,,,43,39,4,17,21,8,3,5,17,3,2,3,0,3,0,0,0
"Oct 30, 2019 3:00 PM",91,26,65,,,,,,,,,,23,15,8,17,,,,48,43,5,14,25,20,4,16,20,4,0,6,4,2,0,0,0
"Oct 30, 2019 4:00 PM",146,31,115,,,,,,,,,,8,6,2,11,,,,87,84,3,24,67,25,8,17,46,3,2,2,1,1,1,1,0
"Oct 30, 2019 5:00 PM",320,58,262,,,,,,,,,,20,16,4,29,,,,187,179,8,43,182,60,11,49,70,5,4,8,3,5,0,0,0
"Oct 30, 2019 6:00 PM",315,52,263,,,,,,,,,,12,8,4,15,,,,218,211,7,30,179,68,9,59,42,3,2,3,3,0,0,0,0
"Oct 30, 2019 7:00 PM",177,33,144,,,,,,,,,,9,6,3,11,,,,113,106,7,12,68,20,2,18,23,1,1,1,1,0,1,0,1
"Oct 30, 2019 8:00 PM",113,21,92,,,,,,,,,,5,2,3,2,,,,65,62,3,11,29,15,2,13,20,2,0,2,0,2,1,1,0
"Oct 30, 2019 9:00 PM",82,12,70,,,,,,,,,,5,4,1,3,,,,38,35,3,7,19,5,1,4,7,1,0,0,0,0,0,0,0
"Oct 30, 2019 10:00 PM",50,9,41,,,,,,,,,,1,0,1,4,,,,27,26,1,1,19,5,2,3,7,0,0,2,1,1,1,0,1
"Oct 30, 2019 11:00 PM",22,8,14,,,,,,,,,,0,0,0,4,,,,17,17,0,2,4,0,0,0,7,0,0,1,0,1,0,0,0
"Oct 31, 2019 12:00 AM",8,1,7,,,,,,,,,,1,0,1,1,,,,7,7,0,3,4,4,2,2,2,0,0,0,0,0,0,0,0
"Oct 31, 2019 1:00 AM",6,1,5,,,,,,,,,,0,0,0,0,,,,3,3,0,0,1,1,0,1,0,0,0,0,0,0,0,0,0
"Oct 31, 2019 2:00 AM",5,1,4,,,,,,,,,,1,0,1,2,,,,0,0,0,1,4,0,0,0,0,0,0,0,0,0,0,0,0
"Oct 31, 2019 3:00 AM",4,2,2,,,,,,,,,,0,0,0,0,,,,1,1,0,0,0,0,0,0,0,1,0,0,0,0,0,0,0
"Oct 31, 2019 4:00 AM",4,2,2,,,,,,,,,,0,0,0,2,,,,1,1,0,0,1,1,0,1,2,0,0,0,0,0,0,0,0
"Oct 31, 2019 5:00 AM",10,6,4,,,,,,,,,,0,0,0,1,,,,2,1,1,6,5,1,0,1,6,3,0,1,0,1,0,0,0
"Oct 31, 2019 6:00 AM",54,48,6,,,,,,,,,,2,0,2,2,,,,13,9,4,25,15,4,3,1,47,3,0,1,1,0,0,0,0
"Oct 31, 2019 7:00 AM",184,153,31,,,,,,,,,,11,3,8,5,,,,27,21,6,110,26,10,6,4,163,1,4,0,0,0,0,0,0
"Oct 31, 2019 8:00 AM",360,306,54,,,,,,,,,,12,2,10,27,,,,54,35,19,234,40,73,60,13,222,2,5,3,0,3,0,0,0
"Oct 31, 2019 9:00 AM",192,172,20,,,,,,,,,,13,5,8,5,,,,30,16,14,96,20,33,19,14,75,2,2,2,1,1,2,0,2
"Oct 31, 2019 10:00 AM",104,79,25,,,,,,,,,,8,1,7,8,,,,22,12,10,52,6,7,4,3,26,1,1,2,0,2,4,4,0
"Oct 31, 2019 11:00 AM",71,49,22,,,,,,,,,,6,5,1,3,,,,16,11,5,19,16,6,3,3,21,1,0,5,2,3,0,0,0
"Oct 31, 2019 12:00 PM",76,38,38,,,,,,,,,,16,7,9,12,,,,23,17,6,17,11,10,3,7,18,1,1,4,2,2,0,0,0
"Oct 31, 2019 1:00 PM",82,40,42,,,,,,,,,,6,1,5,9,,,,29,24,5,32,13,9,5,4,23,1,1,3,3,0,2,1,1
"Oct 31, 2019 2:00 PM",74,25,49,,,,,,,,,,10,5,5,9,,,,30,26,4,13,32,8,1,7,18,2,1,5,3,2,3,2,1
"Oct 31, 2019 3:00 PM",72,22,50,,,,,,,,,,10,9,1,13,,,,48,43,5,16,30,20,0,20,13,0,0,4,2,2,0,0,0
"Oct 31, 2019 4:00 PM",190,35,155,,,,,,,,,,6,5,1,13,,,,75,69,6,17,79,33,4,29,24,2,2,3,1,2,5,5,0
"Oct 31, 2019 5:00 PM",295,47,248,,,,,,,,,,13,11,2,20,,,,153,147,6,39,152,70,8,62,56,7,1,7,5,2,2,1,1
"Oct 31, 2019 6:00 PM",210,42,168,,,,,,,,,,15,10,5,12,,,,172,166,6,23,116,48,7,41,35,2,2,0,0,0,0,0,0
"Oct 31, 2019 7:00 PM",119,19,100,,,,,,,,,,3,1,2,4,,,,92,87,5,9,56,7,0,7,13,3,0,2,0,2,1,1,0
"Oct 31, 2019 8:00 PM",66,9,57,,,,,,,,,,4,3,1,2,,,,51,48,3,7,23,10,4,6,14,1,0,2,0,2,0,0,0
"Oct 31, 2019 9:00 PM",54,6,48,,,,,,,,,,0,0,0,3,,,,34,31,3,3,5,3,0,3,6,1,0,1,0,1,1,1,0
"Oct 31, 2019 10:00 PM",33,10,23,,,,,,,,,,0,0,0,1,,,,27,25,2,1,10,3,2,1,8,0,0,1,0,1,0,0,0
"Oct 31, 2019 11:00 PM",23,7,16,,,,,,,,,,0,0,0,1,,,,14,14,0,5,6,2,1,1,4,0,0,1,0,1,0,0,0
"Nov 1, 2019 12:00 AM",6,0,6,,,,,,,,,,2,1,1,0,,,,8,8,0,0,4,3,1,2,3,0,0,0,0,0,0,0,0
"Nov 1, 2019 1:00 AM",7,3,4,,,,,,,,,,0,0,0,0,,,,1,1,0,1,0,3,1,2,0,0,1,0,0,0,1,1,0
"Nov 1, 2019 2:00 AM",8,2,6,,,,,,,,,,1,1,0,1,,,,0,0,0,0,1,1,0,1,1,0,0,0,0,0,0,0,0
"Nov 1, 2019 3:00 AM",2,1,1,,,,,,,,,,0,0,0,0,,,,0,0,0,1,2,0,0,0,5,0,0,0,0,0,0,0,0
"Nov 1, 2019 4:00 AM",7,2,5,,,,,,,,,,0,0,0,1,,,,0,0,0,0,0,0,0,0,2,0,0,0,0,0,0,0,0
"Nov 1, 2019 5:00 AM",8,6,2,,,,,,,,,,0,0,0,1,,,,2,2,0,7,3,1,1,0,7,3,0,0,0,0,0,0,0
"Nov 1, 2019 6:00 AM",46,39,7,,,,,,,,,,3,1,2,3,,,,7,5,2,25,15,5,4,1,33,0,0,1,0,1,0,0,0
"Nov 1, 2019 7:00 AM",133,111,22,,,,,,,,,,7,3,4,10,,,,20,14,6,83,20,21,15,6,114,0,4,3,3,0,2,0,2
"Nov 1, 2019 8:00 AM",275,234,41,,,,,,,,,,20,5,15,17,,,,45,29,16,188,43,60,39,21,186,3,6,2,0,2,3,0,3
"Nov 1, 2019 9:00 AM",171,145,26,,,,,,,,,,13,3,10,7,,,,26,13,13,74,20,38,20,18,78,5,2,6,4,2,1,1,0
"Nov 1, 2019 10:00 AM",71,57,14,,,,,,,,,,10,6,4,3,,,,15,6,9,54,18,13,9,4,24,2,6,5,2,3,1,1,0
"Nov 1, 2019 11:00 AM",76,45,31,,,,,,,,,,8,4,4,8,,,,16,11,5,28,16,17,5,12,23,3,0,1,1,0,0,0,0
"Nov 1, 2019 12:00 PM",69,36,33,,,,,,,,,,17,10,7,5,,,,24,20,4,24,19,19,5,14,16,0,2,8,4,4,2,1,1
"Nov 1, 2019 1:00 PM",87,30,57,,,,,,,,,,11,7,4,17,,,,28,22,6,29,13,28,8,20,21,4,2,3,3,0,0,0,0
"Nov 1, 2019 2:00 PM",79,43,36,,,,,,,,,,14,7,7,22,,,,30,27,3,24,22,25,6,19,15,2,0,5,3,2,1,1,0
"Nov 1, 2019 3:00 PM",90,22,68,,,,,,,,,,8,5,3,10,,,,50,45,5,16,27,26,13,13,18,2,1,0,0,0,1,1,0
"Nov 1, 2019 4:00 PM",142,28,114,,,,,,,,,,10,6,4,4,,,,68,65,3,13,59,31,6,25,23,5,0,1,1,0,1,1,0
"Nov 1, 2019 5:00 PM",255,35,220,,,,,,,,,,11,10,1,12,,,,130,125,5,27,118,44,11,33,34,3,1,3,1,2,1,1,0
"Nov 1, 2019 6:00 PM",203,41,162,,,,,,,,,,9,7,2,17,,,,106,104,2,13,91,48,8,40,38,1,1,2,2,0,0,0,0
"Nov 1, 2019 7:00 PM",76,15,61,,,,,,,,,,7,7,0,8,,,,53,48,5,9,40,13,2,11,14,0,0,0,0,0,1,1,0
"Nov 1, 2019 8:00 PM",54,8,46,,,,,,,,,,7,4,3,1,,,,26,25,1,8,17,5,1,4,10,2,0,1,1,0,1,1,0
"Nov 1, 2019 9:00 PM",41,9,32,,,,,,,,,,2,2,0,5,,,,14,13,1,4,14,7,0,7,7,0,0,3,1,2,0,0,0
"Nov 1, 2019 10:00 PM",28,5,23,,,,,,,,,,3,2,1,2,,,,15,15,0,5,10,1,0,1,7,0,0,1,0,1,2,2,0
"Nov 1, 2019 11:00 PM",17,7,10,,,,,,,,,,1,1,0,0,,,,7,7,0,1,4,0,0,0,3,0,0,1,1,0,0,0,0
"Nov 2, 2019 12:00 AM",13,0,13,,,,,,,,,,2,1,1,2,,,,6,6,0,1,5,1,0,1,1,0,0,0,0,0,0,0,0
"Nov 2, 2019 1:00 AM",7,0,7,,,,,,,,,,0,0,0,1,,,,4,3,1,2,2,4,1,3,3,0,0,0,0,0,0,0,0
"Nov 2, 2019 2:00 AM",5,1,4,,,,,,,,,,0,0,0,0,,,,4,4,0,0,0,2,1,1,2,1,1,0,0,0,0,0,0
"Nov 2, 2019 3:00 AM",6,2,4,,,,,,,,,,0,0,0,0,,,,2,2,0,0,1,0,0,0,1,0,1,0,0,0,0,0,0
"Nov 2, 2019 4:00 AM",3,0,3,,,,,,,,,,0,0,0,0,,,,1,1,0,1,0,0,0,0,3,0,0,0,0,0,0,0,0
"Nov 2, 2019 5:00 AM",3,1,2,,,,,,,,,,0,0,0,1,,,,2,2,0,0,1,0,0,0,0,0,0,0,0,0,0,0,0
"Nov 2, 2019 6:00 AM",9,6,3,,,,,,,,,,1,1,0,0,,,,4,4,0,1,2,1,0,1,7,0,0,0,0,0,1,0,1
"Nov 2, 2019 7:00 AM",14,5,9,,,,,,,,,,1,1,0,2,,,,5,5,0,3,14,4,1,3,11,1,0,1,1,0,1,0,1
"Nov 2, 2019 8:00 AM",34,20,14,,,,,,,,,,7,3,4,2,,,,6,5,1,17,14,1,1,0,20,1,1,1,0,1,1,0,1
"Nov 2, 2019 9:00 AM",44,35,9,,,,,,,,,,3,1,2,7,,,,8,6,2,21,16,12,6,6,16,0,5,2,1,1,0,0,0
"Nov 2, 2019 10:00 AM",47,23,24,,,,,,,,,,5,3,2,5,,,,13,10,3,18,11,7,4,3,11,0,2,3,2,1,6,0,6
"Nov 2, 2019 11:00 AM",63,39,24,,,,,,,,,,16,4,12,14,,,,17,14,3,22,17,16,4,12,18,2,4,1,1,0,2,2,0
"Nov 2, 2019 12:00 PM",68,40,28,,,,,,,,,,24,10,14,15,,,,14,10,4,22,15,23,14,9,18,1,4,3,2,1,4,1,3
"Nov 2, 2019 1:00 PM",47,24,23,,,,,,,,,,12,11,1,16,,,,18,14,4,15,9,12,4,8,12,4,0,3,2,1,0,0,0
"Nov 2, 2019 2:00 PM",38,20,18,,,,,,,,,,6,4,2,2,,,,17,14,3,9,12,4,4,0,5,2,0,1,1,0,0,0,0
"Nov 2, 2019 3:00 PM",38,11,27,,,,,,,,,,2,1,1,5,,,,17,13,4,8,7,3,1,2,6,1,1,4,1,3,1,1,0
"Nov 2, 2019 4:00 PM",28,11,17,,,,,,,,,,3,3,0,3,,,,16,13,3,5,7,7,1,6,9,2,0,0,0,0,1,0,1
"Nov 2, 2019 5:00 PM",43,8,35,,,,,,,,,,8,5,3,7,,,,21,19,2,6,9,8,2,6,16,2,0,1,1,0,1,1,0
"Nov 2, 2019 6:00 PM",21,11,10,,,,,,,,,,5,3,2,3,,,,13,13,0,7,7,2,2,0,9,1,1,1,1,0,1,1,0
"Nov 2, 2019 7:00 PM",22,6,16,,,,,,,,,,0,0,0,2,,,,8,7,1,3,3,1,0,1,6,0,0,1,1,0,0,0,0
"Nov 2, 2019 8:00 PM",9,2,7,,,,,,,,,,1,1,0,2,,,,5,5,0,1,3,0,0,0,2,1,0,0,0,0,1,1,0
"Nov 2, 2019 9:00 PM",3,0,3,,,,,,,,,,3,3,0,1,,,,4,4,0,2,2,0,0,0,2,0,0,1,1,0,1,0,1
"Nov 2, 2019 10:00 PM",4,3,1,,,,,,,,,,1,1,0,0,,,,5,4,1,2,2,0,0,0,1,0,0,2,1,1,0,0,0
"Nov 2, 2019 11:00 PM",10,3,7,,,,,,,,,,1,1,0,0,,,,6,5,1,1,3,1,1,0,0,0,0,1,0,1,0,0,0
"Nov 3, 2019 12:00 AM",5,2,3,,,,,,,,,,0,0,0,0,,,,3,3,0,1,5,0,0,0,0,1,0,0,0,0,0,0,0
"Nov 3, 2019 1:00 AM",7,1,6,,,,,,,,,,1,1,0,0,,,,4,4,0,0,1,1,1,0,1,0,1,0,0,0,0,0,0
"Nov 3, 2019 2:00 AM",4,3,1,,,,,,,,,,0,0,0,0,,,,2,2,0,2,0,4,1,3,0,1,1,0,0,0,0,0,0
"Nov 3, 2019 3:00 AM",1,0,1,,,,,,,,,,0,0,0,0,,,,2,2,0,0,0,0,0,0,0,0,0,0,0,0,1,1,0
"Nov 3, 2019 4:00 AM",1,1,0,,,,,,,,,,0,0,0,0,,,,0,0,0,0,1,0,0,0,0,0,0,0,0,0,0,0,0
"Nov 3, 2019 5:00 AM",2,1,1,,,,,,,,,,2,1,1,0,,,,1,1,0,0,0,2,0,2,0,0,0,1,1,0,1,0,1
"Nov 3, 2019 6:00 AM",10,2,8,,,,,,,,,,0,0,0,0,,,,3,3,0,1,5,0,0,0,0,2,0,0,0,0,0,0,0
"Nov 3, 2019 7:00 AM",9,5,4,,,,,,,,,,4,3,1,0,,,,9,5,4,3,12,5,2,3,0,0,1,0,0,0,1,0,1
"Nov 3, 2019 8:00 AM",26,9,17,,,,,,,,,,13,4,9,6,,,,6,3,3,6,24,9,3,6,0,2,4,3,1,2,0,0,0
"Nov 3, 2019 9:00 AM",55,37,18,,,,,,,,,,5,2,3,6,,,,12,7,5,13,32,15,9,6,2,6,11,3,2,1,0,0,0
"Nov 3, 2019 10:00 AM",46,30,16,,,,,,,,,,18,5,13,9,,,,14,8,6,21,27,18,8,10,12,7,5,3,2,1,0,0,0
"Nov 3, 2019 11:00 AM",72,34,38,,,,,,,,,,35,24,11,19,,,,19,10,9,21,39,40,21,19,29,2,7,3,2,1,1,0,1
"Nov 3, 2019 12:00 PM",60,32,28,,,,,,,,,,38,27,11,23,,,,24,14,10,27,39,29,10,19,23,7,4,2,1,1,5,3,2
"Nov 3, 2019 1:00 PM",61,35,26,,,,,,,,,,40,24,16,22,,,,30,23,7,18,23,39,13,26,40,7,2,2,1,1,1,0,1
"Nov 3, 2019 2:00 PM",61,36,25,,,,,,,,,,17,12,5,14,,,,21,15,6,16,33,29,16,13,23,2,2,4,2,2,0,0,0
"Nov 3, 2019 3:00 PM",41,22,19,,,,,,,,,,34,18,16,5,,,,21,16,5,19,26,20,9,11,27,7,6,6,3,3,1,0,1
"Nov 3, 2019 4:00 PM",54,24,30,,,,,,,,,,37,24,13,11,,,,18,16,2,19,13,22,14,8,30,5,4,6,2,4,0,0,0
"Nov 3, 2019 5:00 PM",40,17,23,,,,,,,,,,24,13,11,6,,,,23,19,4,10,11,15,8,7,19,1,1,4,3,1,0,0,0
"Nov 3, 2019 6:00 PM",50,10,40,,,,,,,,,,14,6,8,4,,,,17,15,2,10,12,7,2,5,16,4,0,0,0,0,0,0,0
"Nov 3, 2019 7:00 PM",31,10,21,,,,,,,,,,6,4,2,4,,,,15,13,2,5,6,3,2,1,14,1,0,0,0,0,0,0,0
"Nov 3, 2019 8:00 PM",20,4,16,,,,,,,,,,4,3,1,1,,,,8,7,1,2,4,2,1,1,4,1,0,1,0,1,0,0,0
"Nov 3, 2019 9:00 PM",25,9,16,,,,,,,,,,1,1,0,0,,,,5,5,0,6,1,4,2,2,7,1,0,0,0,0,1,1,0
"Nov 3, 2019 10:00 PM",11,3,8,,,,,,,,,,2,2,0,0,,,,6,4,2,3,8,4,3,1,4,1,0,0,0,0,0,0,0
"Nov 3, 2019 11:00 PM",11,3,8,,,,,,,,,,1,0,1,0,,,,5,4,1,1,3,0,0,0,1,0,0,0,0,0,0,0,0
"Nov 4, 2019 12:00 AM",5,2,3,,,,,,,,,,0,0,0,0,,,,4,4,0,0,1,2,1,1,1,0,1,0,0,0,0,0,0
"Nov 4, 2019 1:00 AM",2,2,0,,,,,,,,,,0,0,0,0,,,,2,2,0,0,1,0,0,0,0,0,1,0,0,0,0,0,0
"Nov 4, 2019 2:00 AM",2,0,2,,,,,,,,,,0,0,0,0,,,,1,1,0,0,0,0,0,0,0,0,0,0,0,0,0,0,0
"Nov 4, 2019 3:00 AM",0,0,0,,,,,,,,,,0,0,0,0,,,,2,2,0,0,0,0,0,0,0,0,0,0,0,0,0,0,0
"Nov 4, 2019 4:00 AM",1,0,1,,,,,,,,,,0,0,0,0,,,,0,0,0,0,0,0,0,0,2,0,0,0,0,0,0,0,0
"Nov 4, 2019 5:00 AM",6,5,1,,,,,,,,,,0,0,0,0,,,,1,1,0,4,3,0,0,0,14,3,0,0,0,0,0,0,0
"Nov 4, 2019 6:00 AM",45,36,9,,,,,,,,,,2,0,2,3,,,,9,7,2,22,13,8,6,2,47,4,0,2,2,0,1,0,1
"Nov 4, 2019 7:00 AM",177,136,41,,,,,,,,,,7,2,5,13,,,,22,17,5,120,37,24,15,9,148,2,5,6,4,2,1,0,1
"Nov 4, 2019 8:00 AM",408,352,56,,,,,,,,,,33,9,24,20,,,,43,26,17,297,70,77,62,15,298,4,4,9,9,0,1,0,1
"Nov 4, 2019 9:00 AM",253,226,27,,,,,,,,,,12,4,8,9,,,,30,17,13,123,24,42,31,11,80,3,6,4,2,2,1,0,1
"Nov 4, 2019 10:00 AM",58,45,13,,,,,,,,,,8,2,6,3,,,,13,7,6,42,7,3,2,1,22,0,0,1,0,1,1,1,0
"Nov 4, 2019 11:00 AM",45,33,12,,,,,,,,,,4,1,3,7,,,,16,11,5,23,11,4,2,2,12,1,2,2,2,0,0,0,0
"Nov 4, 2019 12:00 PM",51,26,25,,,,,,,,,,7,3,4,4,,,,18,16,2,9,9,8,3,5,5,0,0,3,0,3,0,0,0
"Nov 4, 2019 1:00 PM",44,20,24,,,,,,,,,,6,5,1,3,,,,23,17,6,7,11,4,0,4,10,0,1,2,0,2,0,0,0
"Nov 4, 2019 2:00 PM",39,20,19,,,,,,,,,,3,2,1,3,,,,28,24,4,3,9,3,0,3,7,0,1,2,1,1,2,2,0
"Nov 4, 2019 3:00 PM",55,11,44,,,,,,,,,,3,3,0,3,,,,41,36,5,14,27,4,1,3,3,2,0,4,2,2,0,0,0
"Nov 4, 2019 4:00 PM",123,24,99,,,,,,,,,,2,1,1,11,,,,60,54,6,11,44,19,4,15,10,2,0,4,2,2,1,1,0
"Nov 4, 2019 5:00 PM",284,47,237,,,,,,,,,,8,6,2,14,,,,138,132,6,34,132,37,5,32,17,6,5,2,0,2,4,4,0
"Nov 4, 2019 6:00 PM",276,37,239,,,,,,,,,,14,7,7,14,,,,148,143,5,19,172,53,4,49,9,5,2,3,1,2,2,1,1
"Nov 4, 2019 7:00 PM",143,20,123,,,,,,,,,,2,2,0,4,,,,79,74,5,12,56,24,1,23,2,1,2,1,1,0,1,1,0
"Nov 4, 2019 8:00 PM",79,9,70,,,,,,,,,,5,4,1,3,,,,44,42,2,4,19,5,0,5,3,1,0,1,0,1,0,0,0
"Nov 4, 2019 9:00 PM",58,6,52,,,,,,,,,,1,0,1,0,,,,25,23,2,5,10,2,0,2,1,4,0,0,0,0,0,0,0
"Nov 4, 2019 10:00 PM",24,3,21,,,,,,,,,,2,2,0,0,,,,20,18,2,2,11,1,1,0,0,0,1,0,0,0,0,0,0
"Nov 4, 2019 11:00 PM",12,2,10,,,,,,,,,,0,0,0,3,,,,6,6,0,1,4,1,0,1,0,0,0,0,0,0,0,0,0
"Nov 5, 2019 12:00 AM",7,2,5,,,,,,,,,,0,0,0,0,,,,3,3,0,1,3,1,1,0,0,0,0,0,0,0,0,0,0
"Nov 5, 2019 1:00 AM",1,0,1,,,,,,,,,,0,0,0,0,,,,2,2,0,0,0,1,0,1,0,0,1,0,0,0,0,0,0
"Nov 5, 2019 2:00 AM",7,6,1,,,,,,,,,,0,0,0,0,,,,1,1,0,1,0,0,0,0,0,0,0,0,0,0,0,0,0
"Nov 5, 2019 3:00 AM",0,0,0,,,,,,,,,,0,0,0,0,,,,1,1,0,0,0,0,0,0,0,0,0,0,0,0,0,0,0
"Nov 5, 2019 4:00 AM",3,1,2,,,,,,,,,,0,0,0,0,,,,0,0,0,0,1,0,0,0,0,0,0,0,0,0,0,0,0
"Nov 5, 2019 5:00 AM",2,2,0,,,,,,,,,,0,0,0,1,,,,4,2,2,6,3,1,1,0,0,4,0,0,0,0,0,0,0
"Nov 5, 2019 6:00 AM",50,38,12,,,,,,,,,,1,0,1,4,,,,13,9,4,32,8,4,2,2,4,1,1,1,0,1,0,0,0
"Nov 5, 2019 7:00 AM",214,170,44,,,,,,,,,,8,3,5,13,,,,32,24,8,60,37,21,15,6,54,5,4,5,5,0,1,0,1
"Nov 5, 2019 8:00 AM",492,400,92,,,,,,,,,,36,12,24,29,,,,64,38,26,305,64,104,84,20,265,7,7,8,5,3,2,0,2
"Nov 5, 2019 9:00 AM",263,234,29,,,,,,,,,,19,9,10,9,,,,34,18,16,157,17,48,33,15,109,2,4,5,2,3,2,0,2
"Nov 5, 2019 10:00 AM",103,78,25,,,,,,,,,,6,3,3,7,,,,20,13,7,63,9,11,5,6,24,6,1,7,3,4,1,1,0
"Nov 5, 2019 11:00 AM",76,52,24,,,,,,,,,,4,1,3,11,,,,23,16,7,33,15,10,1,9,29,2,2,3,2,1,0,0,0
"Nov 5, 2019 12:00 PM",81,43,38,,,,,,,,,,13,8,5,7,,,,22,17,5,24,13,12,3,9,17,2,3,2,0,2,0,0,0
"Nov 5, 2019 1:00 PM",97,51,46,,,,,,,,,,11,7,4,7,,,,29,23,6,22,28,18,11,7,21,2,3,0,0,0,1,0,1
"Nov 5, 2019 2:00 PM",80,36,44,,,,,,,,,,16,9,7,3,,,,38,33,5,18,23,10,1,9,14,1,2,6,4,2,2,0,2
"Nov 5, 2019 3:00 PM",100,22,78,,,,,,,,,,12,10,2,15,,,,51,47,4,25,30,10,3,7,29,7,1,8,6,2,0,0,0
"Nov 5, 2019 4:00 PM",179,39,140,,,,,,,,,,8,6,2,15,,,,78,74,4,25,74,30,8,22,32,7,4,7,3,4,4,3,1
"Nov 5, 2019 5:00 PM",357,65,292,,,,,,,,,,7,5,2,22,,,,159,152,7,51,178,59,9,50,54,4,0,2,2,0,1,0,1
"Nov 5, 2019 6:00 PM",321,47,274,,,,,,,,,,15,11,4,26,,,,160,155,5,33,207,74,8,66,55,3,2,3,2,1,1,1,0
"Nov 5, 2019 7:00 PM",196,38,158,,,,,,,,,,14,9,5,6,,,,84,80,4,12,78,38,4,34,25,1,2,4,2,2,0,0,0
"Nov 5, 2019 8:00 PM",156,25,131,,,,,,,,,,2,2,0,10,,,,62,58,4,13,43,14,1,13,14,1,2,2,1,1,0,0,0
"Nov 5, 2019 9:00 PM",90,9,81,,,,,,,,,,4,3,1,3,,,,30,29,1,2,25,14,2,12,13,2,1,3,2,1,1,1,0
"Nov 5, 2019 10:00 PM",61,11,50,,,,,,,,,,4,4,0,2,,,,19,18,1,5,20,5,2,3,7,0,1,0,0,0,0,0,0
"Nov 5, 2019 11:00 PM",18,2,16,,,,,,,,,,0,0,0,3,,,,8,8,0,2,8,2,2,0,4,1,0,2,1,1,3,2,1
"Nov 6, 2019 12:00 AM",10,2,8,,,,,,,,,,0,0,0,0,,,,2,2,0,0,5,1,0,1,2,0,0,1,1,0,1,0,1
"Nov 6, 2019 1:00 AM",2,1,1,,,,,,,,,,0,0,0,0,,,,3,3,0,1,0,0,0,0,0,1,1,0,0,0,0,0,0
"Nov 6, 2019 2:00 AM",9,8,1,,,,,,,,,,0,0,0,0,,,,0,0,0,2,0,1,0,1,0,0,0,0,0,0,0,0,0
"Nov 6, 2019 3:00 AM",0,0,0,,,,,,,,,,0,0,0,1,,,,0,0,0,0,0,0,0,0,0,0,0,0,0,0,0,0,0
"Nov 6, 2019 4:00 AM",4,2,2,,,,,,,,,,0,0,0,0,,,,1,1,0,1,0,1,0,1,0,0,0,0,0,0,0,0,0
"Nov 6, 2019 5:00 AM",5,5,0,,,,,,,,,,0,0,0,1,,,,2,2,0,8,7,0,0,0,11,3,0,0,0,0,0,0,0
"Nov 6, 2019 6:00 AM",61,50,11,,,,,,,,,,2,0,2,4,,,,12,9,3,20,10,8,3,5,50,1,1,1,0,1,0,0,0
"Nov 6, 2019 7:00 AM",211,156,55,,,,,,,,,,8,2,6,15,,,,36,26,10,123,51,31,24,7,164,3,5,5,5,0,1,0,1
"Nov 6, 2019 8:00 AM",462,385,77,,,,,,,,,,23,7,16,32,,,,62,34,28,311,70,97,77,20,321,8,7,11,10,1,5,0,5
"Nov 6, 2019 9:00 AM",290,262,28,,,,,,,,,,19,6,13,6,,,,37,19,18,145,29,41,27,14,104,2,4,9,3,6,0,0,0
"Nov 6, 2019 10:00 AM",88,69,19,,,,,,,,,,7,1,6,11,,,,25,14,11,63,11,19,10,9,36,4,3,5,3,2,1,1,0
"Nov 6, 2019 11:00 AM",61,43,18,,,,,,,,,,7,2,5,7,,,,17,9,8,42,20,10,2,8,20,1,3,4,1,3,0,0,0
"Nov 6, 2019 12:00 PM",90,56,34,,,,,,,,,,20,12,8,7,,,,30,23,7,19,15,7,0,7,27,1,1,2,2,0,2,2,0
"Nov 6, 2019 1:00 PM",100,50,50,,,,,,,,,,21,10,11,13,,,,40,34,6,20,22,19,8,11,30,3,3,7,4,3,3,2,1
"Nov 6, 2019 2:00 PM",68,30,38,,,,,,,,,,20,11,9,7,,,,42,38,4,25,19,15,5,10,19,1,2,7,4,3,2,1,1
"Nov 6, 2019 3:00 PM",98,28,70,,,,,,,,,,10,8,2,15,,,,51,45,6,17,34,25,7,18,20,4,1,7,3,4,2,1,1
"Nov 6, 2019 4:00 PM",156,33,123,,,,,,,,,,16,12,4,17,,,,87,85,2,21,71,32,8,24,43,5,0,2,2,0,0,0,0
"Nov 6, 2019 5:00 PM",305,50,255,,,,,,,,,,14,11,3,21,,,,191,183,8,32,160,60,9,51,60,7,2,7,3,4,1,1,0
"Nov 6, 2019 6:00 PM",342,53,289,,,,,,,,,,15,12,3,16,,,,211,205,6,34,192,56,5,51,34,3,3,3,3,0,0,0,0
"Nov 6, 2019 7:00 PM",173,25,148,,,,,,,,,,4,3,1,7,,,,111,103,8,13,61,29,0,29,23,3,4,1,0,1,2,2,0
"Nov 6, 2019 8:00 PM",121,21,100,,,,,,,,,,3,2,1,4,,,,67,64,3,9,37,5,1,4,21,1,0,0,0,0,0,0,0
"Nov 6, 2019 9:00 PM",74,12,62,,,,,,,,,,3,1,2,3,,,,37,34,3,6,19,7,0,7,11,3,0,1,1,0,0,0,0
"Nov 6, 2019 10:00 PM",41,11,30,,,,,,,,,,0,0,0,2,,,,29,28,1,3,16,2,1,1,4,1,0,1,0,1,0,0,0
"Nov 6, 2019 11:00 PM",17,4,13,,,,,,,,,,2,2,0,0,,,,17,17,0,2,7,3,2,1,1,1,0,2,1,1,0,0,0
"Nov 7, 2019 12:00 AM",10,1,9,,,,,,,,,,0,0,0,1,,,,6,6,0,4,2,0,0,0,3,0,1,0,0,0,0,0,0
"Nov 7, 2019 1:00 AM",5,0,5,,,,,,,,,,0,0,0,0,,,,3,3,0,2,0,0,0,0,2,0,0,0,0,0,0,0,0
"Nov 7, 2019 2:00 AM",10,7,3,,,,,,,,,,0,0,0,0,,,,0,0,0,1,1,0,0,0,1,0,0,0,0,0,0,0,0
"Nov 7, 2019 3:00 AM",3,1,2,,,,,,,,,,0,0,0,0,,,,1,1,0,0,0,0,0,0,0,1,0,0,0,0,0,0,0
"Nov 7, 2019 4:00 AM",3,2,1,,,,,,,,,,0,0,0,1,,,,1,1,0,0,1,0,0,0,0,0,0,0,0,0,0,0,0
"Nov 7, 2019 5:00 AM",5,5,0,,,,,,,,,,0,0,0,1,,,,2,1,1,6,5,0,0,0,7,3,1,0,0,0,0,0,0
"Nov 7, 2019 6:00 AM",47,36,11,,,,,,,,,,2,0,2,4,,,,13,9,4,19,8,4,4,0,44,2,0,1,1,0,0,0,0
"Nov 7, 2019 7:00 AM",134,103,31,,,,,,,,,,5,3,2,7,,,,28,22,6,100,24,14,11,3,109,2,7,3,2,1,0,0,0
"Nov 7, 2019 8:00 AM",315,271,44,,,,,,,,,,4,1,3,15,,,,59,39,20,167,44,38,30,8,196,2,1,2,1,1,2,0,2
"Nov 7, 2019 9:00 AM",70,43,27,,,,,,,,,,7,4,3,8,,,,32,17,15,72,19,27,21,6,69,2,0,1,1,0,0,0,0
"Nov 7, 2019 10:00 AM",15,6,9,,,,,,,,,,0,0,0,4,,,,24,14,10,21,2,7,3,4,10,0,2,0,0,0,1,1,0
"Nov 7, 2019 11:00 AM",14,0,14,,,,,,,,,,0,0,0,1,,,,17,12,5,7,12,1,0,1,9,1,0,0,0,0,0,0,0
"Nov 7, 2019 12:00 PM",16,0,16,,,,,,,,,,2,1,1,0,,,,26,19,7,10,8,2,2,0,4,0,0,0,0,0,1,1,0
"Nov 7, 2019 1:00 PM",27,0,27,,,,,,,,,,3,2,1,1,,,,30,25,5,11,11,4,1,3,13,1,0,0,0,0,0,0,0
"Nov 7, 2019 2:00 PM",32,1,31,,,,,,,,,,1,0,1,2,,,,32,27,5,6,9,4,0,4,4,0,0,0,0,0,0,0,0
"Nov 7, 2019 3:00 PM",43,2,41,,,,,,,,,,3,1,2,4,,,,53,48,5,7,15,3,0,3,12,3,1,3,3,0,1,0,1
"Nov 7, 2019 4:00 PM",92,3,89,,,,,,,,,,5,1,4,7,,,,83,77,6,15,43,12,2,10,19,1,0,2,1,1,0,0,0
"Nov 7, 2019 5:00 PM",184,7,177,,,,,,,,,,6,0,6,11,,,,165,159,6,18,100,31,7,24,39,4,1,2,2,0,1,1,0
"Nov 7, 2019 6:00 PM",210,3,207,,,,,,,,,,3,1,2,11,,,,184,177,7,20,136,28,4,24,23,6,1,4,3,1,1,1,0
"Nov 7, 2019 7:00 PM",102,4,98,,,,,,,,,,7,1,6,8,,,,95,92,3,14,39,19,2,17,15,2,0,2,0,2,1,1,0
"Nov 7, 2019 8:00 PM",66,7,59,,,,,,,,,,2,0,2,7,,,,55,52,3,4,23,6,0,6,12,3,0,4,1,3,1,1,0
"Nov 7, 2019 9:00 PM",43,2,41,,,,,,,,,,0,0,0,1,,,,37,35,2,3,15,2,0,2,9,0,0,0,0,0,3,3,0
"Nov 7, 2019 10:00 PM",34,0,34,,,,,,,,,,0,0,0,1,,,,29,27,2,4,8,5,0,5,3,0,0,0,0,0,0,0,0
"Nov 7, 2019 11:00 PM",14,1,13,,,,,,,,,,0,0,0,0,,,,15,15,0,2,7,1,1,0,6,0,0,1,0,1,0,0,0
"Nov 8, 2019 12:00 AM",4,0,4,,,,,,,,,,0,0,0,1,,,,8,8,0,1,3,2,1,1,1,0,1,0,0,0,0,0,0
"Nov 8, 2019 1:00 AM",3,0,3,,,,,,,,,,0,0,0,0,,,,1,1,0,0,2,0,0,0,1,0,0,0,0,0,0,0,0
"Nov 8, 2019 2:00 AM",0,0,0,,,,,,,,,,0,0,0,0,,,,0,0,0,2,0,0,0,0,0,0,0,0,0,0,0,0,0
"Nov 8, 2019 3:00 AM",0,0,0,,,,,,,,,,0,0,0,0,,,,0,0,0,0,1,0,0,0,0,0,0,0,0,0,0,0,0
"Nov 8, 2019 4:00 AM",2,0,2,,,,,,,,,,0,0,0,0,,,,0,0,0,0,1,0,0,0,1,0,0,0,0,0,0,0,0
"Nov 8, 2019 5:00 AM",6,6,0,,,,,,,,,,0,0,0,3,,,,2,2,0,6,4,0,0,0,8,3,0,0,0,0,0,0,0
"Nov 8, 2019 6:00 AM",27,14,13,,,,,,,,,,4,0,4,2,,,,7,5,2,22,11,7,2,5,42,3,4,1,1,0,1,0,1
"Nov 8, 2019 7:00 AM",74,29,45,,,,,,,,,,8,4,4,11,,,,20,14,6,92,33,11,6,5,111,3,2,5,4,1,2,0,2
"Nov 8, 2019 8:00 AM",128,54,74,,,,,,,,,,29,5,24,20,,,,46,30,16,223,59,74,52,22,239,7,8,11,10,1,2,1,1
"Nov 8, 2019 9:00 AM",38,11,27,,,,,,,,,,22,7,15,18,,,,28,14,14,104,27,35,25,10,92,4,7,4,0,4,2,0,2
"Nov 8, 2019 10:00 AM",26,4,22,,,,,,,,,,8,1,7,4,,,,14,6,8,42,17,22,16,6,33,1,4,5,2,3,2,1,1
"Nov 8, 2019 11:00 AM",34,0,34,,,,,,,,,,11,3,8,11,,,,17,12,5,30,15,7,5,2,19,3,2,2,2,0,1,0,1
"Nov 8, 2019 12:00 PM",48,0,48,,,,,,,,,,13,7,6,4,,,,25,21,4,21,19,19,10,9,22,0,1,3,3,0,0,0,0
"Nov 8, 2019 1:00 PM",73,0,73,,,,,,,,,,12,4,8,5,,,,28,22,6,24,34,17,3,14,25,1,3,2,1,1,1,1,0
"Nov 8, 2019 2:00 PM",52,1,51,,,,,,,,,,21,5,16,8,,,,33,30,3,11,19,21,7,14,24,4,1,8,4,4,2,1,1
"Nov 8, 2019 3:00 PM",73,0,73,,,,,,,,,,9,3,6,17,,,,53,48,5,21,43,18,6,12,23,8,1,12,8,4,1,1,0
"Nov 8, 2019 4:00 PM",118,5,113,,,,,,,,,,14,7,7,11,,,,76,73,3,27,80,41,9,32,38,8,1,8,5,3,4,3,1
"Nov 8, 2019 5:00 PM",229,10,219,,,,,,,,,,6,3,3,18,,,,136,131,5,34,165,50,8,42,46,8,2,5,2,3,2,1,1
"Nov 8, 2019 6:00 PM",207,6,201,,,,,,,,,,19,10,9,16,,,,106,104,2,27,119,56,5,51,39,7,1,3,3,0,0,0,0
"Nov 8, 2019 7:00 PM",93,8,85,,,,,,,,,,8,6,2,8,,,,50,45,5,5,49,20,3,17,13,1,2,5,2,3,2,1,1
"Nov 8, 2019 8:00 PM",45,2,43,,,,,,,,,,3,1,2,3,,,,25,25,0,9,26,8,2,6,18,2,2,4,1,3,2,2,0
"Nov 8, 2019 9:00 PM",36,4,32,,,,,,,,,,2,1,1,8,,,,13,12,1,5,10,1,0,1,6,2,1,2,2,0,1,1,0
"Nov 8, 2019 10:00 PM",27,2,25,,,,,,,,,,0,0,0,0,,,,14,14,0,2,12,2,1,1,10,1,0,2,1,1,1,0,1
"Nov 8, 2019 11:00 PM",19,1,18,,,,,,,,,,3,2,1,0,,,,7,7,0,3,10,0,0,0,4,0,0,1,0,1,0,0,0
"Nov 9, 2019 12:00 AM",6,0,6,,,,,,,,,,0,0,0,1,,,,6,6,0,3,3,0,0,0,4,2,0,0,0,0,0,0,0
"Nov 9, 2019 1:00 AM",14,1,13,,,,,,,,,,0,0,0,0,,,,4,3,1,3,2,1,0,1,2,0,0,0,0,0,0,0,0
"Nov 9, 2019 2:00 AM",5,1,4,,,,,,,,,,1,0,1,0,,,,3,3,0,0,2,2,1,1,2,0,0,2,2,0,2,0,2
"Nov 9, 2019 3:00 AM",0,0,0,,,,,,,,,,0,0,0,0,,,,2,2,0,0,1,2,2,0,1,0,2,0,0,0,0,0,0
"Nov 9, 2019 4:00 AM",0,0,0,,,,,,,,,,0,0,0,0,,,,1,1,0,1,1,0,0,0,0,0,0,0,0,0,0,0,0
"Nov 9, 2019 5:00 AM",2,0,2,,,,,,,,,,0,0,0,3,,,,2,2,0,0,0,2,0,2,0,0,0,0,0,0,0,0,0
"Nov 9, 2019 6:00 AM",6,1,5,,,,,,,,,,0,0,0,0,,,,4,4,0,3,2,0,0,0,8,1,0,0,0,0,0,0,0
"Nov 9, 2019 7:00 AM",7,1,6,,,,,,,,,,0,0,0,0,,,,4,4,0,8,8,2,0,2,10,0,0,0,0,0,2,0,2
"Nov 9, 2019 8:00 AM",12,2,10,,,,,,,,,,6,4,2,7,,,,6,5,1,12,17,2,0,2,22,2,0,0,0,0,0,0,0
"Nov 9, 2019 9:00 AM",22,12,10,,,,,,,,,,10,4,6,3,,,,9,7,2,26,8,13,8,5,24,2,2,0,0,0,1,1,0
"Nov 9, 2019 10:00 AM",20,7,13,,,,,,,,,,14,6,8,5,,,,13,10,3,22,9,11,3,8,22,1,0,1,0,1,1,0,1
"Nov 9, 2019 11:00 AM",38,22,16,,,,,,,,,,13,6,7,21,,,,18,15,3,17,16,9,5,4,17,0,1,3,3,0,0,0,0
"Nov 9, 2019 12:00 PM",34,9,25,,,,,,,,,,15,5,10,16,,,,15,11,4,15,10,11,4,7,22,0,1,6,4,2,2,1,1
"Nov 9, 2019 1:00 PM",33,11,22,,,,,,,,,,16,5,11,9,,,,16,13,3,11,13,15,8,7,19,2,3,3,1,2,0,0,0
"Nov 9, 2019 2:00 PM",23,4,19,,,,,,,,,,6,2,4,10,,,,17,14,3,9,7,7,1,6,13,3,1,2,0,2,2,2,0
"Nov 9, 2019 3:00 PM",33,5,28,,,,,,,,,,8,4,4,7,,,,18,14,4,8,10,11,1,10,16,2,1,3,3,0,1,0,1
"Nov 9, 2019 4:00 PM",34,4,30,,,,,,,,,,11,4,7,13,,,,16,13,3,13,11,12,1,11,9,1,4,4,2,2,0,0,0
"Nov 9, 2019 5:00 PM",31,3,28,,,,,,,,,,7,5,2,4,,,,22,20,2,8,11,8,4,4,10,2,0,2,1,1,0,0,0
"Nov 9, 2019 6:00 PM",27,2,25,,,,,,,,,,0,0,0,6,,,,15,15,0,4,12,8,2,6,11,2,0,2,1,1,2,2,0
"Nov 9, 2019 7:00 PM",25,2,23,,,,,,,,,,0,0,0,3,,,,9,8,1,5,10,1,0,1,7,1,0,1,1,0,0,0,0
"Nov 9, 2019 8:00 PM",21,2,19,,,,,,,,,,3,1,2,1,,,,5,5,0,3,4,3,1,2,5,0,0,0,0,0,1,1,0
"Nov 9, 2019 9:00 PM",10,1,9,,,,,,,,,,0,0,0,2,,,,4,4,0,2,1,2,1,1,6,0,0,0,0,0,0,0,0
"Nov 9, 2019 10:00 PM",8,1,7,,,,,,,,,,0,0,0,1,,,,4,3,1,0,1,1,0,1,3,1,0,0,0,0,1,1,0
"Nov 9, 2019 11:00 PM",4,0,4,,,,,,,,,,0,0,0,2,,,,6,5,1,0,2,4,3,1,2,0,1,0,0,0,0,0,0
"Nov 10, 2019 12:00 AM",8,2,6,,,,,,,,,,2,0,2,2,,,,3,3,0,1,6,1,0,1,1,0,0,0,0,0,0,0,0
"Nov 10, 2019 1:00 AM",3,0,3,,,,,,,,,,0,0,0,1,,,,3,3,0,0,0,0,0,0,0,0,0,0,0,0,0,0,0
"Nov 10, 2019 2:00 AM",1,0,1,,,,,,,,,,0,0,0,0,,,,2,2,0,2,0,1,1,0,1,0,2,0,0,0,0,0,0
"Nov 10, 2019 3:00 AM",2,0,2,,,,,,,,,,0,0,0,0,,,,1,1,0,0,0,0,0,0,0,0,2,0,0,0,0,0,0
"Nov 10, 2019 4:00 AM",3,0,3,,,,,,,,,,0,0,0,0,,,,0,0,0,0,0,1,0,1,0,0,0,1,0,1,0,0,0
"Nov 10, 2019 5:00 AM",2,0,2,,,,,,,,,,0,0,0,0,,,,1,1,0,0,1,0,0,0,0,0,1,0,0,0,0,0,0
"Nov 10, 2019 6:00 AM",9,1,8,,,,,,,,,,1,1,0,0,,,,4,4,0,1,9,10,1,9,0,1,0,0,0,0,0,0,0
"Nov 10, 2019 7:00 AM",11,2,9,,,,,,,,,,1,1,0,2,,,,8,4,4,4,14,1,0,1,0,0,2,0,0,0,1,0,1
"Nov 10, 2019 8:00 AM",15,3,12,,,,,,,,,,9,5,4,7,,,,4,2,2,7,20,11,4,7,1,0,8,2,1,1,0,0,0
"Nov 10, 2019 9:00 AM",26,7,19,,,,,,,,,,5,3,2,2,,,,12,7,5,20,23,22,6,16,12,4,11,3,2,1,2,2,0
"Nov 10, 2019 10:00 AM",25,8,17,,,,,,,,,,15,5,10,7,,,,14,9,5,19,23,46,13,33,30,9,5,4,3,1,0,0,0
"Nov 10, 2019 11:00 AM",33,13,20,,,,,,,,,,31,9,22,13,,,,19,9,10,13,27,31,10,21,32,4,3,2,1,1,5,3,2
"Nov 10, 2019 12:00 PM",34,13,21,,,,,,,,,,45,21,24,16,,,,24,12,12,16,41,55,25,30,22,3,2,2,1,1,1,1,0
"Nov 10, 2019 1:00 PM",44,6,38,,,,,,,,,,29,10,19,11,,,,31,23,8,17,25,32,14,18,30,3,1,3,3,0,1,0,1
"Nov 10, 2019 2:00 PM",35,4,31,,,,,,,,,,24,13,11,9,,,,21,15,6,8,13,30,10,20,25,3,5,6,2,4,0,0,0
"Nov 10, 2019 3:00 PM",31,3,28,,,,,,,,,,33,17,16,30,,,,23,17,6,15,11,36,26,10,25,4,1,2,2,0,1,0,1
"Nov 10, 2019 4:00 PM",30,5,25,,,,,,,,,,25,16,9,14,,,,19,17,2,18,7,17,13,4,22,2,1,4,3,1,2,2,0
"Nov 10, 2019 5:00 PM",31,4,27,,,,,,,,,,7,6,1,6,,,,22,19,3,9,7,7,1,6,9,1,1,1,1,0,1,1,0
"Nov 10, 2019 6:00 PM",29,3,26,,,,,,,,,,3,2,1,10,,,,17,15,2,4,6,8,4,4,15,2,2,2,2,0,0,0,0
"Nov 10, 2019 7:00 PM",17,1,16,,,,,,,,,,1,1,0,5,,,,14,12,2,3,6,4,1,3,3,0,0,2,1,1,0,0,0
"Nov 10, 2019 8:00 PM",13,0,13,,,,,,,,,,2,1,1,1,,,,7,6,1,3,3,0,0,0,4,1,1,0,0,0,0,0,0
"Nov 10, 2019 9:00 PM",9,1,8,,,,,,,,,,1,0,1,2,,,,5,5,0,4,4,3,1,2,2,1,0,0,0,0,0,0,0
"Nov 10, 2019 10:00 PM",8,1,7,,,,,,,,,,0,0,0,2,,,,6,4,2,2,2,0,0,0,0,1,0,0,0,0,1,1,0
"Nov 10, 2019 11:00 PM",6,0,6,,,,,,,,,,0,0,0,0,,,,5,4,1,0,2,0,0,0,1,0,0,0,0,0,0,0,0
"Nov 11, 2019 12:00 AM",7,0,7,,,,,,,,,,1,1,0,0,,,,4,4,0,0,2,0,0,0,1,0,1,0,0,0,0,0,0
"Nov 11, 2019 1:00 AM",1,0,1,,,,,,,,,,0,0,0,1,,,,1,1,0,0,0,0,0,0,0,0,0,0,0,0,0,0,0
"Nov 11, 2019 2:00 AM",0,0,0,,,,,,,,,,0,0,0,0,,,,1,1,0,0,1,1,1,0,0,0,0,0,0,0,0,0,0
"Nov 11, 2019 3:00 AM",0,0,0,,,,,,,,,,0,0,0,0,,,,2,2,0,0,0,0,0,0,1,0,0,0,0,0,0,0,0
"Nov 11, 2019 4:00 AM",2,0,2,,,,,,,,,,0,0,0,2,,,,0,0,0,0,0,1,0,1,1,0,0,0,0,0,0,0,0
"Nov 11, 2019 5:00 AM",3,3,0,,,,,,,,,,0,0,0,2,,,,1,1,0,5,3,0,0,0,8,2,0,0,0,0,0,0,0
"Nov 11, 2019 6:00 AM",18,9,9,,,,,,,,,,1,0,1,5,,,,8,6,2,23,10,5,2,3,50,1,2,1,1,0,1,0,1
"Nov 11, 2019 7:00 AM",83,36,47,,,,,,,,,,4,0,4,13,,,,22,17,5,113,33,19,9,10,142,3,3,6,6,0,1,0,1
"Nov 11, 2019 8:00 AM",216,146,70,,,,,,,,,,29,10,19,35,,,,42,25,17,291,58,71,61,10,312,6,4,12,11,1,1,0,1
"Nov 11, 2019 9:00 AM",51,25,26,,,,,,,,,,10,2,8,14,,,,27,16,11,140,26,45,32,13,109,0,1,2,1,1,0,0,0
"Nov 11, 2019 10:00 AM",23,6,17,,,,,,,,,,5,4,1,9,,,,13,7,6,58,13,9,3,6,39,0,3,1,0,1,0,0,0
"Nov 11, 2019 11:00 AM",18,1,17,,,,,,,,,,1,0,1,10,,,,17,12,5,24,5,7,3,4,7,1,0,2,2,0,0,0,0
"Nov 11, 2019 12:00 PM",41,4,37,,,,,,,,,,14,4,10,8,,,,16,14,2,18,11,8,4,4,25,2,1,1,1,0,0,0,0
"Nov 11, 2019 1:00 PM",51,3,48,,,,,,,,,,17,6,11,10,,,,24,18,6,25,18,12,3,9,24,1,2,3,1,2,2,1,1
"Nov 11, 2019 2:00 PM",49,3,46,,,,,,,,,,10,4,6,9,,,,28,24,4,16,12,19,7,12,15,4,3,3,3,0,2,0,2
"Nov 11, 2019 3:00 PM",57,3,54,,,,,,,,,,7,5,2,12,,,,40,35,5,15,27,9,4,5,21,3,0,6,3,3,1,1,0
"Nov 11, 2019 4:00 PM",129,0,129,,,,,,,,,,6,4,2,20,,,,55,50,5,13,75,19,5,14,38,1,3,7,1,6,4,4,0
"Nov 11, 2019 5:00 PM",304,1,303,,,,,,,,,,14,12,2,31,,,,130,124,6,35,191,43,6,37,74,6,3,2,2,0,0,0,0
"Nov 11, 2019 6:00 PM",289,4,285,,,,,,,,,,12,7,5,25,,,,138,132,6,31,188,67,7,60,43,6,2,5,2,3,1,0,1
"Nov 11, 2019 7:00 PM",142,2,140,,,,,,,,,,4,4,0,9,,,,69,64,5,15,67,30,3,27,19,3,2,2,2,0,1,1,0
"Nov 11, 2019 8:00 PM",95,0,95,,,,,,,,,,3,3,0,5,,,,41,39,2,11,33,9,1,8,17,5,3,8,3,5,3,3,0
"Nov 11, 2019 9:00 PM",62,0,62,,,,,,,,,,0,0,0,2,,,,24,22,2,10,19,6,2,4,11,3,0,2,1,1,0,0,0
"Nov 11, 2019 10:00 PM",27,0,27,,,,,,,,,,0,0,0,1,,,,20,18,2,5,13,2,0,2,7,2,0,1,0,1,0,0,0
"Nov 11, 2019 11:00 PM",19,0,19,,,,,,,,,,0,0,0,2,,,,6,6,0,3,10,0,0,0,4,0,0,1,0,1,0,0,0
"Nov 12, 2019 12:00 AM",6,0,6,,,,,,,,,,0,0,0,0,,,,3,3,0,1,4,2,0,2,0,0,2,0,0,0,0,0,0
"Nov 12, 2019 1:00 AM",2,0,2,,,,,,,,,,0,0,0,0,,,,1,1,0,1,2,0,0,0,0,0,0,0,0,0,0,0,0
"Nov 12, 2019 2:00 AM",1,0,1,,,,,,,,,,0,0,0,0,,,,1,1,0,1,0,0,0,0,0,0,0,0,0,0,0,0,0
"Nov 12, 2019 3:00 AM",1,0,1,,,,,,,,,,0,0,0,0,,,,1,1,0,0,0,0,0,0,1,0,0,0,0,0,0,0,0
"Nov 12, 2019 4:00 AM",1,0,1,,,,,,,,,,0,0,0,1,,,,0,0,0,0,0,0,0,0,2,0,0,0,0,0,0,0,0
"Nov 12, 2019 5:00 AM",0,0,0,,,,,,,,,,0,0,0,3,,,,4,2,2,6,2,0,0,0,11,1,0,0,0,0,0,0,0
"Nov 12, 2019 6:00 AM",16,2,14,,,,,,,,,,1,0,1,4,,,,13,9,4,22,13,4,1,3,56,1,1,1,0,1,0,0,0
"Nov 12, 2019 7:00 AM",51,3,48,,,,,,,,,,8,1,7,17,,,,33,25,8,135,40,14,9,5,131,4,6,6,6,0,2,0,2
"Nov 12, 2019 8:00 AM",101,22,79,,,,,,,,,,20,3,17,35,,,,63,37,26,270,67,69,57,12,323,8,5,9,6,3,4,2,2
"Nov 12, 2019 9:00 AM",52,23,29,,,,,,,,,,17,6,11,11,,,,33,18,15,147,24,37,24,13,105,1,2,0,0,0,0,0,0
"Nov 12, 2019 10:00 AM",26,6,20,,,,,,,,,,4,1,3,5,,,,20,14,6,41,10,8,5,3,24,1,1,0,0,0,0,0,0
"Nov 12, 2019 11:00 AM",25,4,21,,,,,,,,,,3,2,1,6,,,,24,16,8,33,10,5,2,3,22,2,2,0,0,0,0,0,0
"Nov 12, 2019 12:00 PM",33,3,30,,,,,,,,,,8,6,2,3,,,,22,15,7,26,20,8,5,3,19,0,1,2,1,1,1,0,1
"Nov 12, 2019 1:00 PM",42,0,42,,,,,,,,,,6,5,1,10,,,,30,24,6,20,19,8,1,7,27,2,1,2,2,0,0,0,0
"Nov 12, 2019 2:00 PM",69,22,47,,,,,,,,,,13,10,3,5,,,,41,35,6,14,21,11,7,4,18,4,1,2,1,1,2,1,1
"Nov 12, 2019 3:00 PM",97,32,65,,,,,,,,,,11,5,6,18,,,,52,47,5,24,25,9,2,7,30,2,0,2,2,0,1,1,0
"Nov 12, 2019 4:00 PM",155,31,124,,,,,,,,,,5,5,0,15,,,,75,71,4,25,67,20,5,15,33,2,1,7,3,4,3,3,0
"Nov 12, 2019 5:00 PM",307,48,259,,,,,,,,,,11,7,4,28,,,,152,145,7,43,151,53,8,45,57,6,2,1,0,1,1,1,0
"Nov 12, 2019 6:00 PM",326,45,281,,,,,,,,,,14,9,5,14,,,,145,140,5,36,180,56,3,53,45,5,1,3,2,1,1,1,0
"Nov 12, 2019 7:00 PM",162,21,141,,,,,,,,,,9,6,3,17,,,,72,68,4,14,71,28,1,27,23,4,2,4,3,1,0,0,0
"Nov 12, 2019 8:00 PM",126,31,95,,,,,,,,,,7,4,3,3,,,,55,52,3,10,32,7,0,7,15,2,3,3,1,2,1,1,0
"Nov 12, 2019 9:00 PM",79,8,71,,,,,,,,,,2,2,0,8,,,,26,26,0,6,20,9,0,9,11,3,0,3,2,1,1,1,0
"Nov 12, 2019 10:00 PM",43,4,39,,,,,,,,,,1,1,0,3,,,,17,16,1,3,16,8,2,6,10,3,1,0,0,0,0,0,0
"Nov 12, 2019 11:00 PM",17,1,16,,,,,,,,,,1,1,0,0,,,,6,6,0,0,6,1,1,0,6,0,0,1,0,1,1,1,0
"Nov 13, 2019 12:00 AM",13,6,7,,,,,,,,,,0,0,0,0,,,,2,2,0,1,5,,,,1,,,0,0,0,1,1,0
"Nov 13, 2019 1:00 AM",1,0,1,,,,,,,,,,1,1,0,0,,,,3,3,0,0,2,,,,0,,,0,0,0,0,0,0
"Nov 13, 2019 2:00 AM",4,4,0,,,,,,,,,,0,0,0,0,,,,0,0,0,1,1,,,,0,,,0,0,0,0,0,0
"Nov 13, 2019 3:00 AM",0,0,0,,,,,,,,,,0,0,0,1,,,,0,0,0,0,1,,,,1,,,0,0,0,0,0,0
"Nov 13, 2019 4:00 AM",3,2,1,,,,,,,,,,0,0,0,1,,,,1,1,0,0,0,,,,0,,,0,0,0,0,0,0
"Nov 13, 2019 5:00 AM",5,5,0,,,,,,,,,,0,0,0,4,,,,2,2,0,5,5,,,,9,,,0,0,0,0,0,0
"Nov 13, 2019 6:00 AM",51,37,14,,,,,,,,,,1,0,1,2,,,,12,9,3,20,7,,,,47,,,2,0,2,0,0,0
"Nov 13, 2019 7:00 AM",166,128,38,,,,,,,,,,13,2,11,14,,,,37,27,10,131,31,,,,153,,,3,1,2,0,0,0
"Nov 13, 2019 8:00 AM",379,308,71,,,,,,,,,,21,5,16,29,,,,63,35,28,268,61,,,,316,,,13,12,1,3,0,3
"Nov 13, 2019 9:00 AM",237,205,32,,,,,,,,,,11,4,7,7,,,,35,18,17,142,19,,,,100,,,2,2,0,0,0,0
"Nov 13, 2019 10:00 AM",114,98,16,,,,,,,,,,6,3,3,3,,,,27,15,12,58,10,,,,27,,,4,4,0,4,1,3
"Nov 13, 2019 11:00 AM",60,42,18,,,,,,,,,,7,6,1,4,,,,19,9,10,34,8,,,,17,,,2,2,0,2,0,2
"Nov 13, 2019 12:00 PM",92,53,39,,,,,,,,,,13,8,5,9,,,,30,23,7,34,16,,,,26,,,3,1,2,1,1,0
"Nov 13, 2019 1:00 PM",83,42,41,,,,,,,,,,18,10,8,7,,,,41,34,7,15,16,,,,18,,,0,0,0,2,2,0
"Nov 13, 2019 2:00 PM",70,24,46,,,,,,,,,,7,2,5,7,,,,41,36,5,13,10,4,1,3,17,,,3,0,3,1,1,0
"Nov 13, 2019 3:00 PM",77,16,61,,,,,,,,,,4,3,1,11,,,,54,48,6,14,7,5,2,3,3,1,,7,4,3,0,0,0
"Nov 13, 2019 4:00 PM",111,24,87,,,,,,,,,,6,6,0,7,,,,91,89,2,4,29,18,3,15,16,5,0,1,1,0,0,0,0
"Nov 13, 2019 5:00 PM",267,41,226,,,,,,,,,,11,8,3,12,,,,197,189,8,23,95,39,5,34,13,5,1,3,2,1,1,1,0
"Nov 13, 2019 6:00 PM",267,36,231,,,,,,,,,,14,12,2,15,,,,207,200,7,23,140,41,2,39,5,2,0,0,0,0,1,1,0
"Nov 13, 2019 7:00 PM",153,15,138,,,,,,,,,,4,3,1,13,,,,108,100,8,16,61,35,1,34,8,5,2,0,0,0,0,0,0
"Nov 13, 2019 8:00 PM",92,15,77,,,,,,,,,,1,1,0,5,,,,68,65,3,7,29,6,2,4,13,0,0,0,0,0,0,0,0
"Nov 13, 2019 9:00 PM",56,8,48,,,,,,,,,,2,1,1,4,,,,36,33,3,5,8,7,0,7,7,1,0,2,1,1,0,0,0
"Nov 13, 2019 10:00 PM",35,2,33,,,,,,,,,,0,0,0,2,,,,29,28,1,1,13,2,0,2,2,0,0,2,1,1,0,0,0
"Nov 13, 2019 11:00 PM",24,3,21,,,,,,,,,,1,0,1,0,,,,18,18,0,1,5,0,0,0,1,0,1,1,0,1,0,0,0
"Nov 14, 2019 12:00 AM",13,6,7,,,,,,,,,,0,0,0,1,,,,1,1,0,1,2,1,0,1,0,1,0,0,0,0,0,0,0
"Nov 14, 2019 1:00 AM",2,0,2,,,,,,,,,,0,0,0,0,,,,5,5,0,0,2,0,0,0,0,2,0,0,0,0,0,0,0
"Nov 14, 2019 2:00 AM",2,2,0,,,,,,,,,,0,0,0,1,,,,1,1,0,1,0,0,0,0,0,0,0,0,0,0,0,0,0
"Nov 14, 2019 3:00 AM",0,0,0,,,,,,,,,,0,0,0,0,,,,0,0,0,0,0,0,0,0,0,0,0,0,0,0,0,0,0
"Nov 14, 2019 4:00 AM",7,2,5,,,,,,,,,,0,0,0,1,,,,0,0,0,0,1,0,0,0,1,0,0,0,0,0,0,0,0
"Nov 14, 2019 5:00 AM",7,7,0,,,,,,,,,,0,0,0,1,,,,1,1,0,6,4,1,1,0,5,3,0,0,0,0,0,0,0
"Nov 14, 2019 6:00 AM",39,31,8,,,,,,,,,,4,0,4,6,,,,15,11,4,20,14,2,1,1,30,0,2,2,1,1,1,0,1
"Nov 14, 2019 7:00 AM",138,104,34,,,,,,,,,,2,1,1,5,,,,19,12,7,75,20,13,9,4,92,2,3,2,2,0,0,0,0
"Nov 14, 2019 8:00 AM",358,304,54,,,,,,,,,,15,4,11,19,,,,37,24,13,202,38,30,24,6,188,2,4,3,3,0,4,0,4
"Nov 14, 2019 9:00 AM",204,186,18,,,,,,,,,,5,2,3,11,,,,19,8,11,101,22,22,12,10,87,2,1,1,0,1,0,0,0
"Nov 14, 2019 10:00 AM",108,89,19,,,,,,,,,,1,0,1,6,,,,15,7,8,48,7,8,2,6,27,1,1,2,1,1,1,1,0
"Nov 14, 2019 11:00 AM",69,48,21,,,,,,,,,,8,2,6,5,,,,14,8,6,24,3,5,2,3,13,0,1,3,0,3,0,0,0
"Nov 14, 2019 12:00 PM",66,34,32,,,,,,,,,,6,4,2,7,,,,19,15,4,29,8,4,0,4,25,1,0,0,0,0,0,0,0
"Nov 14, 2019 1:00 PM",91,44,47,,,,,,,,,,10,5,5,3,,,,19,16,3,20,14,10,2,8,18,1,0,2,2,0,1,1,0
"Nov 14, 2019 2:00 PM",74,34,40,,,,,,,,,,0,0,0,4,,,,34,23,11,22,10,11,7,4,15,1,2,2,2,0,0,0,0
"Nov 14, 2019 3:00 PM",99,35,64,,,,,,,,,,9,5,4,7,,,,39,36,3,18,17,16,2,14,16,2,0,4,3,1,0,0,0
"Nov 14, 2019 4:00 PM",149,38,111,,,,,,,,,,7,5,2,9,,,,57,56,1,17,53,20,5,15,34,1,2,3,1,2,3,3,0
"Nov 14, 2019 5:00 PM",265,51,214,,,,,,,,,,8,7,1,11,,,,129,123,6,37,107,37,5,32,50,9,1,3,1,2,1,1,0
"Nov 14, 2019 6:00 PM",257,46,211,,,,,,,,,,10,9,1,15,,,,156,150,6,22,115,38,2,36,40,4,0,3,3,0,1,1,0
"Nov 14, 2019 7:00 PM",159,28,131,,,,,,,,,,6,3,3,8,,,,67,66,1,10,44,23,4,19,19,3,1,6,5,1,1,1,0
"Nov 14, 2019 8:00 PM",113,15,98,,,,,,,,,,5,2,3,8,,,,40,38,2,9,29,5,1,4,11,3,1,2,0,2,0,0,0
"Nov 14, 2019 9:00 PM",80,14,66,,,,,,,,,,1,0,1,4,,,,28,28,0,3,20,6,0,6,5,1,0,0,0,0,0,0,0
"Nov 14, 2019 10:00 PM",54,4,50,,,,,,,,,,0,0,0,5,,,,20,20,0,2,10,1,0,1,9,0,0,0,0,0,1,0,1
"Nov 14, 2019 11:00 PM",25,6,19,,,,,,,,,,0,0,0,1,,,,9,9,0,1,9,4,1,3,1,0,0,0,0,0,0,0,0
"Nov 15, 2019 12:00 AM",12,1,11,,,,,,,,,,0,0,0,1,,,,6,6,0,0,9,0,0,0,2,0,1,0,0,0,0,0,0
"Nov 15, 2019 1:00 AM",0,0,0,,,,,,,,,,1,1,0,0,,,,2,1,1,0,2,0,0,0,1,0,0,0,0,0,0,0,0
"Nov 15, 2019 2:00 AM",6,3,3,,,,,,,,,,0,0,0,0,,,,3,3,0,2,1,1,0,1,0,0,0,1,0,1,0,0,0
"Nov 15, 2019 3:00 AM",1,0,1,,,,,,,,,,0,0,0,0,,,,2,1,1,2,0,1,0,1,0,0,0,0,0,0,0,0,0
"Nov 15, 2019 4:00 AM",2,0,2,,,,,,,,,,0,0,0,1,,,,1,1,0,1,2,0,0,0,0,0,0,0,0,0,0,0,0
"Nov 15, 2019 5:00 AM",5,5,0,,,,,,,,,,1,1,0,2,,,,0,0,0,7,4,2,0,2,5,2,0,0,0,0,0,0,0
"Nov 15, 2019 6:00 AM",45,33,12,,,,,,,,,,4,0,4,4,,,,12,9,3,25,7,3,2,1,36,2,0,2,1,1,1,0,1
"Nov 15, 2019 7:00 AM",151,109,42,,,,,,,,,,8,1,7,9,,,,25,18,7,76,30,23,17,6,114,2,5,4,4,0,3,0,3
"Nov 15, 2019 8:00 AM",305,258,47,,,,,,,,,,27,4,23,39,,,,33,17,16,204,51,60,48,12,241,5,8,9,7,2,5,1,4
"Nov 15, 2019 9:00 AM",222,195,27,,,,,,,,,,12,6,6,13,,,,23,11,12,112,25,24,13,11,91,3,1,5,3,2,0,0,0
"Nov 15, 2019 10:00 AM",76,58,18,,,,,,,,,,2,1,1,10,,,,15,4,11,51,17,11,7,4,33,2,2,5,2,3,1,1,0
"Nov 15, 2019 11:00 AM",85,58,27,,,,,,,,,,6,1,5,7,,,,17,13,4,24,8,11,2,9,16,3,1,2,2,0,0,0,0
"Nov 15, 2019 12:00 PM",75,38,37,,,,,,,,,,9,4,5,6,,,,23,22,1,28,14,8,5,3,20,2,0,5,5,0,2,0,2
"Nov 15, 2019 1:00 PM",111,42,69,,,,,,,,,,10,4,6,2,,,,30,25,5,28,20,12,3,9,32,0,0,0,0,0,1,0,1
"Nov 15, 2019 2:00 PM",78,35,43,,,,,,,,,,8,3,5,7,,,,30,28,2,16,25,17,3,14,19,4,1,3,2,1,1,0,1
"Nov 15, 2019 3:00 PM",109,27,82,,,,,,,,,,6,5,1,17,,,,61,56,5,17,30,19,5,14,22,1,1,4,1,3,5,4,1
"Nov 15, 2019 4:00 PM",159,38,121,,,,,,,,,,7,3,4,11,,,,64,62,2,21,60,22,6,16,32,2,0,4,2,2,1,1,0
"Nov 15, 2019 5:00 PM",275,52,223,,,,,,,,,,10,7,3,20,,,,126,122,4,30,109,49,8,41,46,6,0,2,1,1,1,1,0
"Nov 15, 2019 6:00 PM",208,35,173,,,,,,,,,,13,12,1,11,,,,129,129,0,18,107,44,1,43,30,4,1,4,3,1,0,0,0
"Nov 15, 2019 7:00 PM",124,28,96,,,,,,,,,,2,2,0,15,,,,51,48,3,6,44,19,5,14,17,2,1,1,0,1,1,1,0
"Nov 15, 2019 8:00 PM",60,18,42,,,,,,,,,,3,3,0,4,,,,18,17,1,7,19,8,1,7,12,3,0,1,1,0,1,1,0
"Nov 15, 2019 9:00 PM",36,10,26,,,,,,,,,,4,2,2,5,,,,15,15,0,3,8,4,0,4,7,0,1,0,0,0,0,0,0
"Nov 15, 2019 10:00 PM",26,2,24,,,,,,,,,,1,1,0,1,,,,13,13,0,3,12,1,1,0,3,1,0,1,1,0,0,0,0
"Nov 15, 2019 11:00 PM",19,6,13,,,,,,,,,,1,0,1,1,,,,13,13,0,2,7,2,1,1,3,0,0,2,1,1,0,0,0
"Nov 16, 2019 12:00 AM",15,5,10,,,,,,,,,,0,0,0,1,,,,5,5,0,1,8,8,3,5,1,0,0,0,0,0,0,0,0
"Nov 16, 2019 1:00 AM",9,2,7,,,,,,,,,,0,0,0,0,,,,3,3,0,0,1,2,0,2,4,1,0,0,0,0,1,1,0
"Nov 16, 2019 2:00 AM",5,2,3,,,,,,,,,,0,0,0,1,,,,4,4,0,0,2,0,0,0,0,0,0,0,0,0,0,0,0
"Nov 16, 2019 3:00 AM",2,0,2,,,,,,,,,,0,0,0,0,,,,3,3,0,0,0,0,0,0,0,0,2,1,0,1,0,0,0
"Nov 16, 2019 4:00 AM",2,0,2,,,,,,,,,,0,0,0,0,,,,0,0,0,1,0,2,0,2,3,0,0,0,0,0,0,0,0
"Nov 16, 2019 5:00 AM",3,1,2,,,,,,,,,,0,0,0,1,,,,2,2,0,1,2,0,0,0,1,1,0,2,2,0,0,0,0
"Nov 16, 2019 6:00 AM",11,4,7,,,,,,,,,,2,0,2,0,,,,2,2,0,1,4,1,1,0,10,1,0,0,0,0,0,0,0
"Nov 16, 2019 7:00 AM",16,7,9,,,,,,,,,,1,0,1,1,,,,5,5,0,6,13,2,1,1,12,1,0,0,0,0,0,0,0
"Nov 16, 2019 8:00 AM",24,17,7,,,,,,,,,,10,3,7,8,,,,4,3,1,14,11,5,2,3,19,1,0,3,3,0,2,0,2
"Nov 16, 2019 9:00 AM",51,29,22,,,,,,,,,,12,6,6,11,,,,14,11,3,22,18,8,2,6,24,3,7,1,0,1,2,2,0
"Nov 16, 2019 10:00 AM",43,27,16,,,,,,,,,,12,7,5,7,,,,12,11,1,18,18,17,5,12,17,3,14,5,2,3,1,0,1
"Nov 16, 2019 11:00 AM",52,35,17,,,,,,,,,,18,9,9,11,,,,11,7,4,13,13,17,8,9,22,5,10,3,3,0,0,0,0
"Nov 16, 2019 12:00 PM",47,25,22,,,,,,,,,,11,6,5,9,,,,12,10,2,19,10,10,4,6,20,5,4,5,3,2,0,0,0
"Nov 16, 2019 1:00 PM",56,31,25,,,,,,,,,,10,1,9,9,,,,16,15,1,12,18,19,4,15,17,0,2,2,1,1,0,0,0
"Nov 16, 2019 2:00 PM",61,40,21,,,,,,,,,,17,10,7,11,,,,12,10,2,27,10,21,8,13,23,4,2,5,3,2,1,1,0
"Nov 16, 2019 3:00 PM",64,23,41,,,,,,,,,,30,19,11,18,,,,13,11,2,22,15,12,6,6,11,2,2,1,0,1,0,0,0
"Nov 16, 2019 4:00 PM",49,18,31,,,,,,,,,,12,6,6,7,,,,14,13,1,7,11,8,4,4,16,2,2,5,3,2,0,0,0
"Nov 16, 2019 5:00 PM",61,14,47,,,,,,,,,,11,4,7,5,,,,21,20,1,9,15,13,4,9,11,2,0,1,0,1,0,0,0
"Nov 16, 2019 6:00 PM",47,15,32,,,,,,,,,,4,4,0,7,,,,15,15,0,6,8,13,3,10,9,1,2,2,0,2,1,1,0
"Nov 16, 2019 7:00 PM",26,9,17,,,,,,,,,,4,2,2,4,,,,12,10,2,2,7,6,3,3,9,2,1,2,2,0,0,0,0
"Nov 16, 2019 8:00 PM",28,12,16,,,,,,,,,,5,3,2,0,,,,6,6,0,7,5,3,1,2,7,0,0,1,0,1,0,0,0
"Nov 16, 2019 9:00 PM",16,6,10,,,,,,,,,,2,1,1,2,,,,13,13,0,3,2,3,1,2,1,2,0,1,1,0,1,1,0
"Nov 16, 2019 10:00 PM",13,5,8,,,,,,,,,,0,0,0,3,,,,3,3,0,6,4,2,1,1,5,0,0,0,0,0,0,0,0
"Nov 16, 2019 11:00 PM",11,3,8,,,,,,,,,,2,0,2,0,,,,2,2,0,3,4,3,0,3,3,0,0,0,0,0,0,0,0
"Nov 17, 2019 12:00 AM",12,4,8,,,,,,,,,,2,1,1,0,,,,3,2,1,4,2,0,0,0,5,0,0,0,0,0,0,0,0
"Nov 17, 2019 1:00 AM",2,1,1,,,,,,,,,,1,1,0,2,,,,10,9,1,0,1,2,2,0,3,1,0,0,0,0,0,0,0
"Nov 17, 2019 2:00 AM",4,1,3,,,,,,,,,,0,0,0,0,,,,2,2,0,0,1,0,0,0,1,0,1,0,0,0,0,0,0
"Nov 17, 2019 3:00 AM",0,0,0,,,,,,,,,,0,0,0,0,,,,0,0,0,0,1,0,0,0,1,0,1,0,0,0,0,0,0
"Nov 17, 2019 4:00 AM",2,0,2,,,,,,,,,,0,0,0,0,,,,0,0,0,0,1,0,0,0,3,0,0,1,0,1,0,0,0
"Nov 17, 2019 5:00 AM",1,0,1,,,,,,,,,,0,0,0,0,,,,1,1,0,0,1,1,0,1,0,0,0,0,0,0,0,0,0
"Nov 17, 2019 6:00 AM",8,3,5,,,,,,,,,,0,0,0,0,,,,3,2,1,1,5,1,1,0,12,2,0,0,0,0,0,0,0
"Nov 17, 2019 7:00 AM",19,9,10,,,,,,,,,,3,1,2,1,,,,5,3,2,4,11,0,0,0,16,0,0,0,0,0,0,0,0
"Nov 17, 2019 8:00 AM",17,6,11,,,,,,,,,,9,1,8,7,,,,3,1,2,9,22,12,8,4,14,0,2,2,1,1,0,0,0
"Nov 17, 2019 9:00 AM",37,21,16,,,,,,,,,,8,4,4,3,,,,13,7,6,16,12,14,11,3,24,3,16,5,2,3,0,0,0
"Nov 17, 2019 10:00 AM",32,23,9,,,,,,,,,,22,8,14,6,,,,11,8,3,13,18,19,6,13,49,9,2,6,0,6,7,4,3
"Nov 17, 2019 11:00 AM",36,21,15,,,,,,,,,,17,7,10,3,,,,5,4,1,12,31,19,9,10,26,4,3,4,4,0,2,0,2
"Nov 17, 2019 12:00 PM",47,28,19,,,,,,,,,,22,14,8,10,,,,26,26,0,13,34,27,10,17,20,3,3,3,2,1,0,0,0
"Nov 17, 2019 1:00 PM",48,29,19,,,,,,,,,,25,13,12,3,,,,24,23,1,12,23,25,3,22,37,6,3,3,1,2,1,0,1
"Nov 17, 2019 2:00 PM",62,41,21,,,,,,,,,,18,10,8,10,,,,12,12,0,16,20,28,13,15,26,1,2,5,1,4,2,1,1
"Nov 17, 2019 3:00 PM",44,21,23,,,,,,,,,,29,14,15,23,,,,13,12,1,17,19,14,8,6,30,2,1,3,2,1,1,1,0
"Nov 17, 2019 4:00 PM",50,22,28,,,,,,,,,,18,13,5,6,,,,13,11,2,13,10,13,9,4,16,0,5,5,2,3,0,0,0
"Nov 17, 2019 5:00 PM",54,18,36,,,,,,,,,,11,7,4,8,,,,16,13,3,14,12,7,3,4,10,1,1,3,1,2,0,0,0
"Nov 17, 2019 6:00 PM",37,11,26,,,,,,,,,,2,1,1,1,,,,8,7,1,15,11,3,2,1,13,2,0,0,0,0,0,0,0
"Nov 17, 2019 7:00 PM",27,10,17,,,,,,,,,,3,2,1,10,,,,8,8,0,5,3,0,0,0,10,1,0,0,0,0,0,0,0
"Nov 17, 2019 8:00 PM",28,8,20,,,,,,,,,,3,0,3,4,,,,14,12,2,3,3,1,1,0,7,1,0,1,0,1,1,1,0
"Nov 17, 2019 9:00 PM",18,3,15,,,,,,,,,,2,1,1,1,,,,3,3,0,6,0,3,2,1,4,1,1,1,0,1,0,0,0
"Nov 17, 2019 10:00 PM",10,5,5,,,,,,,,,,0,0,0,0,,,,4,3,1,2,5,1,0,1,4,1,1,2,1,1,1,0,1
"Nov 17, 2019 11:00 PM",4,1,3,,,,,,,,,,2,2,0,1,,,,1,1,0,4,1,2,2,0,1,0,1,1,0,1,1,1,0
"Nov 18, 2019 12:00 AM",9,1,8,,,,,,,,,,0,0,0,0,,,,0,0,0,0,2,2,1,1,1,0,1,1,0,1,0,0,0
"Nov 18, 2019 1:00 AM",0,0,0,,,,,,,,,,0,0,0,0,,,,0,0,0,0,2,0,0,0,0,0,0,0,0,0,0,0,0
"Nov 18, 2019 2:00 AM",1,0,1,,,,,,,,,,0,0,0,0,,,,1,1,0,0,0,0,0,0,0,0,0,0,0,0,0,0,0
"Nov 18, 2019 3:00 AM",0,0,0,,,,,,,,,,0,0,0,1,,,,1,1,0,0,0,0,0,0,0,0,0,0,0,0,0,0,0
"Nov 18, 2019 4:00 AM",5,2,3,,,,,,,,,,0,0,0,0,,,,0,0,0,1,0,0,0,0,2,0,0,0,0,0,0,0,0
"Nov 18, 2019 5:00 AM",3,3,0,,,,,,,,,,0,0,0,1,,,,0,0,0,6,4,1,1,0,9,2,0,0,0,0,0,0,0
"Nov 18, 2019 6:00 AM",50,34,16,,,,,,,,,,1,0,1,3,,,,8,7,1,30,10,5,4,1,39,2,0,1,0,1,0,0,0
"Nov 18, 2019 7:00 AM",164,124,40,,,,,,,,,,8,1,7,15,,,,36,29,7,111,25,33,22,11,159,1,8,4,4,0,1,0,1
"Nov 18, 2019 8:00 AM",416,346,70,,,,,,,,,,24,8,16,23,,,,57,29,28,287,64,90,74,16,332,5,6,10,7,3,5,0,5
"Nov 18, 2019 9:00 AM",268,231,37,,,,,,,,,,19,8,11,13,,,,33,18,15,146,19,53,38,15,90,1,3,7,1,6,3,1,2
"Nov 18, 2019 10:00 AM",117,94,23,,,,,,,,,,5,0,5,8,,,,18,8,10,53,8,16,7,9,31,2,0,4,3,1,1,0,1
"Nov 18, 2019 11:00 AM",85,67,18,,,,,,,,,,9,7,2,3,,,,13,9,4,34,12,8,3,5,25,2,1,2,1,1,1,1,0
"Nov 18, 2019 12:00 PM",59,27,32,,,,,,,,,,21,12,9,4,,,,17,14,3,25,13,11,5,6,25,0,2,2,2,0,0,0,0
"Nov 18, 2019 1:00 PM",100,40,60,,,,,,,,,,15,9,6,12,,,,33,26,7,21,20,15,5,10,24,2,2,3,0,3,0,0,0
"Nov 18, 2019 2:00 PM",92,42,50,,,,,,,,,,8,3,5,7,,,,31,26,5,16,19,15,8,7,20,4,3,3,2,1,3,1,2
"Nov 18, 2019 3:00 PM",73,19,54,,,,,,,,,,10,7,3,13,,,,38,35,3,19,28,14,3,11,26,6,1,6,6,0,3,2,1
"Nov 18, 2019 4:00 PM",178,41,137,,,,,,,,,,14,8,6,16,,,,92,89,3,32,77,28,7,21,48,2,2,4,2,2,2,2,0
"Nov 18, 2019 5:00 PM",331,51,280,,,,,,,,,,14,9,5,30,,,,182,174,8,41,142,66,6,60,67,8,3,0,0,0,0,0,0
"Nov 18, 2019 6:00 PM",302,52,250,,,,,,,,,,16,14,2,26,,,,186,178,8,36,128,88,9,79,34,3,3,2,2,0,2,0,2
"Nov 18, 2019 7:00 PM",175,38,137,,,,,,,,,,6,5,1,14,,,,86,82,4,17,69,32,2,30,25,2,1,2,1,1,0,0,0
"Nov 18, 2019 8:00 PM",96,18,78,,,,,,,,,,4,3,1,2,,,,52,51,1,6,31,12,0,12,14,4,0,3,1,2,0,0,0
"Nov 18, 2019 9:00 PM",75,8,67,,,,,,,,,,2,1,1,7,,,,28,28,0,6,18,9,1,8,13,2,1,0,0,0,1,1,0
"Nov 18, 2019 10:00 PM",56,2,54,,,,,,,,,,0,0,0,3,,,,25,25,0,7,20,10,5,5,8,0,1,3,3,0,2,2,0
"Nov 18, 2019 11:00 PM",16,3,13,,,,,,,,,,2,2,0,2,,,,11,9,2,4,10,1,1,0,4,0,0,1,0,1,1,0,1
"Nov 19, 2019 12:00 AM",4,0,4,,,,,,,,,,1,1,0,4,,,,2,2,0,2,3,1,0,1,2,0,1,0,0,0,1,1,0
"Nov 19, 2019 1:00 AM",4,2,2,,,,,,,,,,0,0,0,0,,,,1,1,0,1,1,0,0,0,0,1,0,0,0,0,0,0,0
"Nov 19, 2019 2:00 AM",6,3,3,,,,,,,,,,0,0,0,0,,,,0,0,0,1,0,0,0,0,0,0,0,0,0,0,0,0,0
"Nov 19, 2019 3:00 AM",2,1,1,,,,,,,,,,0,0,0,1,,,,0,0,0,0,0,0,0,0,0,0,0,0,0,0,0,0,0
"Nov 19, 2019 4:00 AM",4,0,4,,,,,,,,,,0,0,0,0,,,,1,1,0,1,0,0,0,0,2,0,0,0,0,0,0,0,0
"Nov 19, 2019 5:00 AM",4,3,1,,,,,,,,,,0,0,0,3,,,,1,0,1,4,2,0,0,0,8,2,0,0,0,0,0,0,0
"Nov 19, 2019 6:00 AM",58,44,14,,,,,,,,,,1,0,1,4,,,,14,10,4,20,13,2,1,1,42,2,1,3,2,1,0,0,0
"Nov 19, 2019 7:00 AM",202,149,53,,,,,,,,,,9,4,5,14,,,,31,27,4,126,39,24,21,3,156,4,5,4,4,0,0,0,0
"Nov 19, 2019 8:00 AM",449,364,85,,,,,,,,,,32,12,20,29,,,,44,28,16,317,53,82,65,17,346,5,7,10,7,3,2,0,2
"Nov 19, 2019 9:00 AM",233,201,32,,,,,,,,,,9,5,4,13,,,,30,8,22,148,23,50,35,15,106,1,3,2,1,1,0,0,0
"Nov 19, 2019 10:00 AM",98,77,21,,,,,,,,,,5,2,3,4,,,,16,9,7,57,6,15,9,6,23,1,2,3,1,2,2,1,1
"Nov 19, 2019 11:00 AM",77,51,26,,,,,,,,,,5,2,3,7,,,,16,12,4,26,11,6,1,5,17,2,1,2,0,2,1,1,0
"Nov 19, 2019 12:00 PM",72,38,34,,,,,,,,,,4,4,0,2,,,,22,17,5,20,13,4,3,1,13,1,0,2,2,0,0,0,0
"Nov 19, 2019 1:00 PM",93,40,53,,,,,,,,,,9,6,3,8,,,,30,18,12,20,16,12,1,11,20,3,2,6,3,3,1,1,0
"Nov 19, 2019 2:00 PM",77,32,45,,,,,,,,,,13,5,8,6,,,,28,24,4,14,23,11,4,7,21,1,1,2,1,1,1,1,0
"Nov 19, 2019 3:00 PM",85,25,60,,,,,,,,,,5,3,2,10,,,,39,33,6,20,28,15,3,12,27,1,0,2,2,0,1,1,0
"Nov 19, 2019 4:00 PM",159,48,111,,,,,,,,,,7,5,2,16,,,,82,80,2,16,68,25,6,19,33,1,2,5,2,3,2,1,1
"Nov 19, 2019 5:00 PM",354,69,285,,,,,,,,,,8,4,4,21,,,,174,172,2,47,159,54,5,49,63,2,2,2,2,0,1,1,0
"Nov 19, 2019 6:00 PM",327,64,263,,,,,,,,,,16,14,2,25,,,,180,170,10,30,152,75,7,68,44,2,2,2,1,1,0,0,0
"Nov 19, 2019 7:00 PM",172,23,149,,,,,,,,,,13,10,3,8,,,,118,114,4,12,49,25,2,23,25,9,0,3,3,0,2,1,1
"Nov 19, 2019 8:00 PM",127,16,111,,,,,,,,,,4,2,2,2,,,,51,50,1,12,46,12,0,12,15,4,4,1,1,0,0,0,0
"Nov 19, 2019 9:00 PM",73,9,64,,,,,,,,,,2,1,1,6,,,,32,32,0,5,21,16,2,14,8,1,2,4,3,1,1,0,1
"Nov 19, 2019 10:00 PM",40,1,39,,,,,,,,,,1,1,0,8,,,,26,26,0,2,18,8,3,5,9,1,1,2,1,1,1,1,0
"Nov 19, 2019 11:00 PM",23,6,17,,,,,,,,,,1,0,1,0,,,,9,9,0,3,7,2,1,1,3,0,0,1,0,1,0,0,0
"Nov 20, 2019 12:00 AM",6,2,4,,,,,,,,,,0,0,0,0,,,,3,3,0,1,3,0,0,0,0,0,1,0,0,0,0,0,0
"Nov 20, 2019 1:00 AM",3,0,3,,,,,,,,,,0,0,0,1,,,,1,1,0,1,1,1,0,1,1,0,0,0,0,0,0,0,0
"Nov 20, 2019 2:00 AM",2,2,0,,,,,,,,,,0,0,0,1,,,,1,1,0,1,0,0,0,0,1,1,0,0,0,0,0,0,0
"Nov 20, 2019 3:00 AM",1,1,0,,,,,,,,,,0,0,0,0,,,,1,1,0,0,0,0,0,0,0,0,0,0,0,0,0,0,0
"Nov 20, 2019 4:00 AM",2,1,1,,,,,,,,,,0,0,0,0,,,,0,0,0,2,0,0,0,0,1,0,0,0,0,0,0,0,0
"Nov 20, 2019 5:00 AM",4,4,0,,,,,,,,,,0,0,0,2,,,,2,0,2,6,2,0,0,0,9,2,0,0,0,0,0,0,0
"Nov 20, 2019 6:00 AM",47,30,17,,,,,,,,,,1,0,1,5,,,,8,8,0,16,8,1,0,1,33,0,0,2,1,1,0,0,0
"Nov 20, 2019 7:00 AM",156,123,33,,,,,,,,,,2,1,1,11,,,,20,13,7,88,27,16,10,6,99,0,3,3,1,2,1,0,1
"Nov 20, 2019 8:00 AM",310,258,52,,,,,,,,,,14,4,10,25,,,,30,17,13,195,54,53,40,13,198,4,4,4,3,1,3,0,3
"Nov 20, 2019 9:00 AM",198,168,30,,,,,,,,,,13,6,7,4,,,,28,14,14,95,27,29,20,9,91,0,1,1,1,0,0,0,0
"Nov 20, 2019 10:00 AM",84,72,12,,,,,,,,,,2,1,1,7,,,,20,9,11,42,6,9,5,4,25,1,2,2,2,0,1,0,1
"Nov 20, 2019 11:00 AM",62,44,18,,,,,,,,,,3,1,2,6,,,,7,5,2,20,5,0,0,0,7,0,1,0,0,0,0,0,0
"Nov 20, 2019 12:00 PM",49,30,19,,,,,,,,,,7,4,3,3,,,,15,13,2,16,10,7,4,3,19,0,2,2,0,2,0,0,0
"Nov 20, 2019 1:00 PM",68,27,41,,,,,,,,,,5,2,3,11,,,,27,20,7,14,10,3,1,2,13,1,1,2,0,2,0,0,0
"Nov 20, 2019 2:00 PM",64,26,38,,,,,,,,,,3,2,1,4,,,,22,20,2,13,19,4,2,2,22,3,0,2,2,0,0,0,0
"Nov 20, 2019 3:00 PM",71,22,49,,,,,,,,,,7,3,4,9,,,,27,27,0,19,20,15,1,14,21,4,1,4,2,2,2,1,1
"Nov 20, 2019 4:00 PM",142,31,111,,,,,,,,,,7,5,2,15,,,,63,56,7,20,43,19,5,14,23,6,0,5,3,2,3,3,0
"Nov 20, 2019 5:00 PM",262,46,216,,,,,,,,,,4,2,2,22,,,,108,108,0,39,80,35,7,28,55,5,1,1,1,0,1,1,0
"Nov 20, 2019 6:00 PM",301,61,240,,,,,,,,,,9,6,3,19,,,,134,128,6,24,122,44,4,40,34,3,0,2,2,0,0,0,0
"Nov 20, 2019 7:00 PM",140,25,115,,,,,,,,,,7,7,0,6,,,,62,59,3,9,55,24,3,21,17,2,3,4,2,2,2,2,0
"Nov 20, 2019 8:00 PM",103,15,88,,,,,,,,,,3,2,1,10,,,,51,44,7,18,24,5,0,5,12,1,1,5,4,1,1,0,1
"Nov 20, 2019 9:00 PM",66,5,61,,,,,,,,,,4,1,3,5,,,,24,23,1,7,15,7,1,6,11,1,0,0,0,0,1,1,0
"Nov 20, 2019 10:00 PM",47,8,39,,,,,,,,,,0,0,0,2,,,,20,17,3,4,10,1,0,1,3,0,2,0,0,0,1,0,1
"Nov 20, 2019 11:00 PM",22,6,16,,,,,,,,,,2,1,1,1,,,,8,7,1,0,4,2,1,1,2,0,0,1,1,0,0,0,0
"Nov 21, 2019 12:00 AM",10,3,7,,,,,,,,,,0,0,0,1,,,,2,1,1,0,3,3,1,2,2,1,0,0,0,0,0,0,0
"Nov 21, 2019 1:00 AM",3,0,3,,,,,,,,,,0,0,0,0,,,,2,2,0,2,0,0,0,0,0,0,2,0,0,0,0,0,0
"Nov 21, 2019 2:00 AM",4,3,1,,,,,,,,,,0,0,0,0,,,,1,1,0,1,0,0,0,0,0,0,0,0,0,0,0,0,0
"Nov 21, 2019 3:00 AM",3,0,3,,,,,,,,,,0,0,0,0,,,,0,0,0,0,1,0,0,0,1,0,0,0,0,0,0,0,0
"Nov 21, 2019 4:00 AM",3,1,2,,,,,,,,,,0,0,0,0,,,,2,0,2,1,0,0,0,0,0,0,0,0,0,0,0,0,0
"Nov 21, 2019 5:00 AM",3,3,0,,,,,,,,,,0,0,0,1,,,,2,0,2,9,3,1,1,0,3,1,0,0,0,0,0,0,0
"Nov 21, 2019 6:00 AM",40,26,14,,,,,,,,,,2,0,2,5,,,,11,7,4,19,7,3,2,1,32,0,0,1,0,1,0,0,0
"Nov 21, 2019 7:00 AM",124,94,30,,,,,,,,,,4,3,1,5,,,,20,14,6,73,15,15,9,6,105,1,2,4,3,1,2,0,2
"Nov 21, 2019 8:00 AM",290,241,49,,,,,,,,,,8,3,5,22,,,,40,26,14,172,33,46,41,5,188,3,3,3,3,0,0,0,0
"Nov 21, 2019 9:00 AM",173,155,18,,,,,,,,,,5,3,2,7,,,,14,3,11,95,20,18,10,8,68,1,4,1,1,0,1,0,1
"Nov 21, 2019 10:00 AM",65,56,9,,,,,,,,,,6,3,3,2,,,,14,6,8,31,8,8,5,3,26,0,1,2,2,0,2,0,2
"Nov 21, 2019 11:00 AM",62,49,13,,,,,,,,,,0,0,0,1,,,,10,6,4,34,7,4,3,1,14,0,0,2,0,2,0,0,0
"Nov 21, 2019 12:00 PM",58,32,26,,,,,,,,,,7,3,4,6,,,,15,12,3,20,11,3,1,2,16,2,0,6,2,4,0,0,0
"Nov 21, 2019 1:00 PM",71,35,36,,,,,,,,,,5,2,3,10,,,,19,12,7,15,16,6,3,3,19,0,3,0,0,0,0,0,0
"Nov 21, 2019 2:00 PM",86,44,42,,,,,,,,,,7,1,6,2,,,,25,19,6,17,10,16,4,12,16,2,2,2,2,0,0,0,0
"Nov 21, 2019 3:00 PM",91,24,67,,,,,,,,,,5,2,3,10,,,,37,31,6,23,22,10,2,8,13,4,1,5,4,1,1,0,1
"Nov 21, 2019 4:00 PM",123,25,98,,,,,,,,,,9,2,7,7,,,,42,39,3,15,45,19,6,13,16,4,3,2,2,0,3,3,0
"Nov 21, 2019 5:00 PM",249,43,206,,,,,,,,,,5,3,2,11,,,,118,113,5,32,91,35,5,30,38,3,0,3,2,1,0,0,0
"Nov 21, 2019 6:00 PM",257,48,209,,,,,,,,,,9,4,5,19,,,,117,116,1,19,98,35,3,32,32,3,1,3,0,3,1,1,0
"Nov 21, 2019 7:00 PM",142,21,121,,,,,,,,,,8,0,8,10,,,,59,58,1,11,33,18,0,18,17,4,2,4,2,2,0,0,0
"Nov 21, 2019 8:00 PM",82,15,67,,,,,,,,,,3,2,1,5,,,,32,30,2,5,29,7,1,6,8,2,2,2,1,1,1,1,0
"Nov 21, 2019 9:00 PM",65,9,56,,,,,,,,,,2,0,2,4,,,,27,26,1,2,11,6,1,5,7,3,1,2,2,0,0,0,0
"Nov 21, 2019 10:00 PM",36,3,33,,,,,,,,,,2,0,2,0,,,,16,15,1,5,8,0,0,0,5,2,0,0,0,0,1,0,1
"Nov 21, 2019 11:00 PM",31,5,26,,,,,,,,,,2,2,0,1,,,,11,10,1,0,11,1,1,0,3,0,0,1,0,1,0,0,0
"Nov 22, 2019 12:00 AM",8,3,5,,,,,,,,,,1,0,1,2,,,,1,0,1,2,1,0,0,0,4,0,1,0,0,0,0,0,0
"Nov 22, 2019 1:00 AM",6,2,4,,,,,,,,,,0,0,0,0,,,,3,3,0,0,3,0,0,0,0,0,1,0,0,0,0,0,0
"Nov 22, 2019 2:00 AM",6,4,2,,,,,,,,,,0,0,0,0,,,,2,2,0,0,1,2,0,2,1,0,0,0,0,0,0,0,0
"Nov 22, 2019 3:00 AM",2,1,1,,,,,,,,,,0,0,0,0,,,,0,0,0,0,2,1,0,1,0,0,0,0,0,0,0,0,0
"Nov 22, 2019 4:00 AM",2,0,2,,,,,,,,,,1,1,0,0,,,,1,1,0,1,0,0,0,0,1,0,0,0,0,0,0,0,0
"Nov 22, 2019 5:00 AM",6,5,1,,,,,,,,,,0,0,0,1,,,,0,0,0,8,5,0,0,0,5,3,0,0,0,0,0,0,0
"Nov 22, 2019 6:00 AM",34,24,10,,,,,,,,,,2,0,2,7,,,,7,6,1,21,8,3,3,0,38,1,0,1,1,0,0,0,0
"Nov 22, 2019 7:00 AM",120,84,36,,,,,,,,,,5,2,3,13,,,,22,16,6,63,24,15,10,5,84,2,5,0,0,0,1,0,1
"Nov 22, 2019 8:00 AM",286,234,52,,,,,,,,,,15,6,9,22,,,,41,26,15,184,42,43,35,8,206,7,4,7,3,4,4,0,4
"Nov 22, 2019 9:00 AM",198,165,33,,,,,,,,,,13,1,12,10,,,,25,7,18,94,23,35,20,15,78,0,3,4,2,2,0,0,0
"Nov 22, 2019 10:00 AM",88,69,19,,,,,,,,,,4,1,3,3,,,,22,12,10,40,9,18,14,4,27,2,2,6,2,4,4,3,1
"Nov 22, 2019 11:00 AM",61,39,22,,,,,,,,,,7,1,6,2,,,,13,10,3,26,6,5,3,2,19,0,1,0,0,0,0,0,0
"Nov 22, 2019 12:00 PM",75,33,42,,,,,,,,,,11,7,4,6,,,,15,13,2,24,15,5,2,3,20,2,0,7,5,2,1,1,0
"Nov 22, 2019 1:00 PM",79,27,52,,,,,,,,,,3,3,0,8,,,,19,16,3,11,18,15,4,11,26,0,1,3,1,2,1,1,0
"Nov 22, 2019 2:00 PM",58,20,38,,,,,,,,,,0,0,0,7,,,,30,26,4,11,16,8,2,6,12,4,0,3,3,0,0,0,0
"Nov 22, 2019 3:00 PM",88,26,62,,,,,,,,,,5,4,1,12,,,,34,32,2,15,21,7,1,6,17,4,1,1,1,0,1,1,0
"Nov 22, 2019 4:00 PM",139,28,111,,,,,,,,,,5,5,0,12,,,,61,58,3,16,57,17,5,12,28,4,1,1,1,0,2,2,0
"Nov 22, 2019 5:00 PM",214,33,181,,,,,,,,,,15,11,4,16,,,,108,107,1,17,101,44,4,40,35,6,3,2,2,0,0,0,0
"Nov 22, 2019 6:00 PM",165,36,129,,,,,,,,,,8,8,0,13,,,,88,87,1,18,89,33,4,29,29,2,1,5,2,3,0,0,0
"Nov 22, 2019 7:00 PM",77,8,69,,,,,,,,,,1,0,1,7,,,,46,46,0,3,33,16,2,14,7,0,0,1,0,1,0,0,0
"Nov 22, 2019 8:00 PM",41,8,33,,,,,,,,,,6,5,1,1,,,,17,17,0,4,9,7,0,7,8,1,3,2,2,0,2,2,0
"Nov 22, 2019 9:00 PM",28,5,23,,,,,,,,,,0,0,0,1,,,,8,8,0,4,8,3,0,3,10,0,0,1,0,1,1,1,0
"Nov 22, 2019 10:00 PM",18,1,17,,,,,,,,,,1,1,0,2,,,,4,3,1,3,6,4,1,3,1,1,0,0,0,0,0,0,0
"Nov 22, 2019 11:00 PM",14,4,10,,,,,,,,,,1,1,0,0,,,,6,6,0,4,2,1,0,1,1,0,0,0,0,0,0,0,0
"Nov 23, 2019 12:00 AM",13,2,11,,,,,,,,,,1,0,1,0,,,,5,5,0,0,6,2,2,0,2,0,0,1,1,0,0,0,0
"Nov 23, 2019 1:00 AM",1,0,1,,,,,,,,,,0,0,0,0,,,,5,5,0,1,3,1,1,0,2,0,2,2,1,1,0,0,0
"Nov 23, 2019 2:00 AM",5,3,2,,,,,,,,,,0,0,0,1,,,,2,2,0,0,2,1,0,1,0,0,2,0,0,0,0,0,0
"Nov 23, 2019 3:00 AM",3,2,1,,,,,,,,,,0,0,0,0,,,,0,0,0,1,0,0,0,0,0,1,0,1,0,1,0,0,0
"Nov 23, 2019 4:00 AM",1,0,1,,,,,,,,,,0,0,0,0,,,,0,0,0,0,0,0,0,0,1,0,0,0,0,0,0,0,0
"Nov 23, 2019 5:00 AM",1,0,1,,,,,,,,,,0,0,0,0,,,,1,1,0,0,1,0,0,0,3,1,0,0,0,0,0,0,0
"Nov 23, 2019 6:00 AM",9,4,5,,,,,,,,,,1,1,0,2,,,,3,3,0,3,5,0,0,0,6,1,0,0,0,0,0,0,0
"Nov 23, 2019 7:00 AM",11,6,5,,,,,,,,,,1,0,1,0,,,,4,3,1,4,6,0,0,0,4,0,0,0,0,0,0,0,0
"Nov 23, 2019 8:00 AM",11,8,3,,,,,,,,,,4,4,0,3,,,,3,3,0,7,11,2,0,2,12,0,1,0,0,0,0,0,0
"Nov 23, 2019 9:00 AM",30,26,4,,,,,,,,,,7,3,4,8,,,,4,3,1,14,12,4,2,2,18,2,1,0,0,0,0,0,0
"Nov 23, 2019 10:00 AM",36,22,14,,,,,,,,,,2,1,1,9,,,,4,2,2,12,5,2,2,0,12,2,2,0,0,0,1,1,0
"Nov 23, 2019 11:00 AM",36,19,17,,,,,,,,,,2,2,0,7,,,,9,7,2,11,4,5,1,4,5,1,2,1,1,0,1,0,1
"Nov 23, 2019 12:00 PM",40,26,14,,,,,,,,,,5,5,0,8,,,,6,4,2,11,5,3,2,1,15,3,1,4,1,3,1,0,1
"Nov 23, 2019 1:00 PM",29,9,20,,,,,,,,,,7,7,0,14,,,,16,13,3,7,14,17,7,10,16,1,1,2,1,1,0,0,0
"Nov 23, 2019 2:00 PM",37,24,13,,,,,,,,,,5,3,2,9,,,,7,7,0,10,6,8,2,6,15,1,5,2,2,0,0,0,0
"Nov 23, 2019 3:00 PM",41,19,22,,,,,,,,,,16,7,9,6,,,,16,15,1,15,7,9,5,4,14,1,3,3,1,2,1,1,0
"Nov 23, 2019 4:00 PM",48,17,31,,,,,,,,,,4,4,0,8,,,,13,11,2,7,10,8,1,7,14,1,1,0,0,0,0,0,0
"Nov 23, 2019 5:00 PM",35,14,21,,,,,,,,,,3,1,2,2,,,,15,15,0,10,8,7,2,5,9,2,2,0,0,0,0,0,0
"Nov 23, 2019 6:00 PM",37,13,24,,,,,,,,,,1,0,1,5,,,,11,9,2,5,13,6,1,5,10,4,0,1,1,0,0,0,0
"Nov 23, 2019 7:00 PM",32,9,23,,,,,,,,,,0,0,0,3,,,,7,6,1,9,6,3,0,3,13,1,0,2,2,0,0,0,0
"Nov 23, 2019 8:00 PM",26,11,15,,,,,,,,,,4,0,4,0,,,,5,4,1,4,4,8,2,6,12,1,0,0,0,0,0,0,0
"Nov 23, 2019 9:00 PM",16,6,10,,,,,,,,,,3,3,0,5,,,,4,4,0,2,3,5,3,2,1,0,0,1,0,1,0,0,0
"Nov 23, 2019 10:00 PM",13,4,9,,,,,,,,,,3,0,3,0,,,,2,2,0,2,2,0,0,0,3,0,0,1,1,0,1,0,1
"Nov 23, 2019 11:00 PM",8,3,5,,,,,,,,,,1,1,0,1,,,,6,6,0,4,5,1,0,1,5,0,0,1,0,1,0,0,0
"Nov 24, 2019 12:00 AM",8,3,5,,,,,,,,,,0,0,0,1,,,,3,2,1,1,4,3,1,2,2,0,0,0,0,0,0,0,0
"Nov 24, 2019 1:00 AM",4,1,3,,,,,,,,,,0,0,0,0,,,,5,4,1,1,2,2,1,1,3,0,0,0,0,0,0,0,0
"Nov 24, 2019 2:00 AM",3,1,2,,,,,,,,,,0,0,0,0,,,,1,1,0,0,3,1,1,0,2,0,1,0,0,0,0,0,0
"Nov 24, 2019 3:00 AM",2,1,1,,,,,,,,,,0,0,0,3,,,,1,1,0,0,1,1,0,1,3,1,1,1,0,1,0,0,0
"Nov 24, 2019 4:00 AM",4,0,4,,,,,,,,,,0,0,0,1,,,,2,2,0,1,0,0,0,0,1,0,0,0,0,0,0,0,0
"Nov 24, 2019 5:00 AM",2,1,1,,,,,,,,,,0,0,0,0,,,,2,2,0,0,1,0,0,0,4,0,0,0,0,0,0,0,0
"Nov 24, 2019 6:00 AM",12,5,7,,,,,,,,,,1,1,0,0,,,,2,2,0,1,6,2,0,2,9,1,0,0,0,0,0,0,0
"Nov 24, 2019 7:00 AM",16,8,8,,,,,,,,,,2,2,0,3,,,,5,3,2,5,13,3,2,1,9,1,0,1,0,1,1,0,1
"Nov 24, 2019 8:00 AM",32,17,15,,,,,,,,,,4,4,0,9,,,,10,7,3,7,11,5,1,4,15,0,6,0,0,0,0,0,0
"Nov 24, 2019 9:00 AM",41,27,14,,,,,,,,,,8,8,0,2,,,,12,8,4,45,21,25,14,11,27,6,6,3,2,1,1,0,1
"Nov 24, 2019 10:00 AM",43,25,18,,,,,,,,,,10,10,0,11,,,,8,6,2,19,18,21,8,13,45,2,1,4,1,3,0,0,0
"Nov 24, 2019 11:00 AM",42,22,20,,,,,,,,,,29,27,2,4,,,,12,10,2,9,21,21,5,16,23,11,6,1,0,1,1,0,1
"Nov 24, 2019 12:00 PM",44,28,16,,,,,,,,,,19,18,1,12,,,,24,22,2,17,24,24,9,15,33,3,0,2,2,0,0,0,0
"Nov 24, 2019 1:00 PM",61,28,33,,,,,,,,,,16,11,5,9,,,,13,10,3,15,39,11,3,8,25,6,0,0,0,0,1,0,1
"Nov 24, 2019 2:00 PM",44,21,23,,,,,,,,,,16,16,0,25,,,,13,9,4,13,10,12,3,9,20,3,3,4,4,0,2,0,2
"Nov 24, 2019 3:00 PM",44,25,19,,,,,,,,,,25,23,2,13,,,,13,13,0,16,13,27,10,17,17,1,2,0,0,0,0,0,0
"Nov 24, 2019 4:00 PM",33,13,20,,,,,,,,,,18,16,2,11,,,,14,14,0,17,10,8,4,4,16,3,1,2,1,1,0,0,0
"Nov 24, 2019 5:00 PM",44,17,27,,,,,,,,,,13,13,0,6,,,,17,17,0,11,7,3,1,2,18,0,0,1,0,1,2,2,0
"Nov 24, 2019 6:00 PM",35,8,27,,,,,,,,,,11,11,0,3,,,,10,7,3,3,10,6,4,2,14,3,1,3,1,2,1,1,0
"Nov 24, 2019 7:00 PM",32,6,26,,,,,,,,,,1,1,0,3,,,,5,5,0,1,5,2,2,0,5,0,0,1,1,0,1,1,0
"Nov 24, 2019 8:00 PM",26,4,22,,,,,,,,,,2,2,0,1,,,,5,5,0,4,11,2,1,1,4,0,0,0,0,0,1,0,1
"Nov 24, 2019 9:00 PM",21,5,16,,,,,,,,,,1,0,1,1,,,,6,6,0,4,4,4,0,4,1,0,1,1,0,1,0,0,0
"Nov 24, 2019 10:00 PM",9,4,5,,,,,,,,,,0,0,0,0,,,,7,7,0,2,1,0,0,0,1,1,0,0,0,0,0,0,0
"Nov 24, 2019 11:00 PM",9,6,3,,,,,,,,,,0,0,0,0,,,,1,1,0,3,2,0,0,0,2,0,0,0,0,0,0,0,0
"Nov 25, 2019 12:00 AM",4,1,3,,,,,,,,,,0,0,0,0,,,,0,0,0,1,4,1,1,0,0,0,1,0,0,0,0,0,0
"Nov 25, 2019 1:00 AM",1,0,1,,,,,,,,,,0,0,0,0,,,,0,0,0,1,0,0,0,0,0,0,0,0,0,0,0,0,0
"Nov 25, 2019 2:00 AM",2,1,1,,,,,,,,,,0,0,0,1,,,,1,1,0,0,0,0,0,0,0,0,0,0,0,0,0,0,0
"Nov 25, 2019 3:00 AM",1,0,1,,,,,,,,,,0,0,0,0,,,,0,0,0,0,0,0,0,0,1,0,0,0,0,0,0,0,0
"Nov 25, 2019 4:00 AM",1,0,1,,,,,,,,,,0,0,0,0,,,,0,0,0,0,0,0,0,0,0,0,0,0,0,0,0,0,0
"Nov 25, 2019 5:00 AM",5,5,0,,,,,,,,,,0,0,0,2,,,,1,1,0,5,2,0,0,0,10,3,0,0,0,0,0,0,0
"Nov 25, 2019 6:00 AM",38,25,13,,,,,,,,,,3,3,0,4,,,,6,4,2,22,9,4,2,2,30,1,0,1,0,1,0,0,0
"Nov 25, 2019 7:00 AM",153,126,27,,,,,,,,,,5,1,4,20,,,,24,18,6,102,28,25,19,6,131,4,5,4,4,0,2,0,2
"Nov 25, 2019 8:00 AM",389,307,82,,,,,,,,,,21,18,3,28,,,,49,30,19,249,67,71,59,12,285,5,6,6,4,2,1,0,1
"Nov 25, 2019 9:00 AM",232,203,29,,,,,,,,,,11,7,4,10,,,,31,11,20,133,20,42,27,15,131,0,3,3,1,2,0,0,0
"Nov 25, 2019 10:00 AM",104,86,18,,,,,,,,,,5,0,5,6,,,,17,4,13,39,14,11,6,5,38,1,0,2,0,2,0,0,0
"Nov 25, 2019 11:00 AM",63,53,10,,,,,,,,,,3,3,0,6,,,,7,6,1,25,10,6,2,4,16,2,1,3,0,3,0,0,0
"Nov 25, 2019 12:00 PM",65,33,32,,,,,,,,,,5,5,0,4,,,,8,8,0,32,9,7,3,4,15,0,0,0,0,0,0,0,0
"Nov 25, 2019 1:00 PM",82,41,41,,,,,,,,,,11,11,0,9,,,,30,25,5,20,14,13,2,11,15,2,1,3,2,1,2,0,2
"Nov 25, 2019 2:00 PM",74,32,42,,,,,,,,,,9,9,0,6,,,,38,34,4,18,16,6,1,5,14,5,2,2,1,1,1,0,1
"Nov 25, 2019 3:00 PM",96,26,70,,,,,,,,,,4,4,0,14,,,,36,32,4,21,20,14,4,10,23,5,2,5,2,3,2,2,0
"Nov 25, 2019 4:00 PM",162,33,129,,,,,,,,,,3,2,1,16,,,,69,67,2,16,45,25,7,18,25,6,6,2,2,0,1,1,0
"Nov 25, 2019 5:00 PM",299,52,247,,,,,,,,,,12,5,7,18,,,,133,129,4,37,151,59,9,50,60,6,3,5,3,2,2,2,0
"Nov 25, 2019 6:00 PM",311,36,275,,,,,,,,,,11,1,10,21,,,,183,179,4,28,151,53,6,47,57,4,3,3,1,2,0,0,0
"Nov 25, 2019 7:00 PM",171,26,145,,,,,,,,,,4,2,2,8,,,,71,68,3,13,58,28,2,26,23,4,2,3,2,1,1,1,0
"Nov 25, 2019 8:00 PM",117,22,95,,,,,,,,,,6,6,0,1,,,,48,46,2,7,26,11,0,11,15,1,0,5,2,3,0,0,0
"Nov 25, 2019 9:00 PM",64,9,55,,,,,,,,,,0,0,0,3,,,,27,26,1,6,14,12,6,6,4,5,2,0,0,0,1,1,0
"Nov 25, 2019 10:00 PM",45,3,42,,,,,,,,,,2,2,0,3,,,,24,23,1,1,15,5,1,4,8,1,0,0,0,0,0,0,0
"Nov 25, 2019 11:00 PM",26,1,25,,,,,,,,,,0,0,0,2,,,,2,2,0,1,3,1,0,1,2,1,0,3,2,1,0,0,0
"Nov 26, 2019 12:00 AM",7,1,6,,,,,,,,,,1,0,1,0,,,,2,2,0,2,3,1,0,1,0,0,0,0,0,0,0,0,0
"Nov 26, 2019 1:00 AM",3,0,3,,,,,,,,,,0,0,0,0,,,,4,3,1,1,1,1,1,0,0,0,1,0,0,0,0,0,0
"Nov 26, 2019 2:00 AM",4,3,1,,,,,,,,,,0,0,0,0,,,,1,1,0,1,0,1,0,1,0,0,0,0,0,0,0,0,0
"Nov 26, 2019 3:00 AM",2,1,1,,,,,,,,,,0,0,0,1,,,,0,0,0,0,0,0,0,0,0,0,0,1,0,1,0,0,0
"Nov 26, 2019 4:00 AM",3,0,3,,,,,,,,,,0,0,0,0,,,,0,0,0,0,0,0,0,0,2,0,0,0,0,0,0,0,0
"Nov 26, 2019 5:00 AM",6,6,0,,,,,,,,,,0,0,0,2,,,,1,0,1,6,2,0,0,0,12,4,0,0,0,0,0,0,0
"Nov 26, 2019 6:00 AM",52,31,21,,,,,,,,,,0,0,0,3,,,,8,5,3,29,9,5,2,3,35,1,2,0,0,0,0,0,0
"Nov 26, 2019 7:00 AM",132,108,24,,,,,,,,,,8,5,3,10,,,,17,15,2,98,23,25,20,5,133,2,2,4,3,1,0,0,0
"Nov 26, 2019 8:00 AM",315,268,47,,,,,,,,,,13,10,3,21,,,,30,19,11,218,42,46,37,9,232,5,6,7,5,2,2,0,2
"Nov 26, 2019 9:00 AM",155,132,23,,,,,,,,,,7,6,1,3,,,,22,13,9,74,10,18,15,3,80,0,0,0,0,0,0,0,0
"Nov 26, 2019 10:00 AM",69,58,11,,,,,,,,,,1,1,0,6,,,,10,2,8,36,3,2,2,0,8,0,1,0,0,0,2,2,0
"Nov 26, 2019 11:00 AM",47,33,14,,,,,,,,,,7,2,5,6,,,,7,5,2,22,9,2,2,0,0,1,2,2,1,1,0,0,0
"Nov 26, 2019 12:00 PM",71,51,20,,,,,,,,,,5,4,1,11,,,,12,11,1,26,11,2,0,2,3,1,0,0,0,0,0,0,0
"Nov 26, 2019 1:00 PM",57,33,24,,,,,,,,,,5,4,1,8,,,,23,15,8,25,18,10,5,5,2,1,2,0,0,0,0,0,0
"Nov 26, 2019 2:00 PM",59,24,35,,,,,,,,,,4,3,1,7,,,,30,27,3,23,13,8,2,6,0,0,0,0,0,0,0,0,0
"Nov 26, 2019 3:00 PM",79,22,57,,,,,,,,,,13,6,7,12,,,,23,22,1,13,21,12,4,8,2,2,0,7,6,1,1,1,0
"Nov 26, 2019 4:00 PM",119,27,92,,,,,,,,,,7,6,1,7,,,,65,61,4,20,47,21,4,17,6,1,2,2,1,1,1,1,0
"Nov 26, 2019 5:00 PM",263,41,222,,,,,,,,,,8,7,1,21,,,,139,132,7,25,126,40,8,32,13,4,3,2,2,0,1,1,0
"Nov 26, 2019 6:00 PM",258,48,210,,,,,,,,,,11,11,0,12,,,,147,142,5,32,129,49,6,43,9,4,1,2,2,0,1,0,1
"Nov 26, 2019 7:00 PM",163,23,140,,,,,,,,,,7,4,3,10,,,,65,60,5,11,62,32,4,28,2,2,1,1,0,1,0,0,0
"Nov 26, 2019 8:00 PM",99,24,75,,,,,,,,,,4,1,3,3,,,,41,39,2,17,28,9,1,8,4,0,2,1,0,1,0,0,0
"Nov 26, 2019 9:00 PM",82,9,73,,,,,,,,,,2,0,2,5,,,,24,21,3,4,13,14,5,9,5,0,0,0,0,0,0,0,0
"Nov 26, 2019 10:00 PM",41,4,37,,,,,,,,,,1,1,0,4,,,,25,23,2,3,14,4,2,2,2,1,0,0,0,0,1,0,1
"Nov 26, 2019 11:00 PM",27,3,24,,,,,,,,,,1,1,0,0,,,,8,8,0,3,7,2,1,1,2,0,0,2,1,1,0,0,0
"Nov 27, 2019 12:00 AM",7,1,6,,,,,,,,,,0,0,0,0,,,,1,1,0,0,1,0,0,0,0,0,2,,,,1,1,0
"Nov 27, 2019 1:00 AM",2,1,1,,,,,,,,,,0,0,0,0,,,,0,0,0,1,0,0,0,0,0,0,0,,,,0,0,0
"Nov 27, 2019 2:00 AM",7,4,3,,,,,,,,,,1,0,1,2,,,,0,0,0,2,0,0,0,0,1,0,0,,,,0,0,0
"Nov 27, 2019 3:00 AM",1,0,1,,,,,,,,,,0,0,0,0,,,,1,1,0,0,0,1,0,1,0,0,0,,,,0,0,0
"Nov 27, 2019 4:00 AM",1,0,1,,,,,,,,,,0,0,0,0,,,,2,2,0,1,0,0,0,0,0,0,0,,,,0,0,0
"Nov 27, 2019 5:00 AM",5,4,1,,,,,,,,,,0,0,0,2,,,,1,0,1,8,1,0,0,0,1,1,0,,,,,,
"Nov 27, 2019 6:00 AM",58,39,19,,,,,,,,,,1,0,1,2,,,,9,8,1,16,12,6,3,3,15,1,0,,,,,,
"Nov 27, 2019 7:00 AM",181,151,30,,,,,,,,,,5,0,5,11,,,,30,24,6,121,34,32,25,7,144,4,5,,,,,,
"Nov 27, 2019 8:00 AM",347,284,63,,,,,,,,,,18,13,5,26,,,,52,35,17,241,62,68,56,12,278,6,7,,,,,,
"Nov 27, 2019 9:00 AM",217,181,36,,,,,,,,,,8,8,0,10,,,,27,13,14,118,26,36,26,10,108,2,1,,,,,,
"Nov 27, 2019 10:00 AM",89,78,11,,,,,,,,,,4,4,0,2,,,,13,7,6,60,10,9,6,3,21,1,3,,,,,,
"Nov 27, 2019 11:00 AM",61,47,14,,,,,,,,,,8,8,0,5,,,,14,8,6,40,14,11,1,10,26,4,0,,,,,,
"Nov 27, 2019 12:00 PM",78,47,31,,,,,,,,,,8,8,0,8,,,,13,8,5,26,19,9,4,5,24,1,2,,,,,,
"Nov 27, 2019 1:00 PM",80,38,42,,,,,,,,,,7,7,0,2,,,,27,20,7,22,32,7,4,3,23,0,2,,,,,,
"Nov 27, 2019 2:00 PM",72,36,36,,,,,,,,,,11,10,1,6,,,,39,32,7,14,27,13,3,10,22,3,3,,,,,,
"Nov 27, 2019 3:00 PM",85,30,55,,,,,,,,,,10,7,3,5,,,,30,29,1,24,19,14,2,12,18,5,1,0,0,0,0,0,0
"Nov 27, 2019 4:00 PM",146,28,118,,,,,,,,,,13,13,0,13,,,,81,74,7,19,51,20,6,14,37,6,4,13,5,8,3,1,2
"Nov 27, 2019 5:00 PM",298,61,237,,,,,,,,,,12,11,1,13,,,,142,139,3,37,131,57,9,48,61,7,3,3,2,1,1,1,0
"Nov 27, 2019 6:00 PM",313,58,255,,,,,,,,,,8,8,0,21,,,,157,148,9,28,151,66,6,60,44,6,1,3,2,1,3,2,1
"Nov 27, 2019 7:00 PM",144,23,121,,,,,,,,,,7,7,0,11,,,,79,76,3,17,58,33,4,29,15,0,2,0,0,0,0,0,0
"Nov 27, 2019 8:00 PM",110,11,99,,,,,,,,,,5,5,0,8,,,,49,48,1,12,41,12,0,12,22,1,2,1,0,1,0,0,0
"Nov 27, 2019 9:00 PM",90,12,78,,,,,,,,,,7,7,0,7,,,,39,37,2,7,24,12,2,10,7,1,1,1,1,0,1,1,0
"Nov 27, 2019 10:00 PM",62,4,58,,,,,,,,,,1,1,0,4,,,,17,17,0,3,18,4,0,4,9,1,0,0,0,0,2,1,1
"Nov 27, 2019 11:00 PM",21,5,16,,,,,,,,,,3,3,0,2,,,,12,12,0,1,8,2,0,2,2,0,0,1,0,1,0,0,0
"Nov 28, 2019 12:00 AM",9,4,5,,,,,,,,,,0,0,0,3,,,,4,4,0,1,8,2,0,2,2,0,0,1,1,0,0,0,0
"Nov 28, 2019 1:00 AM",3,0,3,,,,,,,,,,0,0,0,0,,,,1,1,0,1,2,0,0,0,0,0,0,0,0,0,0,0,0
"Nov 28, 2019 2:00 AM",3,3,0,,,,,,,,,,0,0,0,1,,,,1,1,0,1,0,0,0,0,1,0,0,0,0,0,0,0,0
"Nov 28, 2019 3:00 AM",3,1,2,,,,,,,,,,0,0,0,0,,,,0,0,0,0,0,0,0,0,1,0,0,0,0,0,0,0,0
"Nov 28, 2019 4:00 AM",2,0,2,,,,,,,,,,0,0,0,0,,,,0,0,0,1,0,0,0,0,0,0,0,0,0,0,0,0,0
"Nov 28, 2019 5:00 AM",7,7,0,,,,,,,,,,0,0,0,2,,,,0,0,0,5,3,0,0,0,11,2,0,0,0,0,0,0,0
"Nov 28, 2019 6:00 AM",55,39,16,,,,,,,,,,3,3,0,5,,,,11,8,3,28,12,3,2,1,45,3,2,2,2,0,1,0,1
"Nov 28, 2019 7:00 AM",176,140,36,,,,,,,,,,3,3,0,10,,,,24,18,6,87,33,24,16,8,137,4,6,2,2,0,2,0,2
"Nov 28, 2019 8:00 AM",376,307,69,,,,,,,,,,29,20,9,23,,,,43,30,13,251,46,63,48,15,260,6,6,7,5,2,2,0,2
"Nov 28, 2019 9:00 AM",206,179,27,,,,,,,,,,16,15,1,6,,,,33,13,20,121,17,40,30,10,108,6,4,9,4,5,2,1,1
"Nov 28, 2019 10:00 AM",94,77,17,,,,,,,,,,5,5,0,10,,,,19,10,9,69,14,23,11,12,30,1,3,3,0,3,1,1,0
"Nov 28, 2019 11:00 AM",60,45,15,,,,,,,,,,6,6,0,10,,,,11,9,2,27,5,7,3,4,18,1,0,1,1,0,0,0,0
"Nov 28, 2019 12:00 PM",50,28,22,,,,,,,,,,6,6,0,5,,,,23,21,2,12,16,5,3,2,19,0,1,1,1,0,0,0,0
"Nov 28, 2019 1:00 PM",64,26,38,,,,,,,,,,10,10,0,7,,,,14,9,5,17,21,9,0,9,17,1,1,2,0,2,1,1,0
"Nov 28, 2019 2:00 PM",84,30,54,,,,,,,,,,5,5,0,4,,,,28,26,2,16,8,7,3,4,17,1,1,1,0,1,1,1,0
"Nov 28, 2019 3:00 PM",92,27,65,,,,,,,,,,5,5,0,6,,,,41,34,7,13,26,12,3,9,23,4,0,8,4,4,1,1,0
"Nov 28, 2019 4:00 PM",163,29,134,,,,,,,,,,2,2,0,7,,,,59,57,2,18,59,27,11,16,31,1,1,7,2,5,2,2,0
"Nov 28, 2019 5:00 PM",261,57,204,,,,,,,,,,9,9,0,19,,,,142,137,5,40,114,44,8,36,52,9,5,5,4,1,0,0,0
"Nov 28, 2019 6:00 PM",259,39,220,,,,,,,,,,9,9,0,16,,,,118,112,6,26,127,54,1,53,37,0,2,6,3,3,2,1,1
"Nov 28, 2019 7:00 PM",132,27,105,,,,,,,,,,6,6,0,7,,,,76,72,4,9,59,27,4,23,18,1,0,3,0,3,1,1,0
"Nov 28, 2019 8:00 PM",84,12,72,,,,,,,,,,4,4,0,9,,,,43,42,1,16,33,11,1,10,18,0,1,4,0,4,0,0,0
"Nov 28, 2019 9:00 PM",63,7,56,,,,,,,,,,2,2,0,5,,,,24,24,0,9,15,6,1,5,6,2,0,4,4,0,1,0,1
"Nov 28, 2019 10:00 PM",46,8,38,,,,,,,,,,0,0,0,5,,,,24,24,0,4,11,9,3,6,4,0,1,1,0,1,3,2,1
"Nov 28, 2019 11:00 PM",31,5,26,,,,,,,,,,1,0,1,1,,,,17,17,0,3,12,2,0,2,3,0,0,0,0,0,0,0,0
"Nov 29, 2019 12:00 AM",11,0,11,,,,,,,,,,0,0,0,0,,,,7,7,0,0,5,3,1,2,3,0,0,0,0,0,0,0,0
"Nov 29, 2019 1:00 AM",8,0,8,,,,,,,,,,0,0,0,0,,,,0,0,0,2,3,2,1,1,3,0,0,1,0,1,1,1,0
"Nov 29, 2019 2:00 AM",7,4,3,,,,,,,,,,0,0,0,0,,,,3,3,0,2,0,0,0,0,0,0,0,0,0,0,0,0,0
"Nov 29, 2019 3:00 AM",2,0,2,,,,,,,,,,0,0,0,0,,,,2,2,0,1,2,0,0,0,0,0,0,1,0,1,0,0,0
"Nov 29, 2019 4:00 AM",1,0,1,,,,,,,,,,0,0,0,0,,,,0,0,0,0,1,0,0,0,0,0,0,0,0,0,0,0,0
"Nov 29, 2019 5:00 AM",9,8,1,,,,,,,,,,0,0,0,3,,,,0,0,0,4,0,0,0,0,6,4,0,0,0,0,0,0,0
"Nov 29, 2019 6:00 AM",45,32,13,,,,,,,,,,2,2,0,4,,,,7,6,1,17,15,1,1,0,30,1,1,1,0,1,0,0,0
"Nov 29, 2019 7:00 AM",138,101,37,,,,,,,,,,7,6,1,13,,,,18,15,3,77,31,20,15,5,100,3,4,7,7,0,4,0,4
"Nov 29, 2019 8:00 AM",303,251,52,,,,,,,,,,22,21,1,23,,,,38,22,16,189,49,55,43,12,217,6,2,7,5,2,1,0,1
"Nov 29, 2019 9:00 AM",189,160,29,,,,,,,,,,12,12,0,12,,,,22,11,11,103,15,38,27,11,102,2,5,4,2,2,0,0,0
"Nov 29, 2019 10:00 AM",86,60,26,,,,,,,,,,4,4,0,4,,,,19,11,8,47,15,9,5,4,30,0,7,5,2,3,4,2,2
"Nov 29, 2019 11:00 AM",72,45,27,,,,,,,,,,9,7,2,1,,,,21,17,4,25,12,14,8,6,20,5,3,4,2,2,0,0,0
"Nov 29, 2019 12:00 PM",77,38,39,,,,,,,,,,16,9,7,9,,,,24,20,4,28,12,9,4,5,23,1,1,8,5,3,0,0,0
"Nov 29, 2019 1:00 PM",117,38,79,,,,,,,,,,9,1,8,7,,,,30,30,0,27,17,9,2,7,11,3,1,2,1,1,2,0,2
"Nov 29, 2019 2:00 PM",85,37,48,,,,,,,,,,6,3,3,12,,,,26,25,1,17,23,15,4,11,22,2,0,2,2,0,2,0,2
"Nov 29, 2019 3:00 PM",114,29,85,,,,,,,,,,11,1,10,13,,,,43,38,5,15,32,11,1,10,31,2,2,4,1,3,2,2,0
"Nov 29, 2019 4:00 PM",135,36,99,,,,,,,,,,8,5,3,16,,,,54,51,3,24,69,32,8,24,27,7,0,6,3,3,4,3,1
"Nov 29, 2019 5:00 PM",245,47,198,,,,,,,,,,10,2,8,13,,,,139,136,3,21,122,38,3,35,39,2,3,3,3,0,3,2,1
"Nov 29, 2019 6:00 PM",201,28,173,,,,,,,,,,14,6,8,11,,,,105,100,5,15,95,41,2,39,33,1,0,4,2,2,3,2,1
"Nov 29, 2019 7:00 PM",113,25,88,,,,,,,,,,6,4,2,6,,,,42,42,0,6,39,20,4,16,13,1,1,3,1,2,0,0,0
"Nov 29, 2019 8:00 PM",59,10,49,,,,,,,,,,5,2,3,3,,,,20,20,0,8,13,5,1,4,16,0,2,1,1,0,2,2,0
"Nov 29, 2019 9:00 PM",34,9,25,,,,,,,,,,0,0,0,5,,,,12,10,2,4,6,4,0,4,7,0,1,0,0,0,0,0,0
"Nov 29, 2019 10:00 PM",28,10,18,,,,,,,,,,0,0,0,3,,,,10,9,1,3,6,3,0,3,3,0,0,0,0,0,0,0,0
"Nov 29, 2019 11:00 PM",19,4,15,,,,,,,,,,0,0,0,3,,,,15,15,0,2,6,3,3,0,5,2,1,0,0,0,1,1,0
"Nov 30, 2019 12:00 AM",17,6,11,,,,,,,,,,0,0,0,2,,,,8,8,0,0,4,1,0,1,4,0,0,0,0,0,0,0,0
"Nov 30, 2019 1:00 AM",10,2,8,,,,,,,,,,4,0,4,1,,,,6,6,0,0,1,3,1,2,3,0,0,1,1,0,0,0,0
"Nov 30, 2019 2:00 AM",8,1,7,,,,,,,,,,0,0,0,0,,,,0,0,0,0,4,0,0,0,1,0,1,0,0,0,0,0,0
"Nov 30, 2019 3:00 AM",2,1,1,,,,,,,,,,0,0,0,0,,,,0,0,0,2,3,1,0,1,2,0,0,1,0,1,0,0,0
"Nov 30, 2019 4:00 AM",4,0,4,,,,,,,,,,0,0,0,0,,,,1,0,1,0,2,2,0,2,0,0,0,0,0,0,0,0,0
"Nov 30, 2019 5:00 AM",4,0,4,,,,,,,,,,1,0,1,3,,,,2,1,1,1,0,0,0,0,1,0,0,0,0,0,0,0,0
"Nov 30, 2019 6:00 AM",6,3,3,,,,,,,,,,0,0,0,0,,,,3,3,0,5,4,3,1,2,5,2,1,0,0,0,0,0,0
"Nov 30, 2019 7:00 AM",19,13,6,,,,,,,,,,3,0,3,3,,,,3,3,0,7,11,2,1,1,8,2,0,0,0,0,0,0,0
"Nov 30, 2019 8:00 AM",24,12,12,,,,,,,,,,7,1,6,4,,,,3,2,1,11,9,4,4,0,16,1,0,0,0,0,0,0,0
"Nov 30, 2019 9:00 AM",44,30,14,,,,,,,,,,10,2,8,3,,,,10,9,1,19,13,7,0,7,20,3,7,1,1,0,1,0,1
"Nov 30, 2019 10:00 AM",47,33,14,,,,,,,,,,8,3,5,9,,,,12,11,1,16,14,7,2,5,14,6,4,2,0,2,0,0,0
"Nov 30, 2019 11:00 AM",37,19,18,,,,,,,,,,15,3,12,13,,,,7,7,0,27,15,13,6,7,22,3,5,1,1,0,0,0,0
"Nov 30, 2019 12:00 PM",50,28,22,,,,,,,,,,18,12,6,13,,,,9,7,2,13,12,20,3,17,16,3,3,2,2,0,0,0,0
"Nov 30, 2019 1:00 PM",60,30,30,,,,,,,,,,17,17,0,16,,,,15,14,1,20,14,19,10,9,19,8,2,4,2,2,1,0,1
"Nov 30, 2019 2:00 PM",50,24,26,,,,,,,,,,16,16,0,23,,,,18,15,3,13,9,13,6,7,19,3,2,4,2,2,3,1,2
"Nov 30, 2019 3:00 PM",46,19,27,,,,,,,,,,20,8,12,13,,,,20,16,4,24,14,18,4,14,13,4,4,3,2,1,3,2,1
"Nov 30, 2019 4:00 PM",39,17,22,,,,,,,,,,11,6,5,12,,,,15,11,4,10,18,17,9,8,13,1,0,6,4,2,1,1,0
"Nov 30, 2019 5:00 PM",51,16,35,,,,,,,,,,11,2,9,4,,,,16,16,0,9,5,12,6,6,22,2,5,7,5,2,2,1,1
"Nov 30, 2019 6:00 PM",41,13,28,,,,,,,,,,10,2,8,5,,,,24,21,3,8,14,10,6,4,10,4,0,2,2,0,0,0,0
"Nov 30, 2019 7:00 PM",35,16,19,,,,,,,,,,1,0,1,2,,,,11,7,4,8,6,2,0,2,10,0,0,1,0,1,1,1,0
"Nov 30, 2019 8:00 PM",35,16,19,,,,,,,,,,3,3,0,7,,,,8,8,0,6,7,5,3,2,8,0,0,1,1,0,1,0,1
"Nov 30, 2019 9:00 PM",20,10,10,,,,,,,,,,1,1,0,2,,,,9,7,2,4,2,2,2,0,4,1,0,1,0,1,0,0,0
"Nov 30, 2019 10:00 PM",10,3,7,,,,,,,,,,2,2,0,0,,,,4,4,0,2,3,2,0,2,6,0,0,0,0,0,0,0,0
"Nov 30, 2019 11:00 PM",16,8,8,,,,,,,,,,2,2,0,2,,,,7,7,0,1,7,2,0,2,4,0,1,0,0,0,0,0,0
"Dec 1, 2019 12:00 AM",7,3,4,,,,,,,,,,0,0,0,1,,,,3,3,0,1,1,5,4,1,4,0,0,1,1,0,0,0,0
"Dec 1, 2019 1:00 AM",5,0,5,,,,,,,,,,1,1,0,2,,,,4,4,0,1,4,0,0,0,2,1,0,0,0,0,0,0,0
"Dec 1, 2019 2:00 AM",5,2,3,,,,,,,,,,0,0,0,0,,,,2,0,2,1,1,0,0,0,1,0,1,0,0,0,1,1,0
"Dec 1, 2019 3:00 AM",3,0,3,,,,,,,,,,0,0,0,0,,,,1,1,0,1,0,2,0,2,2,0,0,0,0,0,0,0,0
"Dec 1, 2019 4:00 AM",5,0,5,,,,,,,,,,0,0,0,0,,,,0,0,0,0,2,0,0,0,1,0,0,0,0,0,0,0,0
"Dec 1, 2019 5:00 AM",2,0,2,,,,,,,,,,0,0,0,0,,,,1,1,0,0,1,1,0,1,1,0,0,0,0,0,0,0,0
"Dec 1, 2019 6:00 AM",9,4,5,,,,,,,,,,0,0,0,0,,,,6,4,2,0,5,1,1,0,12,1,1,0,0,0,0,0,0
"Dec 1, 2019 7:00 AM",17,7,10,,,,,,,,,,0,0,0,2,,,,5,4,1,2,10,0,0,0,9,0,1,1,0,1,0,0,0
"Dec 1, 2019 8:00 AM",23,15,8,,,,,,,,,,2,2,0,4,,,,3,2,1,3,8,3,1,2,8,1,4,2,1,1,0,0,0
"Dec 1, 2019 9:00 AM",31,20,11,,,,,,,,,,8,8,0,5,,,,10,5,5,16,25,11,2,9,45,5,11,2,2,0,0,0,0
"Dec 1, 2019 10:00 AM",29,19,10,,,,,,,,,,6,6,0,5,,,,4,4,0,10,11,7,2,5,37,1,12,9,0,9,0,0,0
"Dec 1, 2019 11:00 AM",33,19,14,,,,,,,,,,6,6,0,11,,,,5,2,3,8,12,18,8,10,16,5,2,4,2,2,2,2,0
"Dec 1, 2019 12:00 PM",24,15,9,,,,,,,,,,23,23,0,15,,,,6,4,2,19,16,12,1,11,12,2,3,2,2,0,1,0,1
"Dec 1, 2019 1:00 PM",29,15,14,,,,,,,,,,14,13,1,17,,,,11,10,1,13,13,20,2,18,13,1,1,4,2,2,0,0,0
"Dec 1, 2019 2:00 PM",40,20,20,,,,,,,,,,15,14,1,13,,,,11,9,2,17,11,15,3,12,20,1,1,1,0,1,0,0,0
"Dec 1, 2019 3:00 PM",41,18,23,,,,,,,,,,14,14,0,10,,,,10,8,2,10,13,26,12,14,17,4,1,6,4,2,4,2,2
"Dec 1, 2019 4:00 PM",47,19,28,,,,,,,,,,22,20,2,17,,,,14,13,1,23,9,7,3,4,17,0,1,3,1,2,1,0,1
"Dec 1, 2019 5:00 PM",46,23,23,,,,,,,,,,4,4,0,7,,,,8,7,1,9,6,2,0,2,14,2,1,1,1,0,0,0,0
"Dec 1, 2019 6:00 PM",32,6,26,,,,,,,,,,6,6,0,6,,,,15,14,1,3,15,6,3,3,14,1,0,0,0,0,0,0,0
"Dec 1, 2019 7:00 PM",28,7,21,,,,,,,,,,2,2,0,3,,,,6,5,1,4,8,4,2,2,15,1,0,0,0,0,0,0,0
"Dec 1, 2019 8:00 PM",33,10,23,,,,,,,,,,2,2,0,3,,,,8,7,1,6,7,1,0,1,6,0,0,2,1,1,0,0,0
"Dec 1, 2019 9:00 PM",10,2,8,,,,,,,,,,0,0,0,4,,,,7,7,0,4,3,1,1,0,6,1,1,2,0,2,1,1,0
"Dec 1, 2019 10:00 PM",10,7,3,,,,,,,,,,0,0,0,1,,,,3,2,1,1,2,4,1,3,5,0,0,1,1,0,1,1,0
"Dec 1, 2019 11:00 PM",6,2,4,,,,,,,,,,0,0,0,2,,,,2,1,1,4,3,2,1,1,2,0,0,0,0,0,0,0,0
"Dec 2, 2019 12:00 AM",5,2,3,,,,,,,,,,0,0,0,0,,,,5,5,0,2,0,0,0,0,2,0,0,0,0,0,0,0,0
"Dec 2, 2019 1:00 AM",1,0,1,,,,,,,,,,0,0,0,0,,,,2,2,0,1,1,1,1,0,1,0,1,1,0,1,0,0,0
"Dec 2, 2019 2:00 AM",2,0,2,,,,,,,,,,0,0,0,1,,,,0,0,0,1,1,0,0,0,1,0,0,0,0,0,0,0,0
"Dec 2, 2019 3:00 AM",1,0,1,,,,,,,,,,0,0,0,0,,,,0,0,0,0,0,0,0,0,0,0,0,0,0,0,0,0,0
"Dec 2, 2019 4:00 AM",1,1,0,,,,,,,,,,0,0,0,0,,,,0,0,0,0,0,0,0,0,2,0,0,0,0,0,0,0,0
"Dec 2, 2019 5:00 AM",4,4,0,,,,,,,,,,0,0,0,1,,,,2,2,0,4,4,0,0,0,7,2,0,0,0,0,0,0,0
"Dec 2, 2019 6:00 AM",37,27,10,,,,,,,,,,3,1,2,4,,,,5,3,2,19,12,4,2,2,45,2,2,0,0,0,0,0,0
"Dec 2, 2019 7:00 AM",176,133,43,,,,,,,,,,8,7,1,19,,,,16,12,4,104,24,25,20,5,139,1,4,4,2,2,1,0,1
"Dec 2, 2019 8:00 AM",361,294,67,,,,,,,,,,22,11,11,25,,,,50,30,20,258,56,82,66,16,303,7,4,6,6,0,3,0,3
"Dec 2, 2019 9:00 AM",187,157,30,,,,,,,,,,19,12,7,10,,,,21,10,11,105,28,39,29,10,112,3,3,3,2,1,2,0,2
"Dec 2, 2019 10:00 AM",71,52,19,,,,,,,,,,9,0,9,8,,,,15,5,10,47,9,11,6,5,30,1,3,4,3,1,1,1,0
"Dec 2, 2019 11:00 AM",54,41,13,,,,,,,,,,10,0,10,5,,,,5,3,2,23,7,14,6,8,9,3,2,1,1,0,0,0,0
"Dec 2, 2019 12:00 PM",36,11,25,,,,,,,,,,17,4,13,5,,,,13,11,2,15,17,14,3,11,20,2,3,5,2,3,1,1,0
"Dec 2, 2019 1:00 PM",65,28,37,,,,,,,,,,18,0,18,6,,,,14,11,3,10,16,12,6,6,17,3,1,3,2,1,3,1,2
"Dec 2, 2019 2:00 PM",60,29,31,,,,,,,,,,10,2,8,4,,,,31,29,2,12,20,8,4,4,19,3,2,2,2,0,0,0,0
"Dec 2, 2019 3:00 PM",79,21,58,,,,,,,,,,2,0,2,12,,,,43,40,3,23,28,15,4,11,19,5,0,8,5,3,1,0,1
"Dec 2, 2019 4:00 PM",135,39,96,,,,,,,,,,6,0,6,16,,,,67,63,4,26,63,33,5,28,25,3,1,3,1,2,0,0,0
"Dec 2, 2019 5:00 PM",286,46,240,,,,,,,,,,15,1,14,23,,,,170,164,6,30,162,61,9,52,58,3,3,5,3,2,1,1,0
"Dec 2, 2019 6:00 PM",299,52,247,,,,,,,,,,16,1,15,13,,,,173,166,7,34,187,68,5,63,51,4,1,5,3,2,0,0,0
"Dec 2, 2019 7:00 PM",151,25,126,,,,,,,,,,3,2,1,10,,,,76,76,0,14,67,37,3,34,20,4,3,0,0,0,1,1,0
"Dec 2, 2019 8:00 PM",111,22,89,,,,,,,,,,5,5,0,4,,,,43,41,2,9,30,10,2,8,16,1,3,3,0,3,0,0,0
"Dec 2, 2019 9:00 PM",58,7,51,,,,,,,,,,1,1,0,6,,,,20,20,0,9,14,9,1,8,10,2,1,0,0,0,1,1,0
"Dec 2, 2019 10:00 PM",40,7,33,,,,,,,,,,1,1,0,5,,,,21,20,1,1,8,6,1,5,6,0,0,0,0,0,1,0,1
"Dec 2, 2019 11:00 PM",26,3,23,,,,,,,,,,2,2,0,1,,,,4,4,0,1,6,2,2,0,3,0,0,2,1,1,0,0,0
"Dec 3, 2019 12:00 AM",8,2,6,,,,,,,,,,0,0,0,1,,,,3,3,0,0,4,0,0,0,1,0,1,0,0,0,1,1,0
"Dec 3, 2019 1:00 AM",1,1,0,,,,,,,,,,0,0,0,0,,,,2,2,0,0,1,0,0,0,0,0,0,0,0,0,0,0,0
"Dec 3, 2019 2:00 AM",1,1,0,,,,,,,,,,0,0,0,2,,,,2,1,1,3,0,0,0,0,0,0,0,0,0,0,0,0,0
"Dec 3, 2019 3:00 AM",1,0,1,,,,,,,,,,0,0,0,1,,,,0,0,0,0,0,0,0,0,0,0,0,0,0,0,0,0,0
"Dec 3, 2019 4:00 AM",4,2,2,,,,,,,,,,0,0,0,0,,,,0,0,0,0,0,0,0,0,3,0,0,0,0,0,0,0,0
"Dec 3, 2019 5:00 AM",8,7,1,,,,,,,,,,0,0,0,2,,,,3,3,0,6,2,1,0,1,12,3,0,0,0,0,0,0,0
"Dec 3, 2019 6:00 AM",56,42,14,,,,,,,,,,1,1,0,3,,,,10,6,4,24,9,6,5,1,41,3,1,0,0,0,0,0,0
"Dec 3, 2019 7:00 AM",179,129,50,,,,,,,,,,8,5,3,14,,,,31,19,12,115,33,27,20,7,168,2,6,4,4,0,3,0,3
"Dec 3, 2019 8:00 AM",399,322,77,,,,,,,,,,23,20,3,30,,,,50,36,14,256,65,83,64,19,281,7,5,6,6,0,2,1,1
"Dec 3, 2019 9:00 AM",212,182,30,,,,,,,,,,12,5,7,6,,,,22,13,9,122,26,32,22,10,119,1,3,2,1,1,1,1,0
"Dec 3, 2019 10:00 AM",61,41,20,,,,,,,,,,7,1,6,5,,,,12,5,7,36,12,11,5,6,30,2,4,2,1,1,3,3,0
"Dec 3, 2019 11:00 AM",50,28,22,,,,,,,,,,4,3,1,9,,,,10,7,3,31,16,13,7,6,19,1,4,2,2,0,0,0,0
"Dec 3, 2019 12:00 PM",69,39,30,,,,,,,,,,6,5,1,13,,,,12,8,4,23,18,15,7,8,23,1,2,2,1,1,0,0,0
"Dec 3, 2019 1:00 PM",85,41,44,,,,,,,,,,10,9,1,14,,,,18,18,0,15,24,20,7,13,21,1,3,4,3,1,1,0,1
"Dec 3, 2019 2:00 PM",66,34,32,,,,,,,,,,20,18,2,4,,,,27,23,4,21,25,20,7,13,15,2,0,4,4,0,1,1,0
"Dec 3, 2019 3:00 PM",76,23,53,,,,,,,,,,10,9,1,9,,,,30,26,4,19,17,13,2,11,28,4,2,10,5,5,3,1,2
"Dec 3, 2019 4:00 PM",125,37,88,,,,,,,,,,15,13,2,14,,,,44,41,3,20,70,30,5,25,46,2,0,6,4,2,1,1,0
"Dec 3, 2019 5:00 PM",279,57,222,,,,,,,,,,6,6,0,23,,,,155,138,17,36,162,70,13,57,66,1,2,1,0,1,0,0,0
"Dec 3, 2019 6:00 PM",300,47,253,,,,,,,,,,15,15,0,20,,,,202,193,9,38,171,63,2,61,49,2,1,0,0,0,0,0,0
"Dec 3, 2019 7:00 PM",166,35,131,,,,,,,,,,8,8,0,25,,,,83,81,2,13,78,31,4,27,15,5,1,6,2,4,1,1,0
"Dec 3, 2019 8:00 PM",110,13,97,,,,,,,,,,8,8,0,10,,,,46,43,3,13,50,18,1,17,18,1,4,4,1,3,1,1,0
"Dec 3, 2019 9:00 PM",70,5,65,,,,,,,,,,2,1,1,3,,,,24,24,0,6,19,10,0,10,14,2,2,2,1,1,2,0,2
"Dec 3, 2019 10:00 PM",46,6,40,,,,,,,,,,2,1,1,3,,,,21,19,2,10,13,4,0,4,7,2,1,1,1,0,0,0,0
"Dec 3, 2019 11:00 PM",14,2,12,,,,,,,,,,0,0,0,2,,,,14,13,1,3,11,4,2,2,1,1,0,1,0,1,1,1,0
"Dec 4, 2019 12:00 AM",8,1,7,,,,,,,,,,0,0,0,0,,,,3,2,1,0,8,1,1,0,3,0,1,0,0,0,0,0,0
"Dec 4, 2019 1:00 AM",3,0,3,,,,,,,,,,1,1,0,0,,,,3,2,1,1,1,2,1,1,0,0,1,0,0,0,0,0,0
"Dec 4, 2019 2:00 AM",6,4,2,,,,,,,,,,0,0,0,1,,,,1,1,0,1,0,0,0,0,0,0,0,0,0,0,0,0,0
"Dec 4, 2019 3:00 AM",0,0,0,,,,,,,,,,0,0,0,0,,,,0,0,0,0,0,0,0,0,0,0,0,1,0,1,0,0,0
"Dec 4, 2019 4:00 AM",4,2,2,,,,,,,,,,0,0,0,0,,,,0,0,0,0,0,0,0,0,2,0,0,0,0,0,0,0,0
"Dec 4, 2019 5:00 AM",6,6,0,,,,,,,,,,0,0,0,2,,,,1,1,0,9,3,0,0,0,9,4,0,0,0,0,0,0,0
"Dec 4, 2019 6:00 AM",51,35,16,,,,,,,,,,2,0,2,4,,,,8,6,2,20,9,3,1,2,39,1,0,0,0,0,1,0,1
"Dec 4, 2019 7:00 AM",176,136,40,,,,,,,,,,9,5,4,14,,,,23,17,6,122,35,31,24,7,144,1,7,3,2,1,1,0,1
"Dec 4, 2019 8:00 AM",364,303,61,,,,,,,,,,24,13,11,34,,,,57,40,17,248,66,83,67,16,309,6,6,10,9,1,4,0,4
"Dec 4, 2019 9:00 AM",210,183,27,,,,,,,,,,20,6,14,12,,,,20,11,9,117,24,40,24,16,99,4,4,6,3,3,0,0,0
"Dec 4, 2019 10:00 AM",83,64,19,,,,,,,,,,14,8,6,3,,,,19,6,13,50,11,15,6,9,29,3,4,2,0,2,1,1,0
"Dec 4, 2019 11:00 AM",54,38,16,,,,,,,,,,8,8,0,3,,,,13,8,5,21,13,10,4,6,14,0,3,3,3,0,0,0,0
"Dec 4, 2019 12:00 PM",68,34,34,,,,,,,,,,13,12,1,6,,,,21,16,5,22,18,14,8,6,26,2,1,3,2,1,0,0,0
"Dec 4, 2019 1:00 PM",93,37,56,,,,,,,,,,15,13,2,12,,,,22,19,3,14,26,19,7,12,22,3,1,1,0,1,0,0,0
"Dec 4, 2019 2:00 PM",68,29,39,,,,,,,,,,5,5,0,8,,,,28,27,1,20,19,19,7,12,16,2,1,2,1,1,1,1,0
"Dec 4, 2019 3:00 PM",90,28,62,,,,,,,,,,6,6,0,14,,,,34,31,3,20,18,9,3,6,27,4,1,8,6,2,1,0,1
"Dec 4, 2019 4:00 PM",129,31,98,,,,,,,,,,12,12,0,9,,,,66,62,4,24,48,24,6,18,43,2,1,2,2,0,1,1,0
"Dec 4, 2019 5:00 PM",276,46,230,,,,,,,,,,11,8,3,19,,,,147,143,4,27,121,63,9,54,71,6,3,5,2,3,1,1,0
"Dec 4, 2019 6:00 PM",259,51,208,,,,,,,,,,14,2,12,18,,,,181,174,7,33,165,64,5,59,46,2,2,2,2,0,0,0,0
"Dec 4, 2019 7:00 PM",167,33,134,,,,,,,,,,14,0,14,8,,,,80,76,4,18,60,33,8,25,14,1,2,2,0,2,0,0,0
"Dec 4, 2019 8:00 PM",100,19,81,,,,,,,,,,3,2,1,8,,,,34,33,1,9,25,12,3,9,22,0,3,1,1,0,0,0,0
"Dec 4, 2019 9:00 PM",61,6,55,,,,,,,,,,2,0,2,3,,,,26,25,1,3,17,11,2,9,9,1,2,0,0,0,1,1,0
"Dec 4, 2019 10:00 PM",52,10,42,,,,,,,,,,1,0,1,2,,,,14,14,0,6,12,2,0,2,5,0,0,0,0,0,1,0,1
"Dec 4, 2019 11:00 PM",31,6,25,,,,,,,,,,1,0,1,1,,,,12,12,0,0,10,5,3,2,3,2,1,1,0,1,0,0,0
"Dec 5, 2019 12:00 AM",13,3,10,,,,,,,,,,0,0,0,1,,,,4,4,0,0,6,0,0,0,2,1,1,0,0,0,0,0,0
"Dec 5, 2019 1:00 AM",2,0,2,,,,,,,,,,0,0,0,0,,,,3,3,0,1,2,0,0,0,0,0,0,0,0,0,0,0,0
"Dec 5, 2019 2:00 AM",4,3,1,,,,,,,,,,0,0,0,1,,,,1,1,0,2,1,0,0,0,0,0,0,0,0,0,0,0,0
"Dec 5, 2019 3:00 AM",0,0,0,,,,,,,,,,0,0,0,0,,,,1,1,0,0,3,0,0,0,0,0,0,0,0,0,0,0,0
"Dec 5, 2019 4:00 AM",5,2,3,,,,,,,,,,1,1,0,0,,,,1,1,0,0,0,0,0,0,1,0,0,0,0,0,0,0,0
"Dec 5, 2019 5:00 AM",8,8,0,,,,,,,,,,0,0,0,1,,,,2,2,0,5,3,1,0,1,9,2,0,0,0,0,0,0,0
"Dec 5, 2019 6:00 AM",40,32,8,,,,,,,,,,2,2,0,5,,,,11,7,4,22,9,2,1,1,33,2,1,1,0,1,0,0,0
"Dec 5, 2019 7:00 AM",159,130,29,,,,,,,,,,5,4,1,7,,,,28,20,8,99,33,34,27,7,115,2,4,2,1,1,0,0,0
"Dec 5, 2019 8:00 AM",347,283,64,,,,,,,,,,17,17,0,32,,,,53,29,24,204,57,75,62,13,271,7,4,11,10,1,5,0,5
"Dec 5, 2019 9:00 AM",166,140,26,,,,,,,,,,12,12,0,7,,,,25,14,11,115,23,42,23,19,95,3,2,6,4,2,1,1,0
"Dec 5, 2019 10:00 AM",76,53,23,,,,,,,,,,6,6,0,3,,,,12,7,5,29,3,14,10,4,31,0,3,1,0,1,1,1,0
"Dec 5, 2019 11:00 AM",39,25,14,,,,,,,,,,7,5,2,9,,,,10,8,2,12,8,9,3,6,20,2,0,2,2,0,0,0,0
"Dec 5, 2019 12:00 PM",32,18,14,,,,,,,,,,9,3,6,1,,,,18,15,3,18,14,7,4,3,18,1,2,1,1,0,0,0,0
"Dec 5, 2019 1:00 PM",71,29,42,,,,,,,,,,6,3,3,4,,,,17,11,6,13,16,9,1,8,17,0,1,1,0,1,2,2,0
"Dec 5, 2019 2:00 PM",62,23,39,,,,,,,,,,8,3,5,2,,,,18,15,3,17,15,8,3,5,20,2,2,1,1,0,0,0,0
"Dec 5, 2019 3:00 PM",71,18,53,,,,,,,,,,3,1,2,7,,,,26,23,3,20,27,12,2,10,13,6,0,4,3,1,0,0,0
"Dec 5, 2019 4:00 PM",116,28,88,,,,,,,,,,4,4,0,10,,,,54,46,8,19,43,29,5,24,33,2,0,4,2,2,0,0,0
"Dec 5, 2019 5:00 PM",224,37,187,,,,,,,,,,10,1,9,13,,,,128,123,5,32,106,56,6,50,55,3,1,3,2,1,1,1,0
"Dec 5, 2019 6:00 PM",237,52,185,,,,,,,,,,10,1,9,15,,,,137,132,5,30,125,62,6,56,35,2,3,3,0,3,0,0,0
"Dec 5, 2019 7:00 PM",134,22,112,,,,,,,,,,5,2,3,9,,,,73,69,4,8,62,25,1,24,29,1,3,1,1,0,1,1,0
"Dec 5, 2019 8:00 PM",95,19,76,,,,,,,,,,4,4,0,6,,,,57,56,1,10,40,13,1,12,13,3,3,4,1,3,1,1,0
"Dec 5, 2019 9:00 PM",52,6,46,,,,,,,,,,1,0,1,6,,,,21,19,2,7,19,11,3,8,13,1,1,0,0,0,1,1,0
"Dec 5, 2019 10:00 PM",40,4,36,,,,,,,,,,2,1,1,3,,,,14,14,0,5,7,5,1,4,9,0,0,0,0,0,0,0,0
"Dec 5, 2019 11:00 PM",29,6,23,,,,,,,,,,0,0,0,0,,,,13,13,0,3,3,2,1,1,5,0,0,1,0,1,0,0,0
"Dec 6, 2019 12:00 AM",14,3,11,,,,,,,,,,0,0,0,1,,,,7,7,0,1,10,0,0,0,4,0,1,0,0,0,0,0,0
"Dec 6, 2019 1:00 AM",6,0,6,,,,,,,,,,0,0,0,0,,,,4,4,0,1,1,4,1,3,0,0,0,0,0,0,0,0,0
"Dec 6, 2019 2:00 AM",4,1,3,,,,,,,,,,0,0,0,1,,,,0,0,0,2,1,0,0,0,1,0,0,0,0,0,0,0,0
"Dec 6, 2019 3:00 AM",1,0,1,,,,,,,,,,0,0,0,0,,,,3,2,1,0,0,0,0,0,3,0,0,1,0,1,0,0,0
"Dec 6, 2019 4:00 AM",3,2,1,,,,,,,,,,0,0,0,0,,,,2,2,0,0,1,0,0,0,1,0,0,0,0,0,0,0,0
"Dec 6, 2019 5:00 AM",10,8,2,,,,,,,,,,0,0,0,2,,,,1,1,0,6,3,1,0,1,9,2,0,0,0,0,0,0,0
"Dec 6, 2019 6:00 AM",33,25,8,,,,,,,,,,1,1,0,5,,,,4,4,0,20,8,3,3,0,27,2,1,1,0,1,0,0,0
"Dec 6, 2019 7:00 AM",124,89,35,,,,,,,,,,8,8,0,7,,,,18,11,7,68,21,14,11,3,98,2,4,4,4,0,1,0,1
"Dec 6, 2019 8:00 AM",262,216,46,,,,,,,,,,19,18,1,14,,,,33,25,8,144,45,47,35,12,189,3,2,7,6,1,2,0,2
"Dec 6, 2019 9:00 AM",132,113,19,,,,,,,,,,13,13,0,8,,,,12,8,4,87,18,32,23,9,74,3,3,3,2,1,2,0,2
"Dec 6, 2019 10:00 AM",66,52,14,,,,,,,,,,6,6,0,5,,,,21,9,12,31,10,15,10,5,29,1,1,6,3,3,1,1,0
"Dec 6, 2019 11:00 AM",23,18,5,,,,,,,,,,1,1,0,3,,,,11,8,3,20,13,6,2,4,17,0,1,5,4,1,0,0,0
"Dec 6, 2019 12:00 PM",72,35,37,,,,,,,,,,7,7,0,5,,,,16,14,2,19,11,4,2,2,20,1,0,3,2,1,0,0,0
"Dec 6, 2019 1:00 PM",65,29,36,,,,,,,,,,8,6,2,4,,,,15,13,2,17,19,10,3,7,18,1,2,0,0,0,0,0,0
"Dec 6, 2019 2:00 PM",71,35,36,,,,,,,,,,6,6,0,5,,,,26,22,4,12,21,13,2,11,12,4,0,4,4,0,0,0,0
"Dec 6, 2019 3:00 PM",62,24,38,,,,,,,,,,10,9,1,6,,,,20,19,1,19,30,24,4,20,19,2,2,4,2,2,0,0,0
"Dec 6, 2019 4:00 PM",120,32,88,,,,,,,,,,14,13,1,13,,,,59,52,7,16,62,28,4,24,35,1,1,3,3,0,1,1,0
"Dec 6, 2019 5:00 PM",206,29,177,,,,,,,,,,10,10,0,13,,,,93,90,3,17,90,39,4,35,32,4,1,6,4,2,1,1,0
"Dec 6, 2019 6:00 PM",144,29,115,,,,,,,,,,9,2,7,15,,,,81,80,1,20,77,28,3,25,28,3,3,6,4,2,8,3,5
"Dec 6, 2019 7:00 PM",71,10,61,,,,,,,,,,5,1,4,9,,,,36,36,0,6,30,16,3,13,13,0,1,2,1,1,1,1,0
"Dec 6, 2019 8:00 PM",40,7,33,,,,,,,,,,4,2,2,2,,,,18,18,0,8,16,7,0,7,7,0,0,4,2,2,1,1,0
"Dec 6, 2019 9:00 PM",49,14,35,,,,,,,,,,4,1,3,6,,,,22,21,1,5,4,4,1,3,6,1,0,1,0,1,0,0,0
"Dec 6, 2019 10:00 PM",37,7,30,,,,,,,,,,5,2,3,1,,,,14,13,1,2,11,4,2,2,9,0,0,0,0,0,0,0,0
"Dec 6, 2019 11:00 PM",20,8,12,,,,,,,,,,4,3,1,0,,,,14,14,0,6,8,1,1,0,6,0,1,1,0,1,0,0,0
"Dec 7, 2019 12:00 AM",15,5,10,,,,,,,,,,1,1,0,4,,,,9,8,1,2,10,0,0,0,4,3,1,0,0,0,0,0,0
"Dec 7, 2019 1:00 AM",10,0,10,,,,,,,,,,2,2,0,0,,,,5,5,0,0,5,3,2,1,4,1,0,0,0,0,0,0,0
"Dec 7, 2019 2:00 AM",5,3,2,,,,,,,,,,0,0,0,1,,,,3,2,1,1,3,0,0,0,2,0,0,0,0,0,2,2,0
"Dec 7, 2019 3:00 AM",5,0,5,,,,,,,,,,0,0,0,0,,,,1,1,0,0,0,1,1,0,1,1,2,0,0,0,0,0,0
"Dec 7, 2019 4:00 AM",4,2,2,,,,,,,,,,0,0,0,1,,,,1,1,0,0,0,0,0,0,1,0,0,0,0,0,0,0,0
"Dec 7, 2019 5:00 AM",2,0,2,,,,,,,,,,0,0,0,0,,,,1,1,0,1,1,0,0,0,1,0,0,2,2,0,0,0,0
"Dec 7, 2019 6:00 AM",10,4,6,,,,,,,,,,1,1,0,1,,,,1,1,0,4,4,1,1,0,11,0,0,0,0,0,0,0,0
"Dec 7, 2019 7:00 AM",15,10,5,,,,,,,,,,2,0,2,5,,,,1,0,1,4,12,2,1,1,12,1,1,1,1,0,0,0,0
"Dec 7, 2019 8:00 AM",36,21,15,,,,,,,,,,6,5,1,6,,,,10,10,0,27,19,5,3,2,26,2,0,4,3,1,2,0,2
"Dec 7, 2019 9:00 AM",63,50,13,,,,,,,,,,8,2,6,10,,,,10,8,2,17,20,8,3,5,20,2,4,2,2,0,0,0,0
"Dec 7, 2019 10:00 AM",35,28,7,,,,,,,,,,10,1,9,11,,,,15,11,4,21,12,17,7,10,12,3,0,3,3,0,2,1,1
"Dec 7, 2019 11:00 AM",50,32,18,,,,,,,,,,11,4,7,15,,,,17,10,7,17,15,18,6,12,22,4,7,2,1,1,2,1,1
"Dec 7, 2019 12:00 PM",46,26,20,,,,,,,,,,16,9,7,12,,,,11,8,3,12,12,17,6,11,16,3,3,1,0,1,1,0,1
"Dec 7, 2019 1:00 PM",45,23,22,,,,,,,,,,28,28,0,13,,,,18,16,2,12,21,13,5,8,17,1,1,3,1,2,1,0,1
"Dec 7, 2019 2:00 PM",42,21,21,,,,,,,,,,11,5,6,13,,,,17,14,3,11,10,24,8,16,17,0,1,1,0,1,0,0,0
"Dec 7, 2019 3:00 PM",50,27,23,,,,,,,,,,14,14,0,20,,,,15,14,1,19,16,19,5,14,20,0,1,1,1,0,0,0,0
"Dec 7, 2019 4:00 PM",37,11,26,,,,,,,,,,11,7,4,10,,,,15,15,0,13,11,17,11,6,21,0,0,1,1,0,0,0,0
"Dec 7, 2019 5:00 PM",28,6,22,,,,,,,,,,10,8,2,5,,,,21,16,5,10,9,13,6,7,17,3,0,3,2,1,0,0,0
"Dec 7, 2019 6:00 PM",43,12,31,,,,,,,,,,1,0,1,7,,,,9,7,2,7,10,4,0,4,10,3,2,3,2,1,0,0,0
"Dec 7, 2019 7:00 PM",40,12,28,,,,,,,,,,2,2,0,2,,,,12,11,1,5,10,2,2,0,1,1,1,2,0,2,0,0,0
"Dec 7, 2019 8:00 PM",36,7,29,,,,,,,,,,1,1,0,2,,,,11,10,1,6,1,1,0,1,3,0,1,1,0,1,0,0,0
"Dec 7, 2019 9:00 PM",17,3,14,,,,,,,,,,1,1,0,3,,,,7,7,0,1,3,1,1,0,2,0,0,0,0,0,0,0,0
"Dec 7, 2019 10:00 PM",14,3,11,,,,,,,,,,0,0,0,0,,,,6,5,1,1,2,0,0,0,6,0,0,1,1,0,0,0,0
"Dec 7, 2019 11:00 PM",11,4,7,,,,,,,,,,1,0,1,0,,,,5,5,0,1,2,2,0,2,4,0,0,0,0,0,0,0,0
"Dec 8, 2019 12:00 AM",5,2,3,,,,,,,,,,0,0,0,0,,,,2,2,0,3,3,0,0,0,0,0,0,0,0,0,0,0,0
"Dec 8, 2019 1:00 AM",4,0,4,,,,,,,,,,1,0,1,1,,,,4,4,0,1,3,3,2,1,2,0,1,0,0,0,0,0,0
"Dec 8, 2019 2:00 AM",5,2,3,,,,,,,,,,0,0,0,0,,,,0,0,0,1,0,0,0,0,2,0,1,0,0,0,0,0,0
"Dec 8, 2019 3:00 AM",3,0,3,,,,,,,,,,0,0,0,0,,,,0,0,0,0,2,0,0,0,1,0,0,0,0,0,0,0,0
"Dec 8, 2019 4:00 AM",4,1,3,,,,,,,,,,1,1,0,0,,,,1,1,0,0,0,0,0,0,3,0,0,0,0,0,0,0,0
"Dec 8, 2019 5:00 AM",3,0,3,,,,,,,,,,0,0,0,0,,,,2,2,0,0,0,0,0,0,1,0,0,0,0,0,0,0,0
"Dec 8, 2019 6:00 AM",7,3,4,,,,,,,,,,0,0,0,0,,,,4,4,0,1,3,1,1,0,7,0,0,0,0,0,0,0,0
"Dec 8, 2019 7:00 AM",4,3,1,,,,,,,,,,1,0,1,2,,,,2,1,1,4,12,4,0,4,9,1,1,0,0,0,0,0,0
"Dec 8, 2019 8:00 AM",11,6,5,,,,,,,,,,2,1,1,0,,,,3,2,1,3,6,1,1,0,2,1,0,1,1,0,0,0,0
"Dec 8, 2019 9:00 AM",18,14,4,,,,,,,,,,1,1,0,1,,,,3,2,1,11,4,4,3,1,8,1,1,1,1,0,0,0,0
"Dec 8, 2019 10:00 AM",35,29,6,,,,,,,,,,3,2,1,4,,,,5,4,1,9,10,3,1,2,13,0,1,0,0,0,0,0,0
"Dec 8, 2019 11:00 AM",19,12,7,,,,,,,,,,4,3,1,3,,,,5,3,2,9,4,3,0,3,6,0,1,6,3,3,2,2,0
"Dec 8, 2019 12:00 PM",20,11,9,,,,,,,,,,6,5,1,7,,,,5,2,3,5,6,1,0,1,11,0,1,0,0,0,0,0,0
"Dec 8, 2019 1:00 PM",15,5,10,,,,,,,,,,4,4,0,4,,,,9,7,2,5,9,3,1,2,15,0,0,2,0,2,0,0,0
"Dec 8, 2019 2:00 PM",17,13,4,,,,,,,,,,5,5,0,5,,,,11,8,3,8,9,5,2,3,7,0,0,2,0,2,0,0,0
"Dec 8, 2019 3:00 PM",13,9,4,,,,,,,,,,5,5,0,9,,,,7,7,0,9,1,8,2,6,10,2,0,4,3,1,0,0,0
"Dec 8, 2019 4:00 PM",22,10,12,,,,,,,,,,6,5,1,1,,,,7,7,0,9,6,4,2,2,8,0,0,1,1,0,0,0,0
"Dec 8, 2019 5:00 PM",15,7,8,,,,,,,,,,3,1,2,2,,,,6,5,1,3,1,3,2,1,6,2,1,0,0,0,0,0,0
"Dec 8, 2019 6:00 PM",29,7,22,,,,,,,,,,1,1,0,3,,,,11,11,0,2,7,4,2,2,9,1,0,1,1,0,0,0,0
"Dec 8, 2019 7:00 PM",15,3,12,,,,,,,,,,0,0,0,0,,,,5,5,0,2,0,0,0,0,6,1,0,0,0,0,0,0,0
"Dec 8, 2019 8:00 PM",28,4,24,,,,,,,,,,3,1,2,4,,,,4,4,0,1,4,1,0,1,6,0,0,2,1,1,1,1,0
"Dec 8, 2019 9:00 PM",15,5,10,,,,,,,,,,1,0,1,0,,,,4,4,0,2,1,1,1,0,1,1,0,1,0,1,0,0,0
"Dec 8, 2019 10:00 PM",3,1,2,,,,,,,,,,1,1,0,0,,,,6,6,0,2,1,0,0,0,1,0,0,0,0,0,0,0,0
"Dec 8, 2019 11:00 PM",1,0,1,,,,,,,,,,0,0,0,0,,,,0,0,0,0,2,0,0,0,1,0,1,0,0,0,0,0,0
"Dec 9, 2019 12:00 AM",4,0,4,,,,,,,,,,0,0,0,0,,,,1,1,0,0,0,3,2,1,1,0,0,0,0,0,0,0,0
"Dec 9, 2019 1:00 AM",3,1,2,,,,,,,,,,0,0,0,0,,,,1,1,0,1,2,0,0,0,0,0,0,1,1,0,0,0,0
"Dec 9, 2019 2:00 AM",2,2,0,,,,,,,,,,0,0,0,0,,,,0,0,0,0,0,0,0,0,0,0,0,0,0,0,0,0,0
"Dec 9, 2019 3:00 AM",0,0,0,,,,,,,,,,0,0,0,0,,,,0,0,0,0,0,0,0,0,0,0,0,0,0,0,0,0,0
"Dec 9, 2019 4:00 AM",2,0,2,,,,,,,,,,0,0,0,0,,,,0,0,0,0,0,0,0,0,0,0,0,0,0,0,0,0,0
"Dec 9, 2019 5:00 AM",5,4,1,,,,,,,,,,0,0,0,2,,,,1,1,0,3,3,0,0,0,5,3,0,0,0,0,0,0,0
"Dec 9, 2019 6:00 AM",41,31,10,,,,,,,,,,2,1,1,7,,,,11,3,8,28,8,4,2,2,32,1,0,0,0,0,0,0,0
"Dec 9, 2019 7:00 AM",155,119,36,,,,,,,,,,5,3,2,13,,,,20,15,5,92,27,25,17,8,102,2,4,4,3,1,3,2,1
"Dec 9, 2019 8:00 AM",365,302,63,,,,,,,,,,18,15,3,30,,,,44,29,15,260,68,77,62,15,287,3,6,11,8,3,3,0,3
"Dec 9, 2019 9:00 AM",179,154,25,,,,,,,,,,17,10,7,12,,,,19,14,5,105,25,38,25,13,110,3,1,4,3,1,1,1,0
"Dec 9, 2019 10:00 AM",68,55,13,,,,,,,,,,7,5,2,2,,,,14,6,8,27,8,12,8,4,27,1,2,2,1,1,0,0,0
"Dec 9, 2019 11:00 AM",33,24,9,,,,,,,,,,5,2,3,3,,,,18,12,6,35,5,10,7,3,29,2,2,4,3,1,0,0,0
"Dec 9, 2019 12:00 PM",53,28,25,,,,,,,,,,9,6,3,4,,,,19,11,8,20,13,8,2,6,21,0,1,2,1,1,1,1,0
"Dec 9, 2019 1:00 PM",76,41,35,,,,,,,,,,15,10,5,3,,,,19,18,1,16,21,12,4,8,15,1,1,2,1,1,2,1,1
"Dec 9, 2019 2:00 PM",68,38,30,,,,,,,,,,8,7,1,5,,,,14,13,1,20,17,14,4,10,19,1,3,0,0,0,2,1,1
"Dec 9, 2019 3:00 PM",74,23,51,,,,,,,,,,11,8,3,12,,,,38,33,5,24,16,19,3,16,17,2,0,2,1,1,1,1,0
"Dec 9, 2019 4:00 PM",109,34,75,,,,,,,,,,2,2,0,14,,,,48,45,3,20,44,18,3,15,35,6,0,5,3,2,3,3,0
"Dec 9, 2019 5:00 PM",317,63,254,,,,,,,,,,8,8,0,23,,,,136,133,3,43,127,56,9,47,63,10,1,5,4,1,0,0,0
"Dec 9, 2019 6:00 PM",288,41,247,,,,,,,,,,15,12,3,14,,,,162,154,8,18,150,66,8,58,46,6,2,3,0,3,2,2,0
"Dec 9, 2019 7:00 PM",136,17,119,,,,,,,,,,5,4,1,9,,,,74,68,6,12,60,26,3,23,24,2,4,5,3,2,0,0,0
"Dec 9, 2019 8:00 PM",106,22,84,,,,,,,,,,1,1,0,4,,,,57,54,3,12,24,13,1,12,12,1,0,1,0,1,3,3,0
"Dec 9, 2019 9:00 PM",67,10,57,,,,,,,,,,0,0,0,5,,,,26,25,1,6,23,6,2,4,9,1,3,3,2,1,0,0,0
"Dec 9, 2019 10:00 PM",43,4,39,,,,,,,,,,4,4,0,2,,,,18,17,1,2,14,6,0,6,5,1,1,3,2,1,0,0,0
"Dec 9, 2019 11:00 PM",24,0,24,,,,,,,,,,2,1,1,1,,,,8,7,1,0,8,2,0,2,2,0,0,1,1,0,0,0,0
"Dec 10, 2019 12:00 AM",9,0,9,,,,,,,,,,0,0,0,0,,,,4,4,0,0,3,0,0,0,1,0,3,1,1,0,0,0,0
"Dec 10, 2019 1:00 AM",1,0,1,,,,,,,,,,1,1,0,0,,,,2,1,1,0,1,1,0,1,0,0,0,0,0,0,0,0,0
"Dec 10, 2019 2:00 AM",3,3,0,,,,,,,,,,0,0,0,0,,,,0,0,0,1,1,0,0,0,0,0,0,0,0,0,0,0,0
"Dec 10, 2019 3:00 AM",0,0,0,,,,,,,,,,0,0,0,1,,,,0,0,0,0,0,0,0,0,0,0,0,0,0,0,0,0,0
"Dec 10, 2019 4:00 AM",4,2,2,,,,,,,,,,0,0,0,0,,,,0,0,0,0,0,0,0,0,2,0,0,0,0,0,0,0,0
"Dec 10, 2019 5:00 AM",9,9,0,,,,,,,,,,0,0,0,3,,,,0,0,0,2,3,0,0,0,7,2,0,0,0,0,0,0,0
"Dec 10, 2019 6:00 AM",36,25,11,,,,,,,,,,1,0,1,3,,,,7,3,4,20,4,4,3,1,30,0,1,0,0,0,0,0,0
"Dec 10, 2019 7:00 AM",142,113,29,,,,,,,,,,6,0,6,8,,,,19,11,8,79,20,12,9,3,115,0,3,3,3,0,1,0,1
"Dec 10, 2019 8:00 AM",302,255,47,,,,,,,,,,14,0,14,19,,,,26,14,12,179,35,65,53,12,244,4,5,4,2,2,3,1,2
"Dec 10, 2019 9:00 AM",169,142,27,,,,,,,,,,8,1,7,7,,,,13,9,4,106,18,31,20,11,74,1,2,1,1,0,0,0,0
"Dec 10, 2019 10:00 AM",71,58,13,,,,,,,,,,6,3,3,3,,,,17,8,9,25,10,9,3,6,16,0,1,0,0,0,1,0,1
"Dec 10, 2019 11:00 AM",59,39,20,,,,,,,,,,3,2,1,5,,,,20,13,7,18,13,7,5,2,18,2,3,2,1,1,0,0,0
"Dec 10, 2019 12:00 PM",29,13,16,,,,,,,,,,4,1,3,3,,,,14,13,1,13,11,5,4,1,13,0,0,1,1,0,0,0,0
"Dec 10, 2019 1:00 PM",42,14,28,,,,,,,,,,10,9,1,4,,,,9,5,4,12,12,5,2,3,16,2,1,1,0,1,0,0,0
"Dec 10, 2019 2:00 PM",56,21,35,,,,,,,,,,6,5,1,4,,,,13,11,2,10,9,4,0,4,17,0,0,1,1,0,0,0,0
"Dec 10, 2019 3:00 PM",38,10,28,,,,,,,,,,3,2,1,3,,,,17,14,3,11,14,4,1,3,15,1,0,2,1,1,1,1,0
"Dec 10, 2019 4:00 PM",91,25,66,,,,,,,,,,4,4,0,4,,,,43,40,3,11,47,12,2,10,19,1,0,1,0,1,0,0,0
"Dec 10, 2019 5:00 PM",231,46,185,,,,,,,,,,8,5,3,13,,,,93,90,3,23,95,43,6,37,49,3,1,4,2,2,0,0,0
"Dec 10, 2019 6:00 PM",234,48,186,,,,,,,,,,9,5,4,11,,,,119,115,4,20,116,46,3,43,31,2,1,2,0,2,0,0,0
"Dec 10, 2019 7:00 PM",131,25,106,,,,,,,,,,4,4,0,12,,,,52,52,0,7,64,21,1,20,19,1,1,1,1,0,0,0,0
"Dec 10, 2019 8:00 PM",84,18,66,,,,,,,,,,1,0,1,7,,,,45,41,4,9,30,11,1,10,11,0,1,3,1,2,1,1,0
"Dec 10, 2019 9:00 PM",55,10,45,,,,,,,,,,0,0,0,5,,,,24,23,1,4,10,8,1,7,4,0,1,0,0,0,0,0,0
"Dec 10, 2019 10:00 PM",36,6,30,,,,,,,,,,1,1,0,4,,,,18,17,1,3,10,3,1,2,6,2,1,2,1,1,0,0,0
"Dec 10, 2019 11:00 PM",21,6,15,,,,,,,,,,1,1,0,1,,,,12,11,1,0,6,2,0,2,0,0,0,1,1,0,0,0,0
"Dec 11, 2019 12:00 AM",9,1,8,,,,,,,,,,0,0,0,1,,,,4,4,0,1,4,0,0,0,1,2,3,0,0,0,0,0,0
"Dec 11, 2019 1:00 AM",1,0,1,,,,,,,,,,0,0,0,2,,,,0,0,0,1,3,0,0,0,1,0,0,0,0,0,0,0,0
"Dec 11, 2019 2:00 AM",3,1,2,,,,,,,,,,0,0,0,0,,,,0,0,0,0,0,0,0,0,0,0,0,0,0,0,0,0,0
"Dec 11, 2019 3:00 AM",0,0,0,,,,,,,,,,0,0,0,0,,,,0,0,0,0,0,0,0,0,0,0,0,0,0,0,0,0,0
"Dec 11, 2019 4:00 AM",2,2,0,,,,,,,,,,0,0,0,0,,,,1,1,0,0,0,0,0,0,2,0,0,0,0,0,0,0,0
"Dec 11, 2019 5:00 AM",9,8,1,,,,,,,,,,1,0,1,2,,,,1,1,0,4,3,0,0,0,4,3,0,0,0,0,0,0,0
"Dec 11, 2019 6:00 AM",53,43,10,,,,,,,,,,1,1,0,4,,,,5,3,2,22,11,4,3,1,39,0,0,1,1,0,0,0,0
"Dec 11, 2019 7:00 AM",186,147,39,,,,,,,,,,3,1,2,13,,,,22,18,4,111,29,23,17,6,141,0,6,1,1,0,1,0,1
"Dec 11, 2019 8:00 AM",362,295,67,,,,,,,,,,18,15,3,23,,,,43,29,14,221,61,60,47,13,277,3,5,6,4,2,1,1,0
"Dec 11, 2019 9:00 AM",172,137,35,,,,,,,,,,16,14,2,8,,,,27,12,15,96,18,43,28,15,93,3,3,5,3,2,2,1,1
"Dec 11, 2019 10:00 AM",75,49,26,,,,,,,,,,6,5,1,5,,,,14,7,7,44,12,19,11,8,30,1,1,4,1,3,1,1,0
"Dec 11, 2019 11:00 AM",62,40,22,,,,,,,,,,10,9,1,4,,,,9,5,4,24,16,15,4,11,32,2,0,4,3,1,0,0,0
"Dec 11, 2019 12:00 PM",66,31,35,,,,,,,,,,23,21,2,2,,,,9,9,0,18,17,13,5,8,32,1,0,5,2,3,1,0,1
"Dec 11, 2019 1:00 PM",78,42,36,,,,,,,,,,11,11,0,14,,,,27,20,7,22,23,13,6,7,27,2,5,2,0,2,3,3,0
"Dec 11, 2019 2:00 PM",94,57,37,,,,,,,,,,16,16,0,10,,,,28,22,6,15,27,15,6,9,32,0,2,2,0,2,1,1,0
"Dec 11, 2019 3:00 PM",70,27,43,,,,,,,,,,6,6,0,6,,,,32,28,4,18,22,16,3,13,22,5,1,2,2,0,2,1,1
"Dec 11, 2019 4:00 PM",138,33,105,,,,,,,,,,11,11,0,15,,,,58,58,0,17,46,25,5,20,30,5,1,4,2,2,1,1,0
"Dec 11, 2019 5:00 PM",276,54,222,,,,,,,,,,6,5,1,14,,,,132,128,4,37,108,48,10,38,62,4,4,2,2,0,0,0,0
"Dec 11, 2019 6:00 PM",284,50,234,,,,,,,,,,13,13,0,18,,,,146,141,5,26,115,48,3,45,38,2,1,1,1,0,1,1,0
"Dec 11, 2019 7:00 PM",130,26,104,,,,,,,,,,3,3,0,8,,,,67,64,3,8,65,22,1,21,10,0,2,0,0,0,0,0,0
"Dec 11, 2019 8:00 PM",94,20,74,,,,,,,,,,1,1,0,6,,,,57,54,3,10,30,18,0,18,15,1,3,2,1,1,0,0,0
"Dec 11, 2019 9:00 PM",56,5,51,,,,,,,,,,9,9,0,6,,,,19,19,0,4,18,6,0,6,7,2,3,0,0,0,1,1,0
"Dec 11, 2019 10:00 PM",39,6,33,,,,,,,,,,2,2,0,8,,,,16,14,2,6,15,1,0,1,3,0,0,0,0,0,0,0,0
"Dec 11, 2019 11:00 PM",35,7,28,,,,,,,,,,0,0,0,1,,,,14,14,0,0,4,4,3,1,3,1,0,2,1,1,0,0,0
"Dec 12, 2019 12:00 AM",9,1,8,,,,,,,,,,1,1,0,4,,,,9,9,0,2,5,1,0,1,1,0,0,0,0,0,0,0,0
"Dec 12, 2019 1:00 AM",4,1,3,,,,,,,,,,0,0,0,1,,,,1,1,0,0,3,1,1,0,0,0,0,0,0,0,0,0,0
"Dec 12, 2019 2:00 AM",4,1,3,,,,,,,,,,0,0,0,1,,,,3,3,0,1,1,0,0,0,2,1,0,0,0,0,0,0,0
"Dec 12, 2019 3:00 AM",1,0,1,,,,,,,,,,0,0,0,0,,,,0,0,0,0,0,0,0,0,0,0,0,0,0,0,0,0,0
"Dec 12, 2019 4:00 AM",3,2,1,,,,,,,,,,0,0,0,0,,,,0,0,0,0,0,0,0,0,1,0,0,0,0,0,0,0,0
"Dec 12, 2019 5:00 AM",11,8,3,,,,,,,,,,1,1,0,4,,,,1,0,1,4,4,1,1,0,7,1,0,0,0,0,0,0,0
"Dec 12, 2019 6:00 AM",43,31,12,,,,,,,,,,3,3,0,5,,,,8,7,1,16,10,4,4,0,31,2,1,1,1,0,1,0,1
"Dec 12, 2019 7:00 AM",125,101,24,,,,,,,,,,9,6,3,5,,,,17,9,8,78,17,20,16,4,92,2,4,2,2,0,0,0,0
"Dec 12, 2019 8:00 AM",265,228,37,,,,,,,,,,7,6,1,21,,,,20,12,8,142,38,37,26,11,172,5,1,3,3,0,2,0,2
"Dec 12, 2019 9:00 AM",113,92,21,,,,,,,,,,6,3,3,5,,,,15,11,4,54,9,19,12,7,85,2,1,0,0,0,0,0,0
"Dec 12, 2019 10:00 AM",48,38,10,,,,,,,,,,2,0,2,6,,,,6,4,2,28,4,8,4,4,21,1,2,0,0,0,1,1,0
"Dec 12, 2019 11:00 AM",59,45,14,,,,,,,,,,6,4,2,6,,,,12,6,6,25,12,7,5,2,26,0,1,2,0,2,0,0,0
"Dec 12, 2019 12:00 PM",43,26,17,,,,,,,,,,10,10,0,5,,,,12,8,4,20,15,6,3,3,16,2,0,3,1,2,2,2,0
"Dec 12, 2019 1:00 PM",52,31,21,,,,,,,,,,11,11,0,6,,,,23,21,2,24,19,11,3,8,12,1,2,1,1,0,0,0,0
"Dec 12, 2019 2:00 PM",59,30,29,,,,,,,,,,8,7,1,5,,,,17,15,2,17,16,10,2,8,16,8,2,3,3,0,0,0,0
"Dec 12, 2019 3:00 PM",72,25,47,,,,,,,,,,4,3,1,5,,,,27,26,1,15,19,10,1,9,13,2,3,6,3,3,1,1,0
"Dec 12, 2019 4:00 PM",95,18,77,,,,,,,,,,5,5,0,11,,,,38,32,6,18,48,22,4,18,17,3,0,4,3,1,3,3,0
"Dec 12, 2019 5:00 PM",207,37,170,,,,,,,,,,7,7,0,12,,,,87,85,2,25,79,47,6,41,35,2,1,3,2,1,3,3,0
"Dec 12, 2019 6:00 PM",181,31,150,,,,,,,,,,8,8,0,17,,,,92,89,3,17,85,31,1,30,23,5,0,7,2,5,0,0,0
"Dec 12, 2019 7:00 PM",105,17,88,,,,,,,,,,3,3,0,6,,,,44,44,0,7,32,16,0,16,21,5,3,2,2,0,0,0,0
"Dec 12, 2019 8:00 PM",66,10,56,,,,,,,,,,2,2,0,7,,,,29,29,0,3,18,6,0,6,12,0,1,2,0,2,0,0,0
"Dec 12, 2019 9:00 PM",52,5,47,,,,,,,,,,3,3,0,1,,,,20,20,0,1,10,3,0,3,7,1,1,0,0,0,0,0,0
"Dec 12, 2019 10:00 PM",31,5,26,,,,,,,,,,0,0,0,2,,,,15,15,0,2,15,4,0,4,6,3,0,2,1,1,0,0,0
"Dec 12, 2019 11:00 PM",26,5,21,,,,,,,,,,0,0,0,1,,,,12,11,1,1,8,5,1,4,2,0,1,2,1,1,0,0,0
"Dec 13, 2019 12:00 AM",12,3,9,,,,,,,,,,0,0,0,1,,,,9,9,0,1,6,2,2,0,2,0,0,0,0,0,0,0,0
"Dec 13, 2019 1:00 AM",9,1,8,,,,,,,,,,0,0,0,0,,,,2,2,0,0,3,0,0,0,2,0,0,0,0,0,0,0,0
"Dec 13, 2019 2:00 AM",5,4,1,,,,,,,,,,0,0,0,0,,,,2,2,0,1,0,0,0,0,1,0,0,0,0,0,0,0,0
"Dec 13, 2019 3:00 AM",1,0,1,,,,,,,,,,2,2,0,0,,,,0,0,0,0,1,0,0,0,1,0,0,0,0,0,0,0,0
"Dec 13, 2019 4:00 AM",2,1,1,,,,,,,,,,0,0,0,0,,,,0,0,0,0,0,0,0,0,0,0,0,0,0,0,0,0,0
"Dec 13, 2019 5:00 AM",10,8,2,,,,,,,,,,0,0,0,2,,,,0,0,0,2,3,0,0,0,1,1,0,0,0,0,0,0,0
"Dec 13, 2019 6:00 AM",30,19,11,,,,,,,,,,2,2,0,4,,,,7,4,3,13,6,2,2,0,27,1,0,0,0,0,0,0,0
"Dec 13, 2019 7:00 AM",101,79,22,,,,,,,,,,4,4,0,12,,,,13,9,4,46,13,9,5,4,45,1,4,1,1,0,1,0,1
"Dec 13, 2019 8:00 AM",249,199,50,,,,,,,,,,14,12,2,18,,,,24,15,9,109,34,22,18,4,147,2,4,1,1,0,2,0,2
"Dec 13, 2019 9:00 AM",136,115,21,,,,,,,,,,9,9,0,14,,,,15,10,5,67,20,25,19,6,63,4,0,2,1,1,0,0,0
"Dec 13, 2019 10:00 AM",50,36,14,,,,,,,,,,6,6,0,6,,,,17,13,4,34,3,9,5,4,24,0,0,2,0,2,0,0,0
"Dec 13, 2019 11:00 AM",44,30,14,,,,,,,,,,2,2,0,5,,,,22,15,7,19,18,6,2,4,19,3,0,1,1,0,0,0,0
"Dec 13, 2019 12:00 PM",61,27,34,,,,,,,,,,4,3,1,3,,,,11,10,1,13,8,7,1,6,17,0,1,1,1,0,2,2,0
"Dec 13, 2019 1:00 PM",51,21,30,,,,,,,,,,6,6,0,3,,,,14,12,2,15,24,12,3,9,21,2,0,4,4,0,0,0,0
"Dec 13, 2019 2:00 PM",62,30,32,,,,,,,,,,7,7,0,9,,,,26,20,6,17,17,6,0,6,28,1,1,2,1,1,1,1,0
"Dec 13, 2019 3:00 PM",74,30,44,,,,,,,,,,10,10,0,6,,,,22,21,1,13,16,13,2,11,24,2,2,0,0,0,2,2,0
"Dec 13, 2019 4:00 PM",114,22,92,,,,,,,,,,6,6,0,15,,,,36,34,2,22,51,13,4,9,23,3,1,8,3,5,2,2,0
"Dec 13, 2019 5:00 PM",166,31,135,,,,,,,,,,6,6,0,20,,,,69,64,5,14,76,26,2,24,41,0,1,1,0,1,2,2,0
"Dec 13, 2019 6:00 PM",124,28,96,,,,,,,,,,8,7,1,10,,,,69,62,7,15,43,16,1,15,25,3,3,9,4,5,1,1,0
"Dec 13, 2019 7:00 PM",73,15,58,,,,,,,,,,2,2,0,8,,,,29,25,4,8,18,14,0,14,14,1,1,0,0,0,0,0,0
"Dec 13, 2019 8:00 PM",50,8,42,,,,,,,,,,1,1,0,7,,,,32,29,3,6,14,2,2,0,16,1,0,1,0,1,0,0,0
"Dec 13, 2019 9:00 PM",39,5,34,,,,,,,,,,0,0,0,6,,,,17,16,1,10,8,2,0,2,5,0,0,2,2,0,0,0,0
"Dec 13, 2019 10:00 PM",28,8,20,,,,,,,,,,1,1,0,2,,,,8,7,1,2,6,2,0,2,8,0,0,0,0,0,0,0,0
"Dec 13, 2019 11:00 PM",25,1,24,,,,,,,,,,1,1,0,3,,,,15,13,2,2,8,1,0,1,2,0,0,0,0,0,0,0,0
"Dec 14, 2019 12:00 AM",18,3,15,,,,,,,,,,3,3,0,3,,,,8,8,0,1,7,0,0,0,3,0,0,0,0,0,1,1,0
"Dec 14, 2019 1:00 AM",3,0,3,,,,,,,,,,0,0,0,4,,,,2,2,0,1,5,1,0,1,3,1,1,0,0,0,0,0,0
"Dec 14, 2019 2:00 AM",10,4,6,,,,,,,,,,0,0,0,0,,,,2,1,1,0,3,5,2,3,1,0,0,0,0,0,0,0,0
"Dec 14, 2019 3:00 AM",3,0,3,,,,,,,,,,0,0,0,0,,,,0,0,0,0,4,2,0,2,1,0,2,0,0,0,0,0,0
"Dec 14, 2019 4:00 AM",2,1,1,,,,,,,,,,0,0,0,1,,,,0,0,0,0,1,0,0,0,1,0,0,0,0,0,0,0,0
"Dec 14, 2019 5:00 AM",4,1,3,,,,,,,,,,1,0,1,0,,,,2,2,0,1,2,0,0,0,1,0,0,0,0,0,0,0,0
"Dec 14, 2019 6:00 AM",5,3,2,,,,,,,,,,0,0,0,3,,,,1,1,0,3,2,0,0,0,4,2,0,1,1,0,0,0,0
"Dec 14, 2019 7:00 AM",14,7,7,,,,,,,,,,1,0,1,2,,,,2,2,0,3,6,2,1,1,5,0,0,1,1,0,0,0,0
"Dec 14, 2019 8:00 AM",54,41,13,,,,,,,,,,5,3,2,5,,,,3,3,0,16,13,2,1,1,17,0,2,0,0,0,0,0,0
"Dec 14, 2019 9:00 AM",54,46,8,,,,,,,,,,2,1,1,7,,,,10,6,4,15,11,8,6,2,9,0,2,0,0,0,0,0,0
"Dec 14, 2019 10:00 AM",45,27,18,,,,,,,,,,3,2,1,4,,,,7,5,2,15,13,11,4,7,12,1,1,0,0,0,1,1,0
"Dec 14, 2019 11:00 AM",57,36,21,,,,,,,,,,1,1,0,9,,,,12,10,2,15,17,9,1,8,10,0,5,1,1,0,0,0,0
"Dec 14, 2019 12:00 PM",39,26,13,,,,,,,,,,9,7,2,7,,,,14,11,3,13,11,8,0,8,12,2,3,3,2,1,1,1,0
"Dec 14, 2019 1:00 PM",44,19,25,,,,,,,,,,11,3,8,8,,,,13,10,3,9,9,21,12,9,23,0,2,0,0,0,1,0,1
"Dec 14, 2019 2:00 PM",78,41,37,,,,,,,,,,6,1,5,6,,,,18,16,2,15,4,15,4,11,19,1,2,4,3,1,0,0,0
"Dec 14, 2019 3:00 PM",34,17,17,,,,,,,,,,2,0,2,6,,,,7,7,0,11,11,9,5,4,11,2,2,0,0,0,0,0,0
"Dec 14, 2019 4:00 PM",52,19,33,,,,,,,,,,5,0,5,10,,,,11,8,3,10,10,17,10,7,19,2,0,1,1,0,0,0,0
"Dec 14, 2019 5:00 PM",57,14,43,,,,,,,,,,4,1,3,11,,,,15,12,3,5,8,8,3,5,13,0,2,0,0,0,1,1,0
"Dec 14, 2019 6:00 PM",46,15,31,,,,,,,,,,4,0,4,9,,,,15,11,4,3,9,7,1,6,5,1,0,3,2,1,1,1,0
"Dec 14, 2019 7:00 PM",42,16,26,,,,,,,,,,0,0,0,3,,,,13,13,0,6,8,2,0,2,10,0,0,0,0,0,0,0,0
"Dec 14, 2019 8:00 PM",41,6,35,,,,,,,,,,4,0,4,2,,,,10,10,0,0,5,3,3,0,9,0,1,4,3,1,1,0,1
"Dec 14, 2019 9:00 PM",28,5,23,,,,,,,,,,2,0,2,3,,,,12,10,2,3,2,2,1,1,2,0,0,0,0,0,0,0,0
"Dec 14, 2019 10:00 PM",13,5,8,,,,,,,,,,0,0,0,1,,,,6,6,0,3,2,2,1,1,6,0,0,0,0,0,0,0,0
"Dec 14, 2019 11:00 PM",13,6,7,,,,,,,,,,0,0,0,0,,,,4,4,0,0,2,1,0,1,5,0,0,1,0,1,0,0,0
"Dec 15, 2019 12:00 AM",11,5,6,,,,,,,,,,0,0,0,0,,,,3,3,0,1,4,2,2,0,5,0,0,1,0,1,0,0,0
"Dec 15, 2019 1:00 AM",11,3,8,,,,,,,,,,1,0,1,2,,,,2,2,0,0,2,3,0,3,2,0,0,0,0,0,0,0,0
"Dec 15, 2019 2:00 AM",4,2,2,,,,,,,,,,0,0,0,1,,,,3,3,0,0,0,2,0,2,3,0,0,0,0,0,0,0,0
"Dec 15, 2019 3:00 AM",4,0,4,,,,,,,,,,0,0,0,0,,,,0,0,0,0,2,1,0,1,1,0,2,0,0,0,0,0,0
"Dec 15, 2019 4:00 AM",2,1,1,,,,,,,,,,0,0,0,0,,,,0,0,0,0,1,0,0,0,1,0,0,1,0,1,0,0,0
"Dec 15, 2019 5:00 AM",1,0,1,,,,,,,,,,0,0,0,0,,,,1,1,0,0,0,0,0,0,1,0,0,0,0,0,0,0,0
"Dec 15, 2019 6:00 AM",5,2,3,,,,,,,,,,0,0,0,0,,,,0,0,0,3,4,0,0,0,10,1,0,0,0,0,0,0,0
"Dec 15, 2019 7:00 AM",6,3,3,,,,,,,,,,1,0,1,2,,,,2,1,1,5,14,2,0,2,16,0,0,1,1,0,0,0,0
"Dec 15, 2019 8:00 AM",21,13,8,,,,,,,,,,6,3,3,4,,,,5,1,4,9,8,3,1,2,6,0,0,1,0,1,0,0,0
"Dec 15, 2019 9:00 AM",30,22,8,,,,,,,,,,10,8,2,2,,,,10,6,4,23,23,8,1,7,34,2,7,2,2,0,0,0,0
"Dec 15, 2019 10:00 AM",22,17,5,,,,,,,,,,9,6,3,4,,,,9,5,4,20,25,19,4,15,28,5,7,9,1,8,0,0,0
"Dec 15, 2019 11:00 AM",40,29,11,,,,,,,,,,11,10,1,6,,,,6,5,1,23,12,16,8,8,23,2,4,3,2,1,2,0,2
"Dec 15, 2019 12:00 PM",42,25,17,,,,,,,,,,6,5,1,14,,,,18,14,4,13,15,13,9,4,14,6,5,3,2,1,0,0,0
"Dec 15, 2019 1:00 PM",40,21,19,,,,,,,,,,9,8,1,10,,,,18,15,3,8,11,12,5,7,14,9,2,2,1,1,1,1,0
"Dec 15, 2019 2:00 PM",42,28,14,,,,,,,,,,5,4,1,3,,,,13,9,4,16,6,9,2,7,14,1,1,0,0,0,2,1,1
"Dec 15, 2019 3:00 PM",37,19,18,,,,,,,,,,14,11,3,7,,,,15,10,5,15,12,10,3,7,15,4,2,1,1,0,0,0,0
"Dec 15, 2019 4:00 PM",37,13,24,,,,,,,,,,13,5,8,5,,,,17,13,4,5,10,3,2,1,13,2,1,1,0,1,0,0,0
"Dec 15, 2019 5:00 PM",39,14,25,,,,,,,,,,9,0,9,7,,,,10,9,1,6,5,3,1,2,10,1,2,2,1,1,2,2,0
"Dec 15, 2019 6:00 PM",28,10,18,,,,,,,,,,2,1,1,3,,,,10,10,0,6,5,5,3,2,11,1,2,0,0,0,0,0,0
"Dec 15, 2019 7:00 PM",36,8,28,,,,,,,,,,6,0,6,2,,,,13,13,0,4,4,4,0,4,10,0,1,0,0,0,1,1,0
"Dec 15, 2019 8:00 PM",37,6,31,,,,,,,,,,1,1,0,2,,,,18,16,2,3,8,3,3,0,7,0,0,0,0,0,0,0,0
"Dec 15, 2019 9:00 PM",19,4,15,,,,,,,,,,3,0,3,0,,,,9,8,1,6,4,4,1,3,6,0,0,0,0,0,0,0,0
"Dec 15, 2019 10:00 PM",10,3,7,,,,,,,,,,2,0,2,0,,,,6,6,0,1,0,1,0,1,3,0,0,0,0,0,0,0,0
"Dec 15, 2019 11:00 PM",8,1,7,,,,,,,,,,0,0,0,2,,,,5,5,0,0,3,0,0,0,2,0,0,0,0,0,0,0,0
"Dec 16, 2019 12:00 AM",6,0,6,,,,,,,,,,0,0,0,0,,,,0,0,0,3,3,1,1,0,2,0,1,0,0,0,0,0,0
"Dec 16, 2019 1:00 AM",3,0,3,,,,,,,,,,0,0,0,1,,,,0,0,0,0,2,1,1,0,0,0,0,0,0,0,0,0,0
"Dec 16, 2019 2:00 AM",2,1,1,,,,,,,,,,0,0,0,1,,,,2,2,0,0,0,0,0,0,0,0,0,0,0,0,0,0,0
"Dec 16, 2019 3:00 AM",0,0,0,,,,,,,,,,0,0,0,0,,,,0,0,0,0,0,0,0,0,1,0,0,0,0,0,0,0,0
"Dec 16, 2019 4:00 AM",3,0,3,,,,,,,,,,0,0,0,0,,,,0,0,0,0,1,0,0,0,2,0,0,0,0,0,0,0,0
"Dec 16, 2019 5:00 AM",2,1,1,,,,,,,,,,0,0,0,3,,,,3,3,0,3,4,0,0,0,6,2,0,0,0,0,0,0,0
"Dec 16, 2019 6:00 AM",43,24,19,,,,,,,,,,2,0,2,4,,,,8,4,4,19,6,2,1,1,44,1,0,1,1,0,0,0,0
"Dec 16, 2019 7:00 AM",152,115,37,,,,,,,,,,5,0,5,11,,,,23,13,10,79,24,24,15,9,110,1,7,2,2,0,0,0,0
"Dec 16, 2019 8:00 AM",344,276,68,,,,,,,,,,21,2,19,21,,,,39,27,12,212,64,76,67,9,290,6,5,4,4,0,3,1,2
"Dec 16, 2019 9:00 AM",187,161,26,,,,,,,,,,8,1,7,8,,,,25,14,11,83,24,42,30,12,91,2,2,1,0,1,0,0,0
"Dec 16, 2019 10:00 AM",59,40,19,,,,,,,,,,10,9,1,7,,,,12,7,5,27,8,14,7,7,27,1,1,1,1,0,1,1,0
"Dec 16, 2019 11:00 AM",70,34,36,,,,,,,,,,6,5,1,8,,,,13,5,8,29,11,9,3,6,24,0,1,1,0,1,0,0,0
"Dec 16, 2019 12:00 PM",52,29,23,,,,,,,,,,13,13,0,10,,,,16,12,4,18,14,13,4,9,22,0,0,3,2,1,0,0,0
"Dec 16, 2019 1:00 PM",64,33,31,,,,,,,,,,8,8,0,10,,,,24,18,6,10,20,12,3,9,17,2,1,1,1,0,0,0,0
"Dec 16, 2019 2:00 PM",64,33,31,,,,,,,,,,8,7,1,9,,,,25,23,2,18,12,16,5,11,25,1,2,2,1,1,0,0,0
"Dec 16, 2019 3:00 PM",64,23,41,,,,,,,,,,3,3,0,18,,,,25,20,5,11,16,12,5,7,21,5,1,3,2,1,2,2,0
"Dec 16, 2019 4:00 PM",109,34,75,,,,,,,,,,11,11,0,11,,,,45,43,2,21,57,25,5,20,25,6,1,3,1,2,2,2,0
"Dec 16, 2019 5:00 PM",256,58,198,,,,,,,,,,13,11,2,16,,,,124,116,8,37,123,62,7,55,56,4,2,5,2,3,1,1,0
"Dec 16, 2019 6:00 PM",246,34,212,,,,,,,,,,18,17,1,23,,,,143,134,9,24,118,59,6,53,38,7,2,5,4,1,1,1,0
"Dec 16, 2019 7:00 PM",135,28,107,,,,,,,,,,5,2,3,9,,,,56,55,1,17,45,27,0,27,21,7,2,2,1,1,0,0,0
"Dec 16, 2019 8:00 PM",102,16,86,,,,,,,,,,1,0,1,4,,,,31,31,0,11,24,7,3,4,14,3,1,4,0,4,1,1,0
"Dec 16, 2019 9:00 PM",49,8,41,,,,,,,,,,2,1,1,8,,,,17,15,2,8,11,10,1,9,5,3,0,2,2,0,1,1,0
"Dec 16, 2019 10:00 PM",22,5,17,,,,,,,,,,1,1,0,1,,,,10,10,0,9,9,3,2,1,3,0,2,0,0,0,0,0,0
"Dec 16, 2019 11:00 PM",25,2,23,,,,,,,,,,0,0,0,2,,,,12,12,0,2,6,1,1,0,3,0,0,0,0,0,0,0,0
"Dec 17, 2019 12:00 AM",6,2,4,,,,,,,,,,0,0,0,0,,,,3,2,1,0,1,0,0,0,0,0,2,0,0,0,0,0,0
"Dec 17, 2019 1:00 AM",6,0,6,,,,,,,,,,1,1,0,0,,,,4,4,0,2,1,1,0,1,0,0,0,0,0,0,0,0,0
"Dec 17, 2019 2:00 AM",4,3,1,,,,,,,,,,0,0,0,1,,,,1,1,0,1,0,0,0,0,1,0,0,0,0,0,0,0,0
"Dec 17, 2019 3:00 AM",0,0,0,,,,,,,,,,0,0,0,0,,,,0,0,0,0,0,0,0,0,0,0,0,0,0,0,0,0,0
"Dec 17, 2019 4:00 AM",4,1,3,,,,,,,,,,0,0,0,0,,,,0,0,0,0,0,0,0,0,3,0,0,0,0,0,0,0,0
"Dec 17, 2019 5:00 AM",6,5,1,,,,,,,,,,0,0,0,1,,,,2,2,0,4,4,0,0,0,9,2,0,0,0,0,0,0,0
"Dec 17, 2019 6:00 AM",41,26,15,,,,,,,,,,2,1,1,8,,,,8,7,1,24,9,4,4,0,31,1,1,1,1,0,1,0,1
"Dec 17, 2019 7:00 AM",168,129,39,,,,,,,,,,5,1,4,8,,,,23,15,8,82,28,24,18,6,120,1,5,8,8,0,3,0,3
"Dec 17, 2019 8:00 AM",348,288,60,,,,,,,,,,21,6,15,27,,,,44,28,16,199,50,61,48,13,272,6,7,6,6,0,0,0,0
"Dec 17, 2019 9:00 AM",154,121,33,,,,,,,,,,12,8,4,6,,,,25,14,11,83,18,42,28,14,96,5,4,5,4,1,2,0,2
"Dec 17, 2019 10:00 AM",47,39,8,,,,,,,,,,4,3,1,5,,,,13,6,7,40,12,12,7,5,30,1,3,3,1,2,1,1,0
"Dec 17, 2019 11:00 AM",68,43,25,,,,,,,,,,9,8,1,7,,,,12,10,2,24,16,13,4,9,16,3,1,0,0,0,0,0,0
"Dec 17, 2019 12:00 PM",49,20,29,,,,,,,,,,8,8,0,4,,,,12,11,1,17,10,7,5,2,16,0,2,1,1,0,0,0,0
"Dec 17, 2019 1:00 PM",53,27,26,,,,,,,,,,13,13,0,7,,,,19,18,1,14,19,10,0,10,16,5,1,4,3,1,2,1,1
"Dec 17, 2019 2:00 PM",78,40,38,,,,,,,,,,14,14,0,10,,,,17,15,2,15,15,15,9,6,21,2,1,3,2,1,3,2,1
"Dec 17, 2019 3:00 PM",61,20,41,,,,,,,,,,8,8,0,11,,,,23,21,2,15,18,11,2,9,18,1,0,1,1,0,3,3,0
"Dec 17, 2019 4:00 PM",124,32,92,,,,,,,,,,8,7,1,14,,,,40,36,4,24,51,23,2,21,27,4,2,5,1,4,0,0,0
"Dec 17, 2019 5:00 PM",242,71,171,,,,,,,,,,9,8,1,20,,,,114,107,7,33,121,46,10,36,55,5,2,6,3,3,0,0,0
"Dec 17, 2019 6:00 PM",247,43,204,,,,,,,,,,11,7,4,13,,,,146,144,2,30,117,57,4,53,35,4,2,4,3,1,0,0,0
"Dec 17, 2019 7:00 PM",117,25,92,,,,,,,,,,3,1,2,10,,,,74,69,5,6,43,21,1,20,14,6,1,1,1,0,2,2,0
"Dec 17, 2019 8:00 PM",111,19,92,,,,,,,,,,3,0,3,8,,,,43,39,4,13,26,10,1,9,15,2,0,4,2,2,1,1,0
"Dec 17, 2019 9:00 PM",39,6,33,,,,,,,,,,1,0,1,1,,,,10,10,0,5,16,4,0,4,8,1,4,1,1,0,0,0,0
"Dec 17, 2019 10:00 PM",39,3,36,,,,,,,,,,1,0,1,0,,,,16,15,1,3,15,5,2,3,6,2,1,1,1,0,1,0,1
"Dec 17, 2019 11:00 PM",23,5,18,,,,,,,,,,1,0,1,1,,,,14,14,0,1,8,3,1,2,3,0,0,2,1,1,0,0,0
"Dec 18, 2019 12:00 AM",9,2,7,,,,,,,,,,0,0,0,1,,,,5,5,0,0,5,1,0,1,2,0,2,0,0,0,1,1,0
"Dec 18, 2019 1:00 AM",2,1,1,,,,,,,,,,0,0,0,0,,,,2,2,0,0,0,0,0,0,1,0,0,0,0,0,0,0,0
"Dec 18, 2019 2:00 AM",7,2,5,,,,,,,,,,0,0,0,1,,,,1,1,0,1,0,0,0,0,0,0,0,0,0,0,0,0,0
"Dec 18, 2019 3:00 AM",1,0,1,,,,,,,,,,0,0,0,0,,,,0,0,0,0,1,0,0,0,2,1,0,0,0,0,0,0,0
"Dec 18, 2019 4:00 AM",4,1,3,,,,,,,,,,0,0,0,0,,,,0,0,0,0,1,0,0,0,1,0,0,0,0,0,0,0,0
"Dec 18, 2019 5:00 AM",5,5,0,,,,,,,,,,0,0,0,2,,,,2,2,0,4,1,0,0,0,11,3,0,0,0,0,0,0,0
"Dec 18, 2019 6:00 AM",43,31,12,,,,,,,,,,2,0,2,5,,,,7,5,2,18,6,1,1,0,28,0,0,1,1,0,0,0,0
"Dec 18, 2019 7:00 AM",124,95,29,,,,,,,,,,3,0,3,8,,,,12,8,4,81,24,18,15,3,73,1,3,1,0,1,1,0,1
"Dec 18, 2019 8:00 AM",260,214,46,,,,,,,,,,11,4,7,20,,,,34,23,11,153,44,50,37,13,180,5,6,6,4,2,1,0,1
"Dec 18, 2019 9:00 AM",136,105,31,,,,,,,,,,7,7,0,8,,,,16,8,8,47,20,15,6,9,64,0,0,2,2,0,0,0,0
"Dec 18, 2019 10:00 AM",48,31,17,,,,,,,,,,3,3,0,7,,,,11,9,2,14,7,7,4,3,8,0,0,0,0,0,1,1,0
"Dec 18, 2019 11:00 AM",39,23,16,,,,,,,,,,1,1,0,0,,,,8,8,0,12,7,5,1,4,10,0,1,0,0,0,1,1,0
"Dec 18, 2019 12:00 PM",21,12,9,,,,,,,,,,3,3,0,2,,,,7,6,1,2,7,5,2,3,10,0,0,1,0,1,0,0,0
"Dec 18, 2019 1:00 PM",29,8,21,,,,,,,,,,4,4,0,3,,,,7,5,2,7,8,5,0,5,12,3,0,0,0,0,3,3,0
"Dec 18, 2019 2:00 PM",36,14,22,,,,,,,,,,2,2,0,5,,,,12,10,2,6,6,2,1,1,9,0,0,2,0,2,1,1,0
"Dec 18, 2019 3:00 PM",45,14,31,,,,,,,,,,2,2,0,3,,,,15,13,2,10,9,5,1,4,9,2,0,3,3,0,0,0,0
"Dec 18, 2019 4:00 PM",68,21,47,,,,,,,,,,3,3,0,5,,,,25,22,3,4,34,9,2,7,16,1,0,1,1,0,1,1,0
"Dec 18, 2019 5:00 PM",144,21,123,,,,,,,,,,6,6,0,14,,,,64,62,2,18,54,30,4,26,33,3,1,2,2,0,1,1,0
"Dec 18, 2019 6:00 PM",160,22,138,,,,,,,,,,8,7,1,9,,,,79,75,4,16,61,27,0,27,18,0,0,1,0,1,0,0,0
"Dec 18, 2019 7:00 PM",59,7,52,,,,,,,,,,3,1,2,0,,,,30,30,0,6,28,14,0,14,10,1,1,0,0,0,0,0,0
"Dec 18, 2019 8:00 PM",40,4,36,,,,,,,,,,0,0,0,2,,,,16,16,0,3,11,5,0,5,9,0,0,0,0,0,0,0,0
"Dec 18, 2019 9:00 PM",21,6,15,,,,,,,,,,1,1,0,0,,,,9,7,2,2,10,0,0,0,6,0,0,0,0,0,0,0,0
"Dec 18, 2019 10:00 PM",19,2,17,,,,,,,,,,1,1,0,0,,,,9,9,0,2,2,3,0,3,4,0,0,0,0,0,0,0,0
"Dec 18, 2019 11:00 PM",17,3,14,,,,,,,,,,1,1,0,0,,,,4,4,0,2,4,1,1,0,3,0,0,0,0,0,0,0,0
"Dec 19, 2019 12:00 AM",4,2,2,,,,,,,,,,0,0,0,2,,,,3,1,2,2,2,0,0,0,2,1,0,1,1,0,0,0,0
"Dec 19, 2019 1:00 AM",3,0,3,,,,,,,,,,0,0,0,0,,,,0,0,0,1,2,1,0,1,0,0,1,0,0,0,0,0,0
"Dec 19, 2019 2:00 AM",4,2,2,,,,,,,,,,0,0,0,0,,,,0,0,0,0,1,0,0,0,0,1,0,0,0,0,0,0,0
"Dec 19, 2019 3:00 AM",0,0,0,,,,,,,,,,0,0,0,0,,,,0,0,0,0,0,0,0,0,1,0,0,0,0,0,0,0,0
"Dec 19, 2019 4:00 AM",2,1,1,,,,,,,,,,0,0,0,0,,,,0,0,0,0,0,0,0,0,3,0,0,0,0,0,0,0,0
"Dec 19, 2019 5:00 AM",5,5,0,,,,,,,,,,0,0,0,2,,,,3,2,1,3,1,0,0,0,4,1,0,0,0,0,0,0,0
"Dec 19, 2019 6:00 AM",38,27,11,,,,,,,,,,4,3,1,4,,,,9,7,2,15,5,0,0,0,34,0,3,1,1,0,1,0,1
"Dec 19, 2019 7:00 AM",90,71,19,,,,,,,,,,3,3,0,13,,,,14,8,6,53,13,14,10,4,74,2,2,1,1,0,0,0,0
"Dec 19, 2019 8:00 AM",201,168,33,,,,,,,,,,4,3,1,25,,,,26,16,10,108,32,35,29,6,166,4,6,2,2,0,0,0,0
"Dec 19, 2019 9:00 AM",143,114,29,,,,,,,,,,14,13,1,5,,,,19,11,8,68,18,20,12,8,63,3,2,1,1,0,0,0,0
"Dec 19, 2019 10:00 AM",68,42,26,,,,,,,,,,6,4,2,9,,,,12,6,6,22,14,12,3,9,20,1,1,0,0,0,0,0,0
"Dec 19, 2019 11:00 AM",41,23,18,,,,,,,,,,1,0,1,5,,,,14,12,2,21,13,8,6,2,24,1,2,1,0,1,1,0,1
"Dec 19, 2019 12:00 PM",52,25,27,,,,,,,,,,7,7,0,3,,,,19,15,4,11,8,5,2,3,10,0,2,4,3,1,0,0,0
"Dec 19, 2019 1:00 PM",55,24,31,,,,,,,,,,3,0,3,6,,,,17,11,6,15,9,12,4,8,18,3,2,2,1,1,0,0,0
"Dec 19, 2019 2:00 PM",66,28,38,,,,,,,,,,8,5,3,10,,,,11,9,2,11,7,4,1,3,6,0,3,0,0,0,1,1,0
"Dec 19, 2019 3:00 PM",41,10,31,,,,,,,,,,4,3,1,3,,,,18,18,0,7,9,9,4,5,10,1,0,4,1,3,1,1,0
"Dec 19, 2019 4:00 PM",78,20,58,,,,,,,,,,5,5,0,15,,,,33,30,3,14,27,19,3,16,23,0,0,1,0,1,1,1,0
"Dec 19, 2019 5:00 PM",144,25,119,,,,,,,,,,3,2,1,8,,,,67,62,5,20,63,34,3,31,24,3,1,2,1,1,1,0,1
"Dec 19, 2019 6:00 PM",151,31,120,,,,,,,,,,9,4,5,4,,,,79,79,0,21,63,32,3,29,25,3,1,3,2,1,1,1,0
"Dec 19, 2019 7:00 PM",60,13,47,,,,,,,,,,3,2,1,8,,,,33,31,2,4,27,15,1,14,14,3,2,1,1,0,0,0,0
"Dec 19, 2019 8:00 PM",43,6,37,,,,,,,,,,5,3,2,3,,,,28,27,1,3,20,7,0,7,9,2,1,1,0,1,0,0,0
"Dec 19, 2019 9:00 PM",23,6,17,,,,,,,,,,2,2,0,2,,,,10,9,1,2,2,4,0,4,3,1,1,0,0,0,1,1,0
"Dec 19, 2019 10:00 PM",22,3,19,,,,,,,,,,1,0,1,1,,,,11,11,0,3,10,2,1,1,3,2,0,1,0,1,0,0,0
"Dec 19, 2019 11:00 PM",22,4,18,,,,,,,,,,0,0,0,3,,,,9,9,0,1,1,3,2,1,5,0,0,2,2,0,0,0,0
"Dec 20, 2019 12:00 AM",14,4,10,,,,,,,,,,0,0,0,2,,,,5,5,0,2,5,1,0,1,2,0,1,0,0,0,0,0,0
"Dec 20, 2019 1:00 AM",4,0,4,,,,,,,,,,0,0,0,0,,,,0,0,0,0,2,0,0,0,1,0,0,0,0,0,0,0,0
"Dec 20, 2019 2:00 AM",4,0,4,,,,,,,,,,1,0,1,0,,,,0,0,0,1,1,0,0,0,1,0,0,0,0,0,0,0,0
"Dec 20, 2019 3:00 AM",1,0,1,,,,,,,,,,1,0,1,0,,,,1,0,1,0,0,0,0,0,1,0,0,0,0,0,0,0,0
"Dec 20, 2019 4:00 AM",4,3,1,,,,,,,,,,0,0,0,0,,,,0,0,0,0,0,0,0,0,1,0,0,0,0,0,0,0,0
"Dec 20, 2019 5:00 AM",7,6,1,,,,,,,,,,1,0,1,2,,,,1,1,0,3,0,0,0,0,7,1,0,0,0,0,0,0,0
"Dec 20, 2019 6:00 AM",31,25,6,,,,,,,,,,4,0,4,2,,,,6,4,2,10,7,3,2,1,27,2,2,0,0,0,0,0,0
"Dec 20, 2019 7:00 AM",84,64,20,,,,,,,,,,4,1,3,7,,,,13,8,5,37,17,12,7,5,47,1,3,0,0,0,1,0,1
"Dec 20, 2019 8:00 AM",194,150,44,,,,,,,,,,21,17,4,16,,,,20,14,6,92,28,33,28,5,124,2,4,3,3,0,2,1,1
"Dec 20, 2019 9:00 AM",110,82,28,,,,,,,,,,9,8,1,8,,,,11,7,4,56,24,27,18,9,65,3,5,4,1,3,2,1,1
"Dec 20, 2019 10:00 AM",49,35,14,,,,,,,,,,6,6,0,7,,,,13,7,6,27,13,8,4,4,24,2,2,1,1,0,1,0,1
"Dec 20, 2019 11:00 AM",75,42,33,,,,,,,,,,7,5,2,12,,,,10,7,3,23,11,11,4,7,34,1,1,1,1,0,1,1,0
"Dec 20, 2019 12:00 PM",70,35,35,,,,,,,,,,14,12,2,5,,,,20,18,2,19,20,17,7,10,16,2,0,1,1,0,0,0,0
"Dec 20, 2019 1:00 PM",67,27,40,,,,,,,,,,8,7,1,7,,,,18,15,3,10,17,21,5,16,20,1,5,1,1,0,1,1,0
"Dec 20, 2019 2:00 PM",85,40,45,,,,,,,,,,13,12,1,9,,,,22,21,1,18,16,24,7,17,19,3,0,4,3,1,4,3,1
"Dec 20, 2019 3:00 PM",70,17,53,,,,,,,,,,16,16,0,11,,,,32,32,0,22,35,24,8,16,21,2,2,4,2,2,0,0,0
"Dec 20, 2019 4:00 PM",104,24,80,,,,,,,,,,20,18,2,18,,,,30,30,0,26,52,25,3,22,28,3,1,6,1,5,1,0,1
"Dec 20, 2019 5:00 PM",140,36,104,,,,,,,,,,15,15,0,10,,,,57,55,2,17,69,27,3,24,30,4,1,1,1,0,0,0,0
"Dec 20, 2019 6:00 PM",107,35,72,,,,,,,,,,9,9,0,8,,,,45,44,1,16,50,21,3,18,29,3,1,4,2,2,1,1,0
"Dec 20, 2019 7:00 PM",55,12,43,,,,,,,,,,12,9,3,5,,,,17,16,1,9,18,13,1,12,19,1,0,0,0,0,1,1,0
"Dec 20, 2019 8:00 PM",31,15,16,,,,,,,,,,2,1,1,3,,,,17,16,1,6,14,6,1,5,12,3,0,1,0,1,1,1,0
"Dec 20, 2019 9:00 PM",26,3,23,,,,,,,,,,3,0,3,4,,,,11,9,2,5,10,2,1,1,2,0,0,0,0,0,0,0,0
"Dec 20, 2019 10:00 PM",20,3,17,,,,,,,,,,0,0,0,2,,,,6,5,1,4,8,2,0,2,6,1,0,0,0,0,0,0,0
"Dec 20, 2019 11:00 PM",21,5,16,,,,,,,,,,2,0,2,4,,,,10,10,0,1,9,0,0,0,12,0,0,1,0,1,0,0,0
"Dec 21, 2019 12:00 AM",10,3,7,,,,,,,,,,2,0,2,2,,,,10,8,2,2,5,2,0,2,3,0,0,0,0,0,0,0,0
"Dec 21, 2019 1:00 AM",9,2,7,,,,,,,,,,3,0,3,1,,,,2,2,0,0,2,0,0,0,2,0,1,0,0,0,0,0,0
"Dec 21, 2019 2:00 AM",4,1,3,,,,,,,,,,1,0,1,0,,,,5,5,0,2,1,0,0,0,4,1,0,0,0,0,0,0,0
"Dec 21, 2019 3:00 AM",5,2,3,,,,,,,,,,0,0,0,0,,,,0,0,0,0,1,0,0,0,1,0,2,0,0,0,0,0,0
"Dec 21, 2019 4:00 AM",1,0,1,,,,,,,,,,0,0,0,2,,,,0,0,0,0,4,0,0,0,1,0,0,0,0,0,0,0,0
"Dec 21, 2019 5:00 AM",1,1,0,,,,,,,,,,2,0,2,0,,,,1,1,0,0,4,0,0,0,3,0,0,0,0,0,0,0,0
"Dec 21, 2019 6:00 AM",7,3,4,,,,,,,,,,1,0,1,1,,,,3,3,0,2,6,0,0,0,5,1,0,1,0,1,0,0,0
"Dec 21, 2019 7:00 AM",6,4,2,,,,,,,,,,4,0,4,2,,,,2,2,0,4,10,5,1,4,9,0,0,1,1,0,2,0,2
"Dec 21, 2019 8:00 AM",15,7,8,,,,,,,,,,3,2,1,7,,,,3,3,0,7,12,3,1,2,12,0,1,1,0,1,0,0,0
"Dec 21, 2019 9:00 AM",23,13,10,,,,,,,,,,8,8,0,6,,,,6,5,1,10,9,13,11,2,21,2,4,1,1,0,2,1,1
"Dec 21, 2019 10:00 AM",35,13,22,,,,,,,,,,14,14,0,12,,,,14,11,3,9,10,15,2,13,16,3,1,2,2,0,0,0,0
"Dec 21, 2019 11:00 AM",42,26,16,,,,,,,,,,10,10,0,12,,,,10,9,1,10,16,14,5,9,14,2,1,0,0,0,0,0,0
"Dec 21, 2019 12:00 PM",40,22,18,,,,,,,,,,14,13,1,16,,,,11,10,1,14,15,19,8,11,15,5,2,2,0,2,1,1,0
"Dec 21, 2019 1:00 PM",31,15,16,,,,,,,,,,12,12,0,18,,,,10,7,3,13,9,16,9,7,16,1,1,1,1,0,0,0,0
"Dec 21, 2019 2:00 PM",46,29,17,,,,,,,,,,19,19,0,17,,,,20,15,5,13,8,9,4,5,11,2,4,2,1,1,0,0,0
"Dec 21, 2019 3:00 PM",31,12,19,,,,,,,,,,16,16,0,19,,,,16,12,4,13,11,10,5,5,11,2,1,0,0,0,0,0,0
"Dec 21, 2019 4:00 PM",29,18,11,,,,,,,,,,12,11,1,4,,,,7,7,0,8,10,10,4,6,11,1,2,1,0,1,0,0,0
"Dec 21, 2019 5:00 PM",37,18,19,,,,,,,,,,10,10,0,3,,,,12,10,2,10,5,6,2,4,12,4,1,0,0,0,0,0,0
"Dec 21, 2019 6:00 PM",14,6,8,,,,,,,,,,5,5,0,9,,,,8,6,2,2,8,8,4,4,10,1,1,2,1,1,0,0,0
"Dec 21, 2019 7:00 PM",12,5,7,,,,,,,,,,0,0,0,5,,,,5,4,1,6,7,1,0,1,13,2,1,0,0,0,0,0,0
"Dec 21, 2019 8:00 PM",19,10,9,,,,,,,,,,2,2,0,2,,,,7,7,0,0,5,0,0,0,5,1,0,0,0,0,0,0,0
"Dec 21, 2019 9:00 PM",17,10,7,,,,,,,,,,1,1,0,1,,,,0,0,0,3,1,1,0,1,4,1,0,0,0,0,0,0,0
"Dec 21, 2019 10:00 PM",13,6,7,,,,,,,,,,0,0,0,0,,,,2,1,1,4,4,1,0,1,5,0,0,0,0,0,0,0,0
"Dec 21, 2019 11:00 PM",8,2,6,,,,,,,,,,1,1,0,0,,,,4,2,2,1,1,0,0,0,2,0,1,1,0,1,1,1,0
"Dec 22, 2019 12:00 AM",5,1,4,,,,,,,,,,2,2,0,0,,,,1,1,0,2,3,0,0,0,3,0,0,0,0,0,0,0,0
"Dec 22, 2019 1:00 AM",8,2,6,,,,,,,,,,0,0,0,1,,,,5,5,0,0,1,2,0,2,4,0,0,0,0,0,0,0,0
"Dec 22, 2019 2:00 AM",3,1,2,,,,,,,,,,3,3,0,0,,,,4,3,1,1,2,0,0,0,2,0,0,0,0,0,0,0,0
"Dec 22, 2019 3:00 AM",5,0,5,,,,,,,,,,0,0,0,0,,,,2,2,0,0,2,0,0,0,0,0,2,0,0,0,0,0,0
"Dec 22, 2019 4:00 AM",1,1,0,,,,,,,,,,0,0,0,0,,,,0,0,0,0,0,0,0,0,2,0,0,0,0,0,0,0,0
"Dec 22, 2019 5:00 AM",3,2,1,,,,,,,,,,0,0,0,0,,,,1,1,0,0,0,0,0,0,1,0,0,0,0,0,0,0,0
"Dec 22, 2019 6:00 AM",5,3,2,,,,,,,,,,1,1,0,1,,,,4,3,1,5,5,0,0,0,6,1,1,1,1,0,0,0,0
"Dec 22, 2019 7:00 AM",8,5,3,,,,,,,,,,2,2,0,2,,,,4,2,2,5,9,4,1,3,12,0,1,0,0,0,0,0,0
"Dec 22, 2019 8:00 AM",13,6,7,,,,,,,,,,4,4,0,3,,,,3,3,0,1,7,3,1,2,10,1,5,1,1,0,0,0,0
"Dec 22, 2019 9:00 AM",24,10,14,,,,,,,,,,5,4,1,3,,,,11,9,2,6,14,19,9,10,18,1,3,1,1,0,1,0,1
"Dec 22, 2019 10:00 AM",22,15,7,,,,,,,,,,5,4,1,8,,,,9,7,2,9,9,9,6,3,18,4,6,2,1,1,0,0,0
"Dec 22, 2019 11:00 AM",28,12,16,,,,,,,,,,17,4,13,20,,,,5,4,1,4,14,25,11,14,13,5,5,5,3,2,1,0,1
"Dec 22, 2019 12:00 PM",31,18,13,,,,,,,,,,13,8,5,11,,,,10,8,2,9,16,18,6,12,16,5,5,4,2,2,2,1,1
"Dec 22, 2019 1:00 PM",44,31,13,,,,,,,,,,27,27,0,5,,,,12,11,1,12,6,17,10,7,18,8,6,0,0,0,1,0,1
"Dec 22, 2019 2:00 PM",46,20,26,,,,,,,,,,14,14,0,11,,,,7,6,1,11,13,21,9,12,14,0,3,0,0,0,1,1,0
"Dec 22, 2019 3:00 PM",37,17,20,,,,,,,,,,17,17,0,11,,,,10,9,1,8,10,18,9,9,15,3,1,4,4,0,0,0,0
"Dec 22, 2019 4:00 PM",23,11,12,,,,,,,,,,12,11,1,3,,,,8,8,0,11,8,14,5,9,10,5,1,4,2,2,2,2,0
"Dec 22, 2019 5:00 PM",24,13,11,,,,,,,,,,7,7,0,6,,,,10,8,2,3,6,9,2,7,12,1,2,1,1,0,0,0,0
"Dec 22, 2019 6:00 PM",14,4,10,,,,,,,,,,5,5,0,9,,,,7,7,0,9,9,5,4,1,12,1,0,0,0,0,0,0,0
"Dec 22, 2019 7:00 PM",14,7,7,,,,,,,,,,4,4,0,3,,,,3,3,0,1,8,6,3,3,5,0,1,0,0,0,1,1,0
"Dec 22, 2019 8:00 PM",13,3,10,,,,,,,,,,3,1,2,1,,,,4,3,1,2,4,2,1,1,6,1,1,3,2,1,0,0,0
"Dec 22, 2019 9:00 PM",12,5,7,,,,,,,,,,0,0,0,3,,,,3,2,1,1,4,2,1,1,2,0,1,0,0,0,0,0,0
"Dec 22, 2019 10:00 PM",7,2,5,,,,,,,,,,2,2,0,1,,,,3,3,0,4,0,2,1,1,6,1,0,0,0,0,0,0,0
"Dec 22, 2019 11:00 PM",6,1,5,,,,,,,,,,3,3,0,3,,,,2,2,0,1,2,0,0,0,4,1,0,1,1,0,0,0,0
"Dec 23, 2019 12:00 AM",4,1,3,,,,,,,,,,0,0,0,1,,,,3,3,0,0,2,2,1,1,2,0,1,0,0,0,0,0,0
"Dec 23, 2019 1:00 AM",1,1,0,,,,,,,,,,0,0,0,0,,,,0,0,0,1,2,0,0,0,2,0,0,1,0,1,0,0,0
"Dec 23, 2019 2:00 AM",4,1,3,,,,,,,,,,0,0,0,0,,,,1,1,0,0,1,2,2,0,2,1,0,0,0,0,0,0,0
"Dec 23, 2019 3:00 AM",0,0,0,,,,,,,,,,0,0,0,0,,,,0,0,0,1,0,0,0,0,2,0,1,0,0,0,0,0,0
"Dec 23, 2019 4:00 AM",4,1,3,,,,,,,,,,0,0,0,2,,,,0,0,0,0,1,0,0,0,1,0,0,0,0,0,0,0,0
"Dec 23, 2019 5:00 AM",2,2,0,,,,,,,,,,0,0,0,2,,,,1,1,0,5,0,0,0,0,2,3,0,0,0,0,0,0,0
"Dec 23, 2019 6:00 AM",17,13,4,,,,,,,,,,2,2,0,1,,,,5,4,1,8,4,3,2,1,14,2,1,1,1,0,0,0,0
"Dec 23, 2019 7:00 AM",43,30,13,,,,,,,,,,2,2,0,4,,,,6,5,1,25,14,10,6,4,37,1,3,1,0,1,0,0,0
"Dec 23, 2019 8:00 AM",70,63,7,,,,,,,,,,4,4,0,7,,,,12,8,4,52,19,21,14,7,87,3,1,2,2,0,0,0,0
"Dec 23, 2019 9:00 AM",69,50,19,,,,,,,,,,6,6,0,1,,,,6,4,2,21,8,16,10,6,45,0,2,1,0,1,1,1,0
"Dec 23, 2019 10:00 AM",29,15,14,,,,,,,,,,11,8,3,5,,,,9,7,2,14,8,11,2,9,10,0,0,3,2,1,1,1,0
"Dec 23, 2019 11:00 AM",23,8,15,,,,,,,,,,16,5,11,5,,,,8,6,2,12,11,14,8,6,12,1,0,0,0,0,0,0,0
"Dec 23, 2019 12:00 PM",27,15,12,,,,,,,,,,22,19,3,6,,,,6,5,1,10,8,13,5,8,10,3,2,5,3,2,0,0,0
"Dec 23, 2019 1:00 PM",38,19,19,,,,,,,,,,9,8,1,6,,,,15,11,4,14,15,12,5,7,18,2,1,6,6,0,0,0,0
"Dec 23, 2019 2:00 PM",37,17,20,,,,,,,,,,14,9,5,8,,,,19,17,2,12,16,11,0,11,16,2,0,0,0,0,0,0,0
"Dec 23, 2019 3:00 PM",64,24,40,,,,,,,,,,12,10,2,18,,,,20,20,0,13,19,19,10,9,14,0,2,5,2,3,0,0,0
"Dec 23, 2019 4:00 PM",69,18,51,,,,,,,,,,12,11,1,12,,,,34,33,1,14,45,18,7,11,12,1,4,1,1,0,1,1,0
"Dec 23, 2019 5:00 PM",65,15,50,,,,,,,,,,4,4,0,9,,,,42,39,3,10,41,18,4,14,23,1,1,3,2,1,4,2,2
"Dec 23, 2019 6:00 PM",49,10,39,,,,,,,,,,8,8,0,5,,,,26,25,1,8,35,14,1,13,16,2,3,4,1,3,1,1,0
"Dec 23, 2019 7:00 PM",35,15,20,,,,,,,,,,2,2,0,8,,,,11,11,0,7,11,9,1,8,12,0,1,1,0,1,0,0,0
"Dec 23, 2019 8:00 PM",20,8,12,,,,,,,,,,4,1,3,9,,,,11,11,0,1,9,4,1,3,11,0,2,1,0,1,0,0,0
"Dec 23, 2019 9:00 PM",12,2,10,,,,,,,,,,0,0,0,6,,,,5,5,0,2,7,1,1,0,4,0,0,0,0,0,3,2,1
"Dec 23, 2019 10:00 PM",14,7,7,,,,,,,,,,0,0,0,1,,,,4,3,1,1,5,1,1,0,6,0,0,0,0,0,0,0,0
"Dec 23, 2019 11:00 PM",14,4,10,,,,,,,,,,0,0,0,5,,,,3,3,0,2,3,0,0,0,5,0,0,0,0,0,0,0,0
"Dec 24, 2019 12:00 AM",5,3,2,,,,,,,,,,2,1,1,3,,,,0,0,0,1,3,0,0,0,2,0,0,0,0,0,0,0,0
"Dec 24, 2019 1:00 AM",8,2,6,,,,,,,,,,0,0,0,0,,,,2,2,0,1,1,1,0,1,1,0,1,0,0,0,0,0,0
"Dec 24, 2019 2:00 AM",2,0,2,,,,,,,,,,2,2,0,0,,,,3,3,0,0,0,0,0,0,0,0,0,1,0,1,0,0,0
"Dec 24, 2019 3:00 AM",2,0,2,,,,,,,,,,0,0,0,0,,,,0,0,0,0,2,0,0,0,0,0,0,0,0,0,0,0,0
"Dec 24, 2019 4:00 AM",4,1,3,,,,,,,,,,0,0,0,1,,,,0,0,0,1,1,0,0,0,1,0,0,0,0,0,0,0,0
"Dec 24, 2019 5:00 AM",3,3,0,,,,,,,,,,0,0,0,1,,,,1,0,1,5,0,0,0,0,0,1,0,0,0,0,0,0,0
"Dec 24, 2019 6:00 AM",12,9,3,,,,,,,,,,2,0,2,0,,,,6,4,2,1,3,0,0,0,7,1,0,0,0,0,0,0,0
"Dec 24, 2019 7:00 AM",13,5,8,,,,,,,,,,1,0,1,3,,,,3,2,1,12,4,3,1,2,25,1,0,2,2,0,2,0,2
"Dec 24, 2019 8:00 AM",35,25,10,,,,,,,,,,4,0,4,3,,,,4,4,0,18,12,8,2,6,31,2,4,1,0,1,0,0,0
"Dec 24, 2019 9:00 AM",29,17,12,,,,,,,,,,4,2,2,6,,,,11,9,2,6,5,9,5,4,21,2,2,0,0,0,0,0,0
"Dec 24, 2019 10:00 AM",25,11,14,,,,,,,,,,8,8,0,4,,,,6,4,2,7,11,16,5,11,19,2,1,0,0,0,1,1,0
"Dec 24, 2019 11:00 AM",30,12,18,,,,,,,,,,19,13,6,6,,,,10,10,0,13,13,9,2,7,14,2,3,3,2,1,1,0,1
"Dec 24, 2019 12:00 PM",27,9,18,,,,,,,,,,15,14,1,12,,,,8,6,2,9,16,13,4,9,14,2,1,1,1,0,0,0,0
"Dec 24, 2019 1:00 PM",38,16,22,,,,,,,,,,10,8,2,7,,,,14,13,1,4,13,7,5,2,15,1,0,1,0,1,0,0,0
"Dec 24, 2019 2:00 PM",24,10,14,,,,,,,,,,7,7,0,13,,,,12,10,2,8,10,6,1,5,12,1,0,1,1,0,0,0,0
"Dec 24, 2019 3:00 PM",29,16,13,,,,,,,,,,14,8,6,11,,,,10,10,0,3,14,5,2,3,13,2,2,2,0,2,0,0,0
"Dec 24, 2019 4:00 PM",23,8,15,,,,,,,,,,4,2,2,6,,,,18,16,2,6,5,7,2,5,6,1,1,3,3,0,0,0,0
"Dec 24, 2019 5:00 PM",22,11,11,,,,,,,,,,3,3,0,8,,,,9,8,1,3,11,4,0,4,9,1,0,0,0,0,1,1,0
"Dec 24, 2019 6:00 PM",16,4,12,,,,,,,,,,1,1,0,9,,,,6,6,0,11,9,2,0,2,7,1,0,2,1,1,0,0,0
"Dec 24, 2019 7:00 PM",12,2,10,,,,,,,,,,2,2,0,4,,,,3,3,0,6,6,3,2,1,6,0,0,1,0,1,0,0,0
"Dec 24, 2019 8:00 PM",9,5,4,,,,,,,,,,1,1,0,0,,,,2,2,0,5,2,0,0,0,7,0,0,1,1,0,0,0,0
"Dec 24, 2019 9:00 PM",8,3,5,,,,,,,,,,1,1,0,1,,,,3,3,0,2,2,0,0,0,2,0,0,0,0,0,0,0,0
"Dec 24, 2019 10:00 PM",8,6,2,,,,,,,,,,2,1,1,0,,,,7,7,0,1,2,0,0,0,2,0,0,0,0,0,1,1,0
"Dec 24, 2019 11:00 PM",4,1,3,,,,,,,,,,1,0,1,1,,,,2,2,0,5,1,0,0,0,2,0,0,1,0,1,0,0,0
"Dec 25, 2019 12:00 AM",2,0,2,,,,,,,,,,4,2,2,0,,,,0,0,0,2,1,0,0,0,4,0,0,0,0,0,0,0,0
"Dec 25, 2019 1:00 AM",2,0,2,,,,,,,,,,0,0,0,1,,,,1,0,1,0,0,0,0,0,1,0,0,0,0,0,0,0,0
"Dec 25, 2019 2:00 AM",1,0,1,,,,,,,,,,0,0,0,0,,,,1,1,0,2,0,0,0,0,1,0,0,0,0,0,0,0,0
"Dec 25, 2019 3:00 AM",1,0,1,,,,,,,,,,0,0,0,0,,,,0,0,0,0,1,0,0,0,0,0,0,0,0,0,0,0,0
"Dec 25, 2019 4:00 AM",0,0,0,,,,,,,,,,0,0,0,0,,,,0,0,0,0,0,0,0,0,0,0,0,0,0,0,0,0,0
"Dec 25, 2019 5:00 AM",0,0,0,,,,,,,,,,0,0,0,0,,,,1,0,1,0,1,0,0,0,2,1,0,2,1,1,0,0,0
"Dec 25, 2019 6:00 AM",2,1,1,,,,,,,,,,0,0,0,0,,,,3,3,0,4,1,0,0,0,2,0,0,1,1,0,0,0,0
"Dec 25, 2019 7:00 AM",5,1,4,,,,,,,,,,0,0,0,0,,,,3,3,0,3,4,1,0,1,3,0,0,2,1,1,1,0,1
"Dec 25, 2019 8:00 AM",4,1,3,,,,,,,,,,1,1,0,0,,,,5,5,0,1,7,6,3,3,2,1,0,0,0,0,0,0,0
"Dec 25, 2019 9:00 AM",6,4,2,,,,,,,,,,0,0,0,0,,,,2,2,0,5,6,20,4,16,7,1,0,2,1,1,0,0,0
"Dec 25, 2019 10:00 AM",11,4,7,,,,,,,,,,15,11,4,2,,,,4,4,0,6,8,7,1,6,5,0,3,3,2,1,2,2,0
"Dec 25, 2019 11:00 AM",16,9,7,,,,,,,,,,10,6,4,3,,,,2,2,0,4,5,23,6,17,12,2,2,3,2,1,4,1,3
"Dec 25, 2019 12:00 PM",8,5,3,,,,,,,,,,16,12,4,12,,,,4,4,0,3,13,17,9,8,19,0,1,5,3,2,1,0,1
"Dec 25, 2019 1:00 PM",11,5,6,,,,,,,,,,9,7,2,9,,,,5,5,0,1,8,16,6,10,15,1,4,2,0,2,3,2,1
"Dec 25, 2019 2:00 PM",11,6,5,,,,,,,,,,7,7,0,3,,,,2,2,0,4,7,16,6,10,14,0,3,4,3,1,0,0,0
"Dec 25, 2019 3:00 PM",8,4,4,,,,,,,,,,1,1,0,2,,,,3,3,0,10,10,4,2,2,5,1,1,2,2,0,0,0,0
"Dec 25, 2019 4:00 PM",12,5,7,,,,,,,,,,2,1,1,8,,,,5,5,0,8,2,7,5,2,9,0,0,1,0,1,0,0,0
"Dec 25, 2019 5:00 PM",4,3,1,,,,,,,,,,4,2,2,1,,,,2,2,0,3,1,2,1,1,7,2,0,2,1,1,0,0,0
"Dec 25, 2019 6:00 PM",3,1,2,,,,,,,,,,0,0,0,0,,,,0,0,0,4,5,0,0,0,6,0,0,0,0,0,0,0,0
"Dec 25, 2019 7:00 PM",11,6,5,,,,,,,,,,0,0,0,2,,,,3,2,1,3,3,1,0,1,7,0,0,0,0,0,0,0,0
"Dec 25, 2019 8:00 PM",7,4,3,,,,,,,,,,1,0,1,2,,,,3,3,0,3,2,2,2,0,2,0,0,0,0,0,0,0,0
"Dec 25, 2019 9:00 PM",5,4,1,,,,,,,,,,6,4,2,1,,,,1,1,0,0,2,1,0,1,1,0,0,0,0,0,0,0,0
"Dec 25, 2019 10:00 PM",3,2,1,,,,,,,,,,0,0,0,1,,,,1,1,0,2,3,3,2,1,2,1,0,1,1,0,0,0,0
"Dec 25, 2019 11:00 PM",4,0,4,,,,,,,,,,2,2,0,0,,,,1,1,0,0,0,1,1,0,3,0,0,0,0,0,0,0,0
"Dec 26, 2019 12:00 AM",1,1,0,,,,,,,,,,2,2,0,0,,,,1,1,0,1,1,0,0,0,0,0,0,1,1,0,0,0,0
"Dec 26, 2019 1:00 AM",0,0,0,,,,,,,,,,0,0,0,0,,,,0,0,0,0,0,0,0,0,0,0,0,0,0,0,0,0,0
"Dec 26, 2019 2:00 AM",1,0,1,,,,,,,,,,0,0,0,0,,,,0,0,0,1,0,0,0,0,0,0,0,0,0,0,0,0,0
"Dec 26, 2019 3:00 AM",0,0,0,,,,,,,,,,0,0,0,0,,,,0,0,0,0,0,0,0,0,0,0,0,0,0,0,0,0,0
"Dec 26, 2019 4:00 AM",0,0,0,,,,,,,,,,0,0,0,0,,,,0,0,0,0,0,0,0,0,0,0,0,0,0,0,0,0,0
"Dec 26, 2019 5:00 AM",0,0,0,,,,,,,,,,0,0,0,0,,,,0,0,0,0,0,0,0,0,0,0,0,0,0,0,0,0,0
"Dec 26, 2019 6:00 AM",2,1,1,,,,,,,,,,0,0,0,0,,,,3,2,1,1,0,1,1,0,2,0,0,0,0,0,0,0,0
"Dec 26, 2019 7:00 AM",4,1,3,,,,,,,,,,1,1,0,1,,,,4,4,0,3,3,1,0,1,2,0,0,0,0,0,0,0,0
"Dec 26, 2019 8:00 AM",12,5,7,,,,,,,,,,0,0,0,1,,,,2,2,0,3,0,0,0,0,0,0,0,1,0,1,0,0,0
"Dec 26, 2019 9:00 AM",3,1,2,,,,,,,,,,0,0,0,1,,,,2,2,0,0,2,2,2,0,2,0,2,0,0,0,0,0,0
"Dec 26, 2019 10:00 AM",5,2,3,,,,,,,,,,2,2,0,2,,,,1,1,0,3,4,1,0,1,7,0,1,5,2,3,3,3,0
"Dec 26, 2019 11:00 AM",11,4,7,,,,,,,,,,4,3,1,4,,,,1,1,0,1,9,10,2,8,9,3,2,0,0,0,0,0,0
"Dec 26, 2019 12:00 PM",11,3,8,,,,,,,,,,9,3,6,6,,,,4,4,0,6,2,11,5,6,11,3,1,4,4,0,0,0,0
"Dec 26, 2019 1:00 PM",17,13,4,,,,,,,,,,10,10,0,19,,,,4,3,1,4,4,19,4,15,15,4,2,6,4,2,6,2,4
"Dec 26, 2019 2:00 PM",21,11,10,,,,,,,,,,12,11,1,14,,,,7,7,0,7,13,14,7,7,9,0,1,11,6,5,5,2,3
"Dec 26, 2019 3:00 PM",19,9,10,,,,,,,,,,13,13,0,50,,,,1,1,0,3,8,9,5,4,12,1,1,1,1,0,0,0,0
"Dec 26, 2019 4:00 PM",10,0,10,,,,,,,,,,14,12,2,3,,,,8,6,2,7,4,5,2,3,9,0,0,1,1,0,0,0,0
"Dec 26, 2019 5:00 PM",15,11,4,,,,,,,,,,9,8,1,5,,,,3,3,0,5,3,0,0,0,9,0,0,1,1,0,1,1,0
"Dec 26, 2019 6:00 PM",8,4,4,,,,,,,,,,6,3,3,1,,,,3,3,0,1,5,0,0,0,6,1,0,1,1,0,0,0,0
"Dec 26, 2019 7:00 PM",6,4,2,,,,,,,,,,2,1,1,0,,,,2,2,0,3,2,2,0,2,1,1,1,0,0,0,0,0,0
"Dec 26, 2019 8:00 PM",5,4,1,,,,,,,,,,4,2,2,2,,,,4,2,2,7,1,0,0,0,3,0,1,0,0,0,0,0,0
"Dec 26, 2019 9:00 PM",10,3,7,,,,,,,,,,6,3,3,2,,,,2,2,0,1,3,0,0,0,1,0,0,0,0,0,0,0,0
"Dec 26, 2019 10:00 PM",5,2,3,,,,,,,,,,0,0,0,2,,,,0,0,0,2,2,0,0,0,3,0,0,0,0,0,0,0,0
"Dec 26, 2019 11:00 PM",1,0,1,,,,,,,,,,0,0,0,0,,,,1,1,0,1,0,0,0,0,2,0,1,0,0,0,0,0,0
"Dec 27, 2019 12:00 AM",4,1,3,,,,,,,,,,3,1,2,1,,,,2,2,0,0,1,0,0,0,1,0,1,0,0,0,0,0,0
"Dec 27, 2019 1:00 AM",1,0,1,,,,,,,,,,1,1,0,2,,,,1,1,0,1,1,0,0,0,1,0,0,0,0,0,0,0,0
"Dec 27, 2019 2:00 AM",0,0,0,,,,,,,,,,0,0,0,0,,,,0,0,0,0,0,0,0,0,0,0,0,0,0,0,0,0,0
"Dec 27, 2019 3:00 AM",1,0,1,,,,,,,,,,0,0,0,0,,,,0,0,0,0,1,0,0,0,0,0,0,1,0,1,0,0,0
"Dec 27, 2019 4:00 AM",3,2,1,,,,,,,,,,0,0,0,1,,,,1,1,0,0,0,0,0,0,2,0,0,0,0,0,0,0,0
"Dec 27, 2019 5:00 AM",0,0,0,,,,,,,,,,0,0,0,0,,,,0,0,0,1,1,0,0,0,5,2,0,0,0,0,0,0,0
"Dec 27, 2019 6:00 AM",8,3,5,,,,,,,,,,1,1,0,0,,,,2,2,0,3,3,1,1,0,5,0,1,0,0,0,0,0,0
"Dec 27, 2019 7:00 AM",18,13,5,,,,,,,,,,2,2,0,1,,,,2,2,0,6,6,2,1,1,17,0,0,2,1,1,0,0,0
"Dec 27, 2019 8:00 AM",17,10,7,,,,,,,,,,2,2,0,3,,,,4,3,1,13,9,4,3,1,20,1,0,1,1,0,0,0,0
"Dec 27, 2019 9:00 AM",27,19,8,,,,,,,,,,5,3,2,1,,,,6,3,3,9,14,11,4,7,14,0,4,0,0,0,0,0,0
"Dec 27, 2019 10:00 AM",25,13,12,,,,,,,,,,9,6,3,5,,,,5,3,2,8,12,15,3,12,17,0,4,2,0,2,0,0,0
"Dec 27, 2019 11:00 AM",24,11,13,,,,,,,,,,18,11,7,11,,,,8,8,0,13,12,13,5,8,12,3,2,4,4,0,2,1,1
"Dec 27, 2019 12:00 PM",32,18,14,,,,,,,,,,17,9,8,20,,,,10,6,4,14,16,19,9,10,20,5,4,6,5,1,2,1,1
"Dec 27, 2019 1:00 PM",30,13,17,,,,,,,,,,12,7,5,17,,,,15,12,3,8,11,13,4,9,16,2,2,2,0,2,0,0,0
"Dec 27, 2019 2:00 PM",38,18,20,,,,,,,,,,22,13,9,19,,,,8,6,2,9,9,25,7,18,16,1,0,3,2,1,0,0,0
"Dec 27, 2019 3:00 PM",31,14,17,,,,,,,,,,34,33,1,15,,,,7,6,1,7,19,30,17,13,12,6,3,5,5,0,1,0,1
"Dec 27, 2019 4:00 PM",34,13,21,,,,,,,,,,13,11,2,17,,,,11,11,0,10,17,13,5,8,16,2,3,5,5,0,4,1,3
"Dec 27, 2019 5:00 PM",35,12,23,,,,,,,,,,10,9,1,4,,,,13,12,1,5,9,7,1,6,19,6,1,3,2,1,3,3,0
"Dec 27, 2019 6:00 PM",17,9,8,,,,,,,,,,3,2,1,2,,,,11,9,2,5,10,4,2,2,5,3,3,1,0,1,0,0,0
"Dec 27, 2019 7:00 PM",10,5,5,,,,,,,,,,3,3,0,5,,,,5,5,0,4,9,3,0,3,8,0,0,2,1,1,1,0,1
"Dec 27, 2019 8:00 PM",9,4,5,,,,,,,,,,5,5,0,3,,,,2,2,0,3,4,0,0,0,7,0,0,0,0,0,1,0,1
"Dec 27, 2019 9:00 PM",15,6,9,,,,,,,,,,1,0,1,5,,,,3,3,0,4,2,1,1,0,8,0,0,0,0,0,0,0,0
"Dec 27, 2019 10:00 PM",5,3,2,,,,,,,,,,6,4,2,3,,,,6,6,0,0,5,2,0,2,5,0,0,0,0,0,0,0,0
"Dec 27, 2019 11:00 PM",10,5,5,,,,,,,,,,2,1,1,3,,,,1,1,0,3,1,1,0,1,2,0,0,1,0,1,0,0,0
"Dec 28, 2019 12:00 AM",3,1,2,,,,,,,,,,0,0,0,0,,,,1,1,0,0,1,1,0,1,4,0,1,0,0,0,0,0,0
"Dec 28, 2019 1:00 AM",3,1,2,,,,,,,,,,0,0,0,0,,,,0,0,0,0,1,0,0,0,1,0,0,1,0,1,0,0,0
"Dec 28, 2019 2:00 AM",8,3,5,,,,,,,,,,2,2,0,2,,,,2,2,0,0,2,0,0,0,1,0,1,0,0,0,0,0,0
"Dec 28, 2019 3:00 AM",2,1,1,,,,,,,,,,0,0,0,0,,,,0,0,0,0,1,1,0,1,0,0,1,1,0,1,0,0,0
"Dec 28, 2019 4:00 AM",4,2,2,,,,,,,,,,0,0,0,1,,,,0,0,0,0,1,0,0,0,2,0,0,0,0,0,0,0,0
"Dec 28, 2019 5:00 AM",1,1,0,,,,,,,,,,1,1,0,1,,,,0,0,0,1,3,0,0,0,2,0,0,0,0,0,0,0,0
"Dec 28, 2019 6:00 AM",6,3,3,,,,,,,,,,1,0,1,0,,,,1,1,0,3,3,0,0,0,8,0,0,0,0,0,0,0,0
"Dec 28, 2019 7:00 AM",10,7,3,,,,,,,,,,1,0,1,1,,,,2,1,1,3,5,2,1,1,6,0,0,0,0,0,0,0,0
"Dec 28, 2019 8:00 AM",11,6,5,,,,,,,,,,2,0,2,3,,,,6,5,1,1,2,4,2,2,2,0,1,0,0,0,0,0,0
"Dec 28, 2019 9:00 AM",25,13,12,,,,,,,,,,4,2,2,4,,,,4,4,0,8,9,7,4,3,22,0,2,1,0,1,0,0,0
"Dec 28, 2019 10:00 AM",27,11,16,,,,,,,,,,3,2,1,2,,,,14,9,5,12,11,11,6,5,15,3,4,1,0,1,0,0,0
"Dec 28, 2019 11:00 AM",27,12,15,,,,,,,,,,12,10,2,4,,,,3,3,0,13,11,14,2,12,13,1,9,3,1,2,0,0,0
"Dec 28, 2019 12:00 PM",27,11,16,,,,,,,,,,8,8,0,19,,,,8,5,3,9,11,29,13,16,13,3,2,2,1,1,0,0,0
"Dec 28, 2019 1:00 PM",34,17,17,,,,,,,,,,8,8,0,9,,,,9,7,2,9,4,26,10,16,13,0,1,3,1,2,1,1,0
"Dec 28, 2019 2:00 PM",22,8,14,,,,,,,,,,17,16,1,11,,,,9,8,1,7,9,20,9,11,13,1,0,1,0,1,2,2,0
"Dec 28, 2019 3:00 PM",38,17,21,,,,,,,,,,20,19,1,4,,,,7,7,0,9,11,13,6,7,7,2,2,4,2,2,1,1,0
"Dec 28, 2019 4:00 PM",28,14,14,,,,,,,,,,24,23,1,18,,,,4,4,0,11,6,11,6,5,8,2,0,2,2,0,1,1,0
"Dec 28, 2019 5:00 PM",32,14,18,,,,,,,,,,5,5,0,6,,,,5,4,1,4,6,7,3,4,10,2,0,0,0,0,0,0,0
"Dec 28, 2019 6:00 PM",13,3,10,,,,,,,,,,3,3,0,3,,,,12,9,3,9,10,4,2,2,3,0,0,0,0,0,0,0,0
"Dec 28, 2019 7:00 PM",12,6,6,,,,,,,,,,1,1,0,3,,,,4,4,0,3,3,4,2,2,6,1,0,0,0,0,0,0,0
"Dec 28, 2019 8:00 PM",13,8,5,,,,,,,,,,2,1,1,2,,,,5,5,0,4,8,0,0,0,3,1,1,3,1,2,0,0,0
"Dec 28, 2019 9:00 PM",15,10,5,,,,,,,,,,2,0,2,2,,,,1,1,0,0,3,2,1,1,6,0,0,0,0,0,0,0,0
"Dec 28, 2019 10:00 PM",6,3,3,,,,,,,,,,1,0,1,0,,,,4,3,1,3,3,2,1,1,7,0,0,0,0,0,0,0,0
"Dec 28, 2019 11:00 PM",4,2,2,,,,,,,,,,1,1,0,0,,,,1,0,1,0,4,2,0,2,2,0,0,1,1,0,0,0,0
"Dec 29, 2019 12:00 AM",2,0,2,,,,,,,,,,0,0,0,2,,,,2,2,0,1,0,0,0,0,3,0,0,0,0,0,0,0,0
"Dec 29, 2019 1:00 AM",3,0,3,,,,,,,,,,0,0,0,0,,,,0,0,0,0,2,1,1,0,2,0,0,0,0,0,0,0,0
"Dec 29, 2019 2:00 AM",3,1,2,,,,,,,,,,0,0,0,0,,,,1,1,0,0,1,0,0,0,1,0,1,0,0,0,0,0,0
"Dec 29, 2019 3:00 AM",2,0,2,,,,,,,,,,0,0,0,0,,,,0,0,0,0,0,0,0,0,1,0,2,0,0,0,0,0,0
"Dec 29, 2019 4:00 AM",1,1,0,,,,,,,,,,0,0,0,0,,,,1,1,0,0,1,0,0,0,2,0,0,0,0,0,0,0,0
"Dec 29, 2019 5:00 AM",3,3,0,,,,,,,,,,0,0,0,0,,,,0,0,0,0,0,0,0,0,0,0,0,1,0,1,0,0,0
"Dec 29, 2019 6:00 AM",11,2,9,,,,,,,,,,0,0,0,0,,,,3,3,0,3,2,0,0,0,7,2,0,0,0,0,0,0,0
"Dec 29, 2019 7:00 AM",11,10,1,,,,,,,,,,3,3,0,1,,,,6,4,2,6,9,4,1,3,6,0,2,0,0,0,0,0,0
"Dec 29, 2019 8:00 AM",12,5,7,,,,,,,,,,2,2,0,5,,,,8,7,1,4,7,3,1,2,6,0,1,2,0,2,0,0,0
"Dec 29, 2019 9:00 AM",14,4,10,,,,,,,,,,6,6,0,8,,,,7,6,1,10,13,7,4,3,17,2,5,1,0,1,0,0,0
"Dec 29, 2019 10:00 AM",32,17,15,,,,,,,,,,10,10,0,12,,,,12,11,1,9,15,18,6,12,20,4,3,0,0,0,0,0,0
"Dec 29, 2019 11:00 AM",34,22,12,,,,,,,,,,19,19,0,18,,,,3,3,0,9,10,21,10,11,20,3,3,3,2,1,1,1,0
"Dec 29, 2019 12:00 PM",31,11,20,,,,,,,,,,27,27,0,15,,,,7,7,0,9,23,20,10,10,23,2,5,4,3,1,2,0,2
"Dec 29, 2019 1:00 PM",32,19,13,,,,,,,,,,17,15,2,10,,,,17,16,1,8,20,15,8,7,26,2,1,1,1,0,1,0,1
"Dec 29, 2019 2:00 PM",40,25,15,,,,,,,,,,25,24,1,14,,,,11,10,1,9,13,15,4,11,18,0,0,7,7,0,3,1,2
"Dec 29, 2019 3:00 PM",36,17,19,,,,,,,,,,15,2,13,26,,,,13,10,3,9,7,24,9,15,14,3,5,1,1,0,4,3,1
"Dec 29, 2019 4:00 PM",36,15,21,,,,,,,,,,9,0,9,15,,,,10,9,1,8,11,11,4,7,13,1,5,1,0,1,2,2,0
"Dec 29, 2019 5:00 PM",26,15,11,,,,,,,,,,11,0,11,3,,,,7,6,1,8,12,21,15,6,11,10,0,2,2,0,0,0,0
"Dec 29, 2019 6:00 PM",12,2,10,,,,,,,,,,4,0,4,11,,,,8,7,1,4,4,1,0,1,7,0,1,1,1,0,1,1,0
"Dec 29, 2019 7:00 PM",21,13,8,,,,,,,,,,3,0,3,2,,,,7,6,1,0,6,3,1,2,6,0,1,1,0,1,0,0,0
"Dec 29, 2019 8:00 PM",16,7,9,,,,,,,,,,8,0,8,2,,,,2,2,0,4,2,2,1,1,5,1,0,1,0,1,0,0,0
"Dec 29, 2019 9:00 PM",9,1,8,,,,,,,,,,2,0,2,1,,,,1,0,1,1,4,1,1,0,5,0,0,4,2,2,0,0,0
"Dec 29, 2019 10:00 PM",2,1,1,,,,,,,,,,1,0,1,2,,,,1,1,0,3,3,2,1,1,6,0,3,0,0,0,0,0,0
"Dec 29, 2019 11:00 PM",6,2,4,,,,,,,,,,2,2,0,0,,,,2,1,1,0,4,1,0,1,4,1,0,1,1,0,1,1,0
"Dec 30, 2019 12:00 AM",2,1,1,,,,,,,,,,7,3,4,1,,,,1,1,0,2,3,1,0,1,1,0,0,0,0,0,0,0,0
"Dec 30, 2019 1:00 AM",2,0,2,,,,,,,,,,0,0,0,3,,,,1,1,0,1,2,0,0,0,1,0,1,0,0,0,0,0,0
"Dec 30, 2019 2:00 AM",1,1,0,,,,,,,,,,0,0,0,1,,,,0,0,0,0,0,1,0,1,0,0,0,0,0,0,0,0,0
"Dec 30, 2019 3:00 AM",1,0,1,,,,,,,,,,0,0,0,0,,,,0,0,0,0,1,0,0,0,0,0,0,0,0,0,0,0,0
"Dec 30, 2019 4:00 AM",3,2,1,,,,,,,,,,0,0,0,0,,,,1,1,0,0,0,0,0,0,0,0,0,0,0,0,0,0,0
"Dec 30, 2019 5:00 AM",2,2,0,,,,,,,,,,0,0,0,1,,,,2,2,0,1,0,0,0,0,1,2,0,0,0,0,0,0,0
"Dec 30, 2019 6:00 AM",15,7,8,,,,,,,,,,1,0,1,1,,,,0,0,0,12,5,2,2,0,15,2,0,0,0,0,0,0,0
"Dec 30, 2019 7:00 AM",34,22,12,,,,,,,,,,1,0,1,1,,,,5,5,0,17,12,3,2,1,22,0,1,0,0,0,0,0,0
"Dec 30, 2019 8:00 AM",56,41,15,,,,,,,,,,3,2,1,4,,,,12,9,3,22,14,10,7,3,53,1,2,0,0,0,0,0,0
"Dec 30, 2019 9:00 AM",47,32,15,,,,,,,,,,6,2,4,3,,,,6,5,1,18,9,8,4,4,38,2,6,1,1,0,1,0,1
"Dec 30, 2019 10:00 AM",21,10,11,,,,,,,,,,9,3,6,8,,,,11,9,2,14,10,8,2,6,24,5,2,2,1,1,1,0,1
"Dec 30, 2019 11:00 AM",27,14,13,,,,,,,,,,17,10,7,21,,,,11,6,5,14,13,17,6,11,22,2,6,9,5,4,2,0,2
"Dec 30, 2019 12:00 PM",29,11,18,,,,,,,,,,21,9,12,19,,,,6,5,1,14,12,23,9,14,20,2,4,5,2,3,3,3,0
"Dec 30, 2019 1:00 PM",37,24,13,,,,,,,,,,27,16,11,13,,,,14,12,2,16,20,27,5,22,18,8,2,7,5,2,3,2,1
"Dec 30, 2019 2:00 PM",32,20,12,,,,,,,,,,13,10,3,19,,,,16,16,0,16,18,27,12,15,14,2,1,2,1,1,1,0,1
"Dec 30, 2019 3:00 PM",50,19,31,,,,,,,,,,10,9,1,17,,,,14,13,1,10,25,20,9,11,11,4,1,1,0,1,0,0,0
"Dec 30, 2019 4:00 PM",53,12,41,,,,,,,,,,17,12,5,17,,,,18,16,2,7,32,14,8,6,20,5,3,7,5,2,1,0,1
"Dec 30, 2019 5:00 PM",46,10,36,,,,,,,,,,14,13,1,3,,,,30,29,1,11,29,8,0,8,16,1,0,0,0,0,0,0,0
"Dec 30, 2019 6:00 PM",34,7,27,,,,,,,,,,10,6,4,2,,,,19,17,2,3,19,13,6,7,19,0,1,0,0,0,2,2,0
"Dec 30, 2019 7:00 PM",15,4,11,,,,,,,,,,4,2,2,1,,,,11,10,1,2,6,1,1,0,7,2,1,1,1,0,0,0,0
"Dec 30, 2019 8:00 PM",5,1,4,,,,,,,,,,0,0,0,3,,,,7,6,1,5,6,1,0,1,7,1,0,0,0,0,0,0,0
"Dec 30, 2019 9:00 PM",9,4,5,,,,,,,,,,0,0,0,3,,,,5,5,0,5,5,2,1,1,2,0,0,1,1,0,1,0,1
"Dec 30, 2019 10:00 PM",5,2,3,,,,,,,,,,1,1,0,2,,,,5,5,0,1,4,1,1,0,6,0,0,0,0,0,0,0,0
"Dec 30, 2019 11:00 PM",8,3,5,,,,,,,,,,1,0,1,0,,,,5,5,0,0,1,0,0,0,4,0,0,0,0,0,0,0,0
"Dec 31, 2019 12:00 AM",2,1,1,,,,,,,,,,0,0,0,0,,,,4,4,0,1,2,2,0,2,5,0,0,2,1,1,2,1,1
"Dec 31, 2019 1:00 AM",1,0,1,,,,,,,,,,2,0,2,3,,,,1,1,0,3,1,1,0,1,2,0,1,0,0,0,0,0,0
"Dec 31, 2019 2:00 AM",5,3,2,,,,,,,,,,0,0,0,0,,,,1,0,1,3,0,0,0,0,1,0,0,0,0,0,0,0,0
"Dec 31, 2019 3:00 AM",0,0,0,,,,,,,,,,0,0,0,0,,,,0,0,0,0,0,0,0,0,0,0,0,0,0,0,0,0,0
"Dec 31, 2019 4:00 AM",4,3,1,,,,,,,,,,0,0,0,2,,,,1,1,0,0,0,0,0,0,1,0,0,0,0,0,0,0,0
"Dec 31, 2019 5:00 AM",1,1,0,,,,,,,,,,0,0,0,2,,,,2,2,0,1,1,0,0,0,1,2,0,0,0,0,0,0,0
"Dec 31, 2019 6:00 AM",5,3,2,,,,,,,,,,1,0,1,0,,,,2,1,1,6,3,1,1,0,10,2,0,0,0,0,0,0,0
"Dec 31, 2019 7:00 AM",30,16,14,,,,,,,,,,3,0,3,4,,,,1,1,0,16,12,4,2,2,21,1,1,1,1,0,1,0,1
"Dec 31, 2019 8:00 AM",46,34,12,,,,,,,,,,3,1,2,5,,,,12,6,6,33,14,5,4,1,30,0,2,2,0,2,0,0,0
"Dec 31, 2019 9:00 AM",47,32,15,,,,,,,,,,9,9,0,7,,,,14,8,6,19,10,15,8,7,25,3,3,3,1,2,0,0,0
"Dec 31, 2019 10:00 AM",31,21,10,,,,,,,,,,8,6,2,12,,,,5,5,0,8,9,9,2,7,12,2,8,3,0,3,2,2,0
"Dec 31, 2019 11:00 AM",35,21,14,,,,,,,,,,17,14,3,6,,,,9,8,1,7,18,22,13,9,19,3,1,3,2,1,0,0,0
"Dec 31, 2019 12:00 PM",34,17,17,,,,,,,,,,13,12,1,32,,,,12,12,0,14,7,15,7,8,21,8,2,4,4,0,1,0,1
"Dec 31, 2019 1:00 PM",48,19,29,,,,,,,,,,10,9,1,19,,,,21,19,2,10,17,9,0,9,16,2,3,6,6,0,0,0,0
"Dec 31, 2019 2:00 PM",50,24,26,,,,,,,,,,21,19,2,28,,,,18,18,0,7,30,24,6,18,9,3,3,1,0,1,0,0,0
"Dec 31, 2019 3:00 PM",61,12,49,,,,,,,,,,29,21,8,19,,,,15,11,4,10,26,26,12,14,17,3,4,7,4,3,0,0,0
"Dec 31, 2019 4:00 PM",50,16,34,,,,,,,,,,27,22,5,12,,,,26,25,1,15,20,18,6,12,18,2,1,3,3,0,0,0,0
"Dec 31, 2019 5:00 PM",46,11,35,,,,,,,,,,4,0,4,11,,,,21,19,2,12,13,10,2,8,13,1,1,1,1,0,0,0,0
"Dec 31, 2019 6:00 PM",21,7,14,,,,,,,,,,1,0,1,3,,,,11,11,0,5,6,4,0,4,5,0,1,2,0,2,0,0,0
"Dec 31, 2019 7:00 PM",15,4,11,,,,,,,,,,1,0,1,1,,,,3,3,0,5,7,6,3,3,4,4,0,0,0,0,1,0,1
"Dec 31, 2019 8:00 PM",13,6,7,,,,,,,,,,4,0,4,3,,,,4,2,2,4,5,0,0,0,7,1,0,0,0,0,0,0,0
"Dec 31, 2019 9:00 PM",4,1,3,,,,,,,,,,2,0,2,1,,,,5,5,0,5,2,2,2,0,4,3,4,0,0,0,1,1,0
"Dec 31, 2019 10:00 PM",3,2,1,,,,,,,,,,0,0,0,0,,,,3,3,0,5,5,0,0,0,6,0,0,0,0,0,0,0,0
"Dec 31, 2019 11:00 PM",2,1,1,,,,,,,,,,2,0,2,0,,,,7,7,0,4,1,0,0,0,9,1,0,1,0,1,0,0,0
